Affrica	África
Iapan	Japão
Sūðamerica	América do Sul
Norþweg	Noruega
Englaland	Inglaterra
Scotland	Escócia
Wēalas	País de Gales
Norðerne Īrland	Irlanda do Norte
Īrland Cynewīse	República da Irlanda
Ungerland	Hungria
Spēonland	Espanha
Geānedu Rīcu American	Estados Unidos
Belgice	Bélgica
Letseburg	Luxemburgo
Eorðe	Terra
Līf	Vida
George Washington	George Washington
Finnland	Finlândia
Swēoland	Suécia
Denemearc	Dinamarca
Polaland	Polónia
Liþþuania	Lituânia
Italia	Itália
Swissland	Suíça
Ēastrīce	Áustria
Grēcland	Grécia
Turcland	Turquia
Bēor	Cerveja
Portugal	Portugal
Europe	Europa
Asia	Ásia
Norðamerica	América do Norte
Antarctica	Antártida
Wikipǣdia	Wikipédia
Niðerland	Países Baixos
Nīweoforwīcburg	Nova Iorque
Hwæsingatūn, D.C.	Washington, D.C.
Berlin	Berlim
Los Angeles	Los Angeles
Spearctelle	Computador
Genf	Genebra
Betweoxnett	Internet
Barack Obama	Barack Obama
Uruguay	Uruguai
Lunden	Londres
Æppel	Maçã
Paris	Paris
Abraham Lincoln	Abraham Lincoln
Android	Android
Google	Google
Mexico	México
Atlantisc Gārsecg	Oceano Atlântico
Sericus Gārsecg	Oceano Pacífico
California	Califórnia
Mōnandæg	Segunda-feira
Æfterra Gēola	Janeiro
Solmōnaþ	Fevereiro
Hrēþmōnaþ	Março
Tīw (tungol)	Marte (planeta)
Cenia	Quénia
Sigelhearwenaland	Etiópia
Ēastermōnaþ	Abril
Þrimilcemōnaþ	Maio
Sēremōnaþ	Junho
Mǣdmōnaþ	Julho
Wēodmōnaþ	Agosto
Hāligmōnaþ	Setembro
Winterfylleþ	Outubro
Blōtmōnaþ	Novembro
Gēolmōnaþ	Dezembro
Tīwesdæg	Terça-feira
Wēdnesdæg	Quarta-feira
Þunresdæg	Quinta-feira
Frīgedæg	Sexta-feira
Sæternesdæg	Sábado
Sunnandæg	Domingo
Lēo	Leão
Francland	França
Esperanto	Esperanto
Geāned Cynerīce	Reino Unido
Catte	Gato
Cīnan Folclicu Cynewīse	República Popular da China
Frencisc sprǣc	Língua francesa
Fisc	Peixe
Brasil	Brasil
Russland	Rússia
Eoferwicscīr	Yorkshire (Inglaterra)
Sǣ	Mar
Euxinus	Mar Negro
Toronto	Toronto
Alabama	Alabama
São Paulo	São Paulo (cidade)
São Paulo (rīce)	São Paulo
Quebec	Quebec
Piza	Pizza
Þēodscland	Alemanha
Hwītrussland	Bielorrússia
Þēodsc sprǣc	Língua alemã
Īsland	Islândia
God	Deus
Estland	Estónia
Sætern (tungol)	Saturno (planeta)
Ceocōlāte	Chocolate
2 (getæl)	Dois
Þrīe	Três
Fēower	Quatro
Fīf	Cinco
George W. Bush	George W. Bush
Lettland	Letónia
Ucrægna	Ucrânia
Cecland	República Checa
Slofacia	Eslováquia
Slofenia	Eslovénia
Vilnius	Vilnius
Moldofa	Moldávia
Rumǣnia	Roménia
Pulgaraland	Bulgária
Rōm	Roma
Macedonia Cynewīse	República da Macedónia
Albania	Albânia
Grēneland	Gronelândia
Croatia	Croácia
Bosnia and Herzegofina	Bósnia e Herzegovina
Godhopa	Nuuk
Azerbaijan	Azerbaijão
Andorra	Andorra
Cipros	Chipre
Georgia (land)	Geórgia
Casahstan	Cazaquistão
Melita	Malta
Flandras	Flandres
Monaco	Mónaco
Sweartbeorg	Montenegro
Faticanburg	Vaticano
San Marino	San Marino
Brysel	Cidade de Bruxelas
Cūba	Cuba
Barbados	Barbados
Cǣgbord (spearctellend)	Teclado (informática)
Indonesia	Indonésia
Wolfgang Amadeus Mozart	Wolfgang Amadeus Mozart
Ludwig van Beethoven	Ludwig van Beethoven
Sūðaffrica	África do Sul
Algeria	Argélia
Usbecastan	Uzbequistão
Warsaw	Varsóvia
Wīn (drinc)	Vinho
Wæter	Água
Holt	Madeira
Feorrsīen	Televisão
Īslendisc sprǣc	Língua islandesa
Cile	Chile
Iesus	Jesus
Elvis Presley	Elvis Presley
Wōden (tungol)	Mercúrio (planeta)
Stǣr	História
Apple Inc.	Apple
Frig (tungol)	Vénus (planeta)
Sprǣc	Linguagem
Lufu	Amor
Þunor (tungol)	Júpiter (planeta)
Uranus	Urano (planeta)
Neptune (planēta)	Netuno (planeta)
Tungolcræft	Astronomia
Witancræft	Ciência
Pluto	Plutão
Montreal	Montreal
Lēohtenstān	Liechtenstein
Plega	Desporto
Grantanbrycg	Cambridge
Adolf Hitler	Adolf Hitler
Fyrst Woruldgūþ	Primeira Guerra Mundial
Ōðru Woruldgūþ	Segunda Guerra Mundial
Wikibēc	Wikilivros
Augusto Pinochet	Augusto Pinochet
Geanca Cupala	Yanka Kupala
Ubuntu	Ubuntu
Stettin	Estetino
Rīmcræft	Matemática
U2	U2
Lǣden	Língua latina
Bahrain	Bahrein
Armenia	Arménia
Serbia	Sérvia
Mōna	Lua
Constantinopolis	Istambul
Australia	Austrália
Bob Marley	Bob Marley
Argentina	Argentina
Peru	Peru
Norþcorēa	Coreia do Norte
Cambodia	Camboja
Kuiperes gyrtel	Cintura de Kuiper
Curān	Alcorão
Alladōm	Islão
Lech Wałęsa	Lech Wałęsa
Europisce Gesamnung	União Europeia
Woruldwīd Webb	World Wide Web
Wīf	Mulher
Wætertyge	Aqueduto
Don Quijote	Dom Quixote
Megelan	Milão
Burg	Cidade
Napoleon I Francena Cāsere	Napoleão Bonaparte
Uesuuius	Vesúvio
Sunne	Sol
Lēohtgēar	Ano-luz
Sunnlicu Endebyrdnes	Sistema Solar
Ostsǣ	Mar Báltico
Wisle	Rio Vístula
Tōþ	Dente
Wætertimber	Hidrogénio
Wikimedia Commons	Wikimedia Commons
Dæg	Dia
Ēasttimor	Timor-Leste
Niht	Noite
Gēar	Ano
Hundgēar	Século
Rīn	Reno
Oslo	Oslo
Katowice	Katowice
1 Ceres	Ceres (planeta anão)
Ii	Iona (Escócia)
Dubai	Dubai
Folga	Rio Volga
Æðmlyft	Oxigénio
Dweligende tungol	Planeta
Venetia	Veneza
Naruto	Naruto
Moscow	Moscovo
Italisc sprǣc	Língua italiana
Cead	Chade
Nīwe Sǣland	Nova Zelândia
Indea	Índia
Īsen	Ferro
Willelm Scacaspere	William Shakespeare
Lēad	Chumbo
Mongolland	Mongólia
Ficgīege	Fiji
Feneswela	Venezuela
Blēobord	Xadrez
Maine	Maine
Hors	Equus ferus caballus
Amsterdam	Amesterdão
Wǣpen	Arma
Dēor	Animalia
Paraguay	Paraguai
Ecuador	Equador
Colombia	Colômbia
Strēawberge	Morangueiro
Buddendōm	Budismo
Bolifia	Bolívia
Coper	Cobre
Plante	Plantae
Nīwu Hāmtūnscīr	Nova Hampshire
Iamaica	Jamaica
Massachusetts	Massachusetts
Connecticut	Connecticut
Henn	Gallus gallus domesticus
Hawaii	Havaí
Cēsarēa	Jersey
Swīn	Sus domesticus
Īshæf	Oceano Ártico
Persealand	Irão
Irac	Iraque
Alaska	Alasca
Israhēl	Israel
Utrecht	Utrecht
Gemen	Iémen
Clēofanwyrm	Vírus
Polisc sprǣc	Língua polaca
Hascemisc Cynerīce þæs Iordanes	Jordânia
Florida	Flórida
Arizona	Arizona
Cuwait	Kuwait
Libanus	Líbano
Oregon	Oregon
Utah	Utah
Hriðer	Bos taurus
Malægsia	Malásia
Burma	Myanmar
Oman	Omã
Pacistan	Paquistão
Qatar	Catar
Tennis	Ténis
Saudisc Arabea	Arábia Saudita
Tāprabane	Sri Lanka
Iosep Stalin	Josef Stalin
Syria	Síria
Plato	Platão
Tacgicastan	Tajiquistão
Aristoteles	Aristóteles
Thailand	Tailândia
Ūtƿeorp	Rádio (telecomunicações)
Turcmenistan	Turquemenistão
Geānedu Arabisc Bregorīcu	Emirados Árabes Unidos
Fietnam	Vietname
Sūþcorēa	Coreia do Sul
Afghanistan	Afeganistão
J. R. R. Tolkien	J. R. R. Tolkien
Gold	Ouro
Bængladesc	Bangladesh
Bleach (manga)	Bleach (mangá)
Socrates	Sócrates
Angola	Angola
Tansania	Tanzânia
Philippines	Filipinas
Middel Affricanisc Cynewīse	República Centro-Africana
Sūþende þǣre eaxe	Polo Sul
Norþende þære eaxe	Polo Norte
Isaac Newton	Isaac Newton
Albert Einstein	Albert Einstein
Geolu	Amarelo
Tunisia	Tunísia
Simbabwe	Zimbabwe
Beicing	Pequim
Sūþsudan	Sudão do Sul
Botswana	Botswana
Burkina Faso	Burkina Faso
Folcrīcelicu Cynewīse þæs Congwes	República Democrática do Congo
Bægwaraland	Baviera
Baden-Wyrttemberg	Baden-Württemberg
Æriþrea	Eritreia
Nīwe Delhi	Nova Deli
Iohannes Paulus II Pāpa	Papa João Paulo II
Gabon	Gabão
Mohandas Karamchand Gandhi	Mahatma Gandhi
Gambia	Gâmbia
Guinea	Guiné
Elpendbānrima	Costa do Marfim
Camerun	Camarões
Grēnenæs Īega	Cabo Verde
Lesotho	Lesoto
Liberia	Libéria
Libia	Líbia
Madagascar	Madagáscar
Mauritania	Mauritânia
Morocco	Marrocos
Mosambice	Moçambique
Namibia	Namíbia
Nigeria	Nigéria
Charles Darwin	Charles Darwin
Uganda	Uganda
Rwanda	Ruanda
Sōmalia	Somália
Gaius Iulius Caesar	Júlio César
Sudan	Sudão
Swasiland	Suazilândia
Hamburg	Hamburgo
Heorte	Coração
Brægen	Cérebro
Prag	Praga
Bleoh	Azul
Seolfor	Prata
Tin	Estanho
Reddit	Reddit
Elsass	Alsácia
Bihar	Bihar
Michigan	Michigan
Puerto Rico	Porto Rico
Niðerseaxland	Baixa Saxônia
Hetwaraland	Hesse
Illinois	Illinois
Norþdakota	Dakota do Norte
Brandenburg	Brandemburgo
Langbeardnaland	Lombardia
Sūþdakota	Dakota do Sul
Montǣna	Montana
Wyoming	Wyoming
Ierusalem	Jerusalém
Idaho	Idaho
Hwæsingatūn	Washington
Nevada	Nevada
Danais	Rio Don
Indisc Gārsecg	Oceano Índico
Caribisc Sǣ	Mar do Caribe
Colorado	Colorado
Tuscania	Toscana
Alpis	Alpes
Gænt	Gante
Chicago	Chicago
The Beatles	The Beatles
Winter	Inverno
Ēawielm	Primavera
Efenniht	Equinócio
Spēonisc sprǣc	Língua castelhana
Caligardamana	Calcutá
West Bengal	Bengala Ocidental
Ātorcoppe	Aranha
Virginia	Virgínia
Westvirginia	Virgínia Ocidental
Nīwe Eoforwīc	Nova Iorque (estado)
Rhode Īeg	Rhode Island
Ceorfdēor	Insetos
Marianland	Maryland
Delaware	Delaware
Fladimir Lenin	Lenin
Ohio	Ohio
Pennsylvānia	Pensilvânia
Uetersen	Uetersen
Augustus	Augusto
Microsoft Windows	Microsoft Windows
Nīwe Cēsarēa	Nova Jérsia
Calpis	Gibraltar
Finnisc sprǣc	Língua finlandesa
Indiǣna	Indiana
Selffērende wægn	Automóvel
Roger Federer	Roger Federer
Georgia (America)	Geórgia (Estados Unidos)
Marcus Aurelius	Marco Aurélio
Texas	Texas
Puilla	Apúlia
Norþcarolīna	Carolina do Norte
Sūþcarolīna	Carolina do Sul
Sicilia	Sicília
Sardinia	Sardenha
Ligore	Rio Loire
Sigen	Sena
Buenos Aires	Buenos Aires
Mexicoburg	Cidade do México
Pīnæppel	Ananás
Mississippi	Mississippi
Mississippi ēa	Rio Mississippi
Mizoram	Mizoram
Tennessee	Tennessee
Abu Dhabi	Abu Dhabi
Nīwe Mexico	Novo México
Athēnas	Atenas
Minnesota	Minnesota
Wisconsin	Wisconsin
Iowa	Iowa
Nebraska	Nebraska
Kansas	Kansas
Hafana	Havana
Pīpwēod	Tabaco
Missouri	Missouri
Louisiāna	Luisiana
Nagaland	Nagaland
Kentucky	Kentucky
Arkansas	Arkansas
Ælf ēa	Rio Elba
Oklahoma	Oklahoma
Donua	Rio Danúbio
Hæfel	Rio Havel
Norþsǣ	Mar do Norte
Flēogeball	Voleibol
Uigenna	Viena
Cēapmannahæfen	Copenhaga
Stoccholm	Estocolmo
Helsinki	Helsínquia
Difelin	Dublin
Rēcwīc	Reykjavík
Riga	Riga
Menuþias	Zanzibar
Dantsic	Gdańsk
Frankfurt	Frankfurt am Main
Death Note	Death Note
Biblioþēce	Bíblia
Ho Chi Minh Burg	Cidade de Ho Chi Minh
Sōþ Iesus Cirice	Verdadeira Igreja de Jesus
Nīwenglisc sprǣc	Língua inglesa
Andorra la Vella	Andorra-a-Velha
Đồng Hới	Dong Hoi
Concepcion	Concepción (Chile)
Cænugeard	Kiev
Ontario	Ontário
Ottawa	Ottawa
Alberta	Alberta
Nīwe Scotland	Nova Escócia
Końskowola	Końskowola
Geocon Landscipe	Yukon
Florentia	Florença
Ǣt	Alimento
Snaca	Serpente
Halifax	Halifax
Quebecceaster	Quebec (cidade)
3. Æfterran Gēolan	3 de janeiro
4. Æfterran Gēolan	4 de janeiro
Región del Biobío (Cile)	Bío-Bío (região)
5. Æfterran Gēolan	5 de janeiro
Arica	Arica
6. Æfterran Gēolan	6 de janeiro
7. Æfterran Gēolan	7 de janeiro
8. Æfterran Gēolan	8 de janeiro
9. Æfterran Gēolan	9 de janeiro
10. Æfterran Gēolan	10 de janeiro
11. Æfterran Gēolan	11 de janeiro
12. Æfterran Gēolan	12 de janeiro
13. Æfterran Gēolan	13 de janeiro
Beormingahām	Birmingham
14. Æfterran Gēolan	14 de janeiro
15. Æfterran Gēolan	15 de janeiro
16. Æfterran Gēolan	16 de janeiro
17. Æfterran Gēolan	17 de janeiro
18. Æfterran Gēolan	18 de janeiro
Rōmānisc Rīce	Império Romano
Microsoft	Microsoft
30. Æfterran Gēolan	30 de janeiro
Kurów	Kurów
11. Solmōnðes	11 de fevereiro
11. Gēolmōnþes	11 de dezembro
12. Gēolmōnðes	12 de dezembro
17. Gēolmōnðes	17 de dezembro
Wæþ	Rio Forth
Þrittiggēara Orlege	Guerra dos Trinta Anos
Benedictus XVI Pāpa	Papa Bento XVI
6. Ēastermōnðes	6 de abril
4. Ēastermōnþes	4 de abril
Helmut Kohl	Helmut Kohl
17. Ēastermōnðes	17 de abril
12. Þrimilcemōnþes	12 de maio
13. Þrimilcemōnþes	13 de maio
20. Þrimilcemōnðes	20 de maio
31 Þrimilcemōnaþ	31 de maio
6. Mǣdmōnðes	6 de julho
1. Mǣdmōnðes	1 de julho
18. Mǣdmōnðes	18 de julho
Gyldfōtþōðer	Futebol
26. Gēolmōnðes	26 de dezembro
Eallbærnet	Holocausto
IPad	IPad
Madrid	Madrid
Elton John	Elton John
Undersǣbāt	Submarino
26. Wēodmōnðes	26 de agosto
24. Wēodmōnðes	24 de agosto
2. Hāligmōnþes	2 de setembro
Kassel	Kassel
Canadisc underrīcu	Províncias e territórios do Canadá
25. Hāligmōnðes	25 de setembro
Santiago (Cile)	Santiago (Chile)
1. Winterfylleðes	1 de outubro
14. Winterfylleðes	14 de outubro
8. Winterfylleðes	8 de outubro
7. Winterfylleðes	7 de outubro
Oldenburg (Oldenburg)	Oldemburgo
26. Winterfylleðes	26 de outubro
4. Blōtmōnðes	4 de novembro
1. Blōtmōnðes	1 de novembro
Wolfsburg	Wolfsburg
Carl Micela Francena Cyning	Carlos Magno
Canberra	Camberra
Sydney	Sydney
Grēne	Verde
Rēad	Vermelho
Perþ (Australia)	Perth (Austrália Ocidental)
Fȳr	Fogo
Westerne Australia	Austrália Ocidental
Nīwe Sūþwealas	Nova Gales do Sul
Norþerne Landscipe	Território do Norte
Australisc Hēafodbyrig Landscipe	Território da Capital Australiana
Fīfeldor	Rio Eider
Nīl	Rio Nilo
Heortfordscīr	Hertfordshire
Comēta	Cometa
Angol	Angol
Antofagasta	Antofagasta
Ancyra	Ancara
Flocc:Bysen	Categoria:!Predefinições Wikipédia
Castro (Cile)	Castro (Chile)
Frencisc Guiana	Guiana Francesa
Chillán (Cile)	Chillán
Amāzanēa	Rio Amazonas
Tybingen	Tubinga
Coyhaique	Coihaique
Flocc:Bysen Land	Categoria:!Predefinições sobre países
Flocc:Bysen tīd	Categoria:!Predefinições para tempo
Willelmeshæfen	Wilhelmshaven
Copiapó (Cile)	Copiapó
Manama	Manama
Delmenhorst	Delmenhorst
Brandenburg (burg)	Brandemburgo no Havel
Wikipǣdia:Sandbox	Wikipédia:Página de testes
Wikipǣdia:Inlǣdung	Wikipédia:Introdução
Cantabria	Cantábria
Hūs	Casa
Rīmagiefung	Álgebra
Mennisc bodiglār	Anatomia humana
Osasco	Osasco
Fujairah	Al Fujayrah
Glasgow	Glasgow
Donghoi Lyfthæfene	Aeroporto de Dong Hoi
Rodor	Espaço sideral
Sweartweald	Floresta Negra
Curitiba	Curitiba
Weald	Floresta
Flocc:Cliferfētedēor	Categoria:Artiodáctilos
Talca	Talca
Flothere	Marinha
Andalién	Rio Andalién
Bysen:Lang-lt	Predefinição:Lang-lt
Cwidbōc	Livro dos Provérbios
Rancagua	Rancagua
Confucius	Confúcio
Corbin Bleu	Corbin Bleu
Flocc:Rīmcræft	Categoria:Matemática
Faroisca Īega	Ilhas Feroe
Wendelsǣ	Mar Mediterrâneo
Flocc:Nīwes Sǣlandes īga	Categoria:Ilhas da Nova Zelândia
Cōcnearuness	Estreito de Cook
Crīstendōm	Cristianismo
Windows 8	Windows 8
Bysen:Asia	Predefinição:Países da Ásia
Gandis	Rio Ganges
Worulddǣl	Continente
Fugol	Aves
Hēafodstōl	Capital
Monzón	Monzón
Portuglisc sprǣc	Língua portuguesa
Mōnaþ	Mês
Almazán	Almazán
Huang Siānfan	Huang Xianfan
Kescwisc sprǣccynn	Língua quíchua
Bill Gates	Bill Gates
Iapanisc sprǣc	Língua japonesa
Wīsdōmbōc	Enciclopédia
Hēafodtramet	Wikipédia:Página principal
Golf	Golfe
Hrōcburhfōtþōðer	Rugby
Olympisc Gamen	Jogos Olímpicos
Eurasia	Eurásia
Andes	Cordilheira dos Andes
Durban	Durban
Caspia	Mar Cáspio
Uictoriamere	Lago Vitória
Babilōn	Babilônia (cidade)
Ēalendisca Īega	Åland
Cægman Īegland	Ilhas Cayman
Novak Đoković	Novak Djokovic
Fortunatus iegland	Canárias
Ūðwitegung	Filosofia
Flocc:Candidates for speedy deletion	Categoria:!Páginas para eliminação rápida
Tē	Chá
Hebe Camargo	Hebe Camargo
Gemǣnre ǣhte rǣd	Comunismo
Wealdlīste rǣd	Anarquismo
Ǣhtwealdes endebyrdness	Capitalismo
Frēodōmes þōht	Liberalismo
Gilmrǣd	Fascismo
Cofentreo	Coventry
Lodi	Lodi
Ōðre Penisc Gūþ	Segunda Guerra Púnica
Cartaina	Cartago
Bryttisc Museum	Museu Britânico
Sund	Natação
1451	1451
Ellaspontus	Dardanelos
Strǣtburg	Estrasburgo
Gytārre	Guitarra
Croatisc sprǣc	Língua croata
Cesena	Cesena
Hāmburgere	Hambúrguer
Fédération Internationale de Volleyball	Federação Internacional de Voleibol
20e gēarhundred	Século XX
Stefan Raab	Stefan Raab
Catalan sprǣc	Língua catalã
11e gēarhundred	Século XI
Gelēaflēasnes	Ateísmo
Cynn scī huang	Qin Shihuang
Elisabeþ I Engla Cwēn	Isabel I de Inglaterra
Cynewīse	República
Þēodlices gemǣnscipes rǣd	Nazismo
Nazi Þēodscland	Alemanha Nazi
Christopher Columbus	Cristóvão Colombo
Iacobus Cōc	James Cook
Ēare	Orelha
Nasu	Nariz
Ēage	Olho
Scēap	Ovis aries
Mereswīn	Golfinho
Sǣhund	Tubarão
Sycedēor	Mamíferos
Ǣmette	Formiga
Bēo	Anthophila
Niðerlendisc sprǣc	Língua neerlandesa
Ǣȝƿyrt	Beringela
Draca	Dragão
Mōdor	Mãe
Snāw	Neve
Wæterþōðer	Polo aquático
1865	1865
Napoleon III Francena Casere	Napoleão III de França
Russisc sprǣc	Língua russa
Hloþwig XIV Francena Cyning	Luís XIV de França
Hām	Lar
Vladimir Putin	Vladimir Putin
Loðwic-Philippus Francena Cyning	Luís Filipe I de França
Þēodacynewīse	Commonwealth
Hlāf	Pão
Līfclēofa	Célula
Blōd	Sangue
Īwungplega	Jogo eletrônico
Rumǣnisc sprǣc	Língua romena
Regn	Chuva
Medumweder	Clima
Woruldlicu wearmung	Aquecimento global
Eorþbeofung	Sismo
Museum on Dēoraby	Derby Museum and Art Gallery
Winston Churchill	Winston Churchill
Nelson Mandela	Nelson Mandela
10. gēarhundred	Século X
Fȳrbeorg	Vulcão
Wolcen	Nuvem
Īwungplegtōl	Console de videogame
Wind	Vento
Lyfthelm	Atmosfera
Sprǣccræft	Linguística
Flocc:Pulgaraland	Categoria:Bulgária
Flocc:Francland	Categoria:França
Flocc:Glīƿdrēam	Categoria:Música
Flocc:Bōccræft	Categoria:Literatura
Fox	Raposa-vermelha
Valladolid	Valladolid
Alexander Mæcedonia Cyning	Alexandre, o Grande
Hēaphandþōðer	Andebol
Hugo Chávez	Hugo Chávez
Þēowdōm	Escravidão
Caffig	Café
Meolc	Leite
Beorg	Montanha
Oferswefn	Hipnose
Andrew Johnson	Andrew Johnson
Miami	Miami
Americanisce Ingefeoht	Guerra de Secessão
Rio de Janeiro	Rio de Janeiro (cidade)
Bryttisce Rīce	Império Britânico
Albanisc sprǣc	Língua albanesa
Ucrægnisc sprǣc	Língua ucraniana
Crabba (steorra)	Cancer
Swēonisc sprǣc	Língua sueca
Denisc sprǣc	Língua dinamarquesa
Norðisc sprǣc	Língua norueguesa
Noam Chomsky	Noam Chomsky
Bæmisc sprǣc	Língua tcheca
Karl Marx	Karl Marx
Lettisc sprǣc	Língua letã
Liþþuanisc sprǣc	Língua lituana
Hinduismus	Hinduísmo
Wīflicu brēost	Mama
Mot	Átomo
Crēacisc sprǣc	Língua grega
Weorcendebyrdness	Sistema operativo
Īrisc sprǣc	Língua irlandesa
Ambihtlic Cīnisc sprǣc/ᚱᚢᚾ	Língua mandarim
C. S. Lewis	Clive Staples Lewis
Baku	Baku
Hebrēisc sprǣc	Língua hebraica
Azeri sprǣc	Língua azeri
Wilisc sprǣc	Língua galesa
Scyttisce sprǣc	Língua gaélica escocesa
John Locke	John Locke
Friedrich Nietzsche	Friedrich Nietzsche
Lifere	Fígado
Drēag (Fūdū)	Zumbi
Gārsecg	Oceano
Gautama Budda	Sidarta Gautama
Premier League	Premier League
Mahomet	Maomé
Ācweorna	Esquilo
Rēmisc Cirice	Igreja Católica
Bengalisc sprǣc	Língua bengali
Tunge	Língua
Folcland Īegland	Ilhas Malvinas
Manīeg	Ilha de Man
Wiht (īeg)	Ilha de Wight
Elisabeþ II	Isabel II do Reino Unido
ß	ß
John F. Kennedy	John F. Kennedy
Ronald Reagan	Ronald Reagan
Æ	Æ
Ð	Ð
Fernando Alonso	Fernando Alonso
Flocc:Feneswela	Categoria:Venezuela
Þunreshæfen	Tórshavn
11. Hāligmōnþes 2001. torngemōt	Ataques de 11 de setembro de 2001
Culfre	Columbidae
Trēow	Árvore
Cīese	Queijo
Wīnberge	Uva
Hunig	Mel
Eorþperu	Batata
Searuþræl	Robô
Searucræft	Tecnologia
Feorrspreca	Telefone
Lugo	Lugo (Galiza)
Hēahdēmere þāra Geāndena Rīca American	Chefe de Justiça dos Estados Unidos
Windows 7	Windows 7
Windows Vista	Windows Vista
World Trade Center	World Trade Center
Nelson Rockefeller	Nelson Rockefeller
David Rockefeller	David Rockefeller
One World Trade Center	1 World Trade Center
Fidel Castro	Fidel Castro
Rockefeller Center	Rockefeller Center
Flocc:Brasil	Categoria:Brasil
Flocc:Rumǣnia	Categoria:Roménia
Hēafodgesceaft	Elemento (química)
Gemot	Molécula
Cræftlicu endebyrdung	Classificação científica
Lyft	Gás
Lyftcræft	Aeronave
Clāðas	Roupa
Swēg	Som
Paper	Papel
Rīm	Número
Bere	Cevada
Nirvana	Nirvana (banda)
Weder	Tempo (meteorologia)
Land þǣre worulde	Lista de Estados soberanos
Bera	Ursidae
John Adams	John Adams
Thomas Jefferson	Thomas Jefferson
James Madison	James Madison
James Monroe	James Monroe
John Quincy Adams	John Quincy Adams
Andrew Jackson	Andrew Jackson
Martin Van Buren	Martin van Buren
William Henry Harrison	William Henry Harrison
John Tyler	John Tyler
James K. Polk	James K. Polk
Zachary Taylor	Zachary Taylor
Ǣtweg	Digestão
Kylie Minogue	Kylie Minogue
Āc	Carvalho
Pīntrēow	Pinheiro
Āte	Aveia-comum
Hwǣte	Trigo
Corn	Cereal
Unmeaht	Deficiência
Gerīmbōc	Calendário
Ādl	Doença
Gregorisc gerīmbōc	Calendário gregoriano
Soria	Sória
Manisc sprǣc	Língua manesa
Bysen:Stedefindend scite Breten	Predefinição:Mapa de localização/Reino Unido
Millard Fillmore	Millard Fillmore
Franklin Pierce	Franklin Pierce
James Buchanan	James Buchanan
Pireni	Pireneus
Hālig Rōmānisc Rīce	Sacro Império Romano-Germânico
Mongolrīce	Império Mongol
Oþomanisce Rīce	Império Otomano
Cirice Ednīwung	Reforma Protestante
Wīcingas	Vikings
Sweord	Espada
Fȳrwǣpen	Arma de fogo
Iberia	Península Ibérica
Fȳrspringend	Explosivo
Campwægn	Carro de combate
Antwerpen	Antuérpia
Brycg (burh)	Bruges
Blæcberige	Amora-silvestre
Fenberge	Oxicoco
Cīnisc gōsberige	Quiuí
Retoromanisc sprǣc	Língua romanche
Īsrēam	Sorvete
Ceace	Bolo
Īsbrīw	Gelado de fruta
Dinegisc sprǣc	Língua navaja
Meolcbrīw	Iogurte
Montserrat	Montserrat
Bysen:Location map Greenland	Predefinição:Mapa de localização/Gronelândia
Wikicynn	Wikispecies
Arabisc sprǣc	Língua árabe
Ian Magen	Jan Mayen
Corsica	Córsega
Affricanisc sprǣc	Língua africâner
Forma Þegn þæs Geānedan Cynerīces	Primeiro-ministro do Reino Unido
Santiago de Compostela	Santiago de Compostela
Fiscoþ	Pesca
Iquique	Iquique
La Serena (Cile)	La Serena
Las Condes	Las Condes
Lebu	Lebu
Lo Barnechea	Lo Barnechea
Niðerscyttisc sprǣc	Scots
Linux (cyrnel)	Linux (núcleo)
Darwin (æhtendebyrd)	Darwin (sistema operacional)
Emmen	Emmen (Países Baixos)
Sofiet Gesamnung	União Soviética
Se Hlāford þāra Hringa	O Senhor dos Anéis
Hrūse	Crosta
Sīensearu	Câmera
Gaðes	Cádis
Llión	Leão (Espanha)
Fōt	Pé
Queen	Queen
Freddie Mercury	Freddie Mercury
Normandig	Normandia
Metallica	Metallica
Wikipǣdia:Fulgōd gewritu	Wikipédia:Artigos destacados
Bysen:Link FA	Predefinição:Link FA
Wikipǣdia:Se Þorpes Wella	Wikipédia:Esplanada
Vermont	Vermont
Jacksonville, Florida	Jacksonville
Los Ángeles (Cile)	Los Ángeles (Chile)
Eþna	Etna
Æg	Ovo
Tibet	Tibete
Handsprecend	Telefone celular
Strȳta	Avestruz
Corēa	Coreia
Wesend	Bisonte
Mameceaster	Manchester
Turcas and Caicos Īegland	Turks e Caicos
Blēocræft	Bordado
Wulf	Lobo
Major League Soccer	Major League Soccer
Þōðer	Bola
Club de Gimnasia y Esgrima La Plata	Club de Gimnasia y Esgrima La Plata
Nīwu Gecȳþnes	Novo Testamento
Ælfric Ercebiscop of Cantawarabyrig	Elfrico de Abingdon
Middelseaxe	Middlesex
San Pedro de la Paz	San Pedro de la Paz
Scræf (fugol)	Cormorão
Dūfedoppa	Pelicano
Nha Trang	Nha Trang
Podolsk	Podolsk
Pāpa	Papa
Rafael Correa	Rafael Correa
5	5
Louvre	Museu do Louvre
Sæfern	Rio Severn
Temes	Rio Tâmisa
Tirana	Tirana
Motorhead	Motörhead
Afen	Rio Avon (Bristol)
6	6
Josh Duhamel	Josh Duhamel
Stīðen Āc	Stevenage
Crīstesmæsse	Natal
Bises	Ano bissexto
Steve Jobs	Steve Jobs
Indo-Europisc sprǣchīred	Línguas indo-europeias
Breinigerberg	Breinigerberg
Muammar al-Gaddafi	Muammar al-Gaddafi
Tiger	Tigre
Samsunghēap	Samsung
Ēaster	Páscoa
Germanisca sprǣca	Línguas germânicas
Windows Mobile	Windows Mobile
GNU Frēo Gewrita Amearcunge Lēaf	GNU Free Documentation License
John Kerry	John Kerry
Taiwan (īeg)	Ilha Formosa
Searusprecend	Smartphone
Trōia	Troia
Nīwe Eoforwīc (scīrung)	Nova Iorque (desambiguação)
Ceafer	Besouro
Scōh	Sapato
Baðanceaster	Bath (Somerset)
Īrland	Irlanda (ilha)
Bradanford	Bradford (West Yorkshire)
Ceasterscīr	Cheshire
Lonceasterscīr	Lancashire
Norþhymbraland	Northumberland
Dūnholmscīr	Condado de Durham
Lincolnscīr	Lincolnshire
Snotingahāmscīr	Nottinghamshire
Dēorabyscīr	Derbyshire
Scrobbesbyrigscīr	Shropshire
Stæffordscīr	Staffordshire
Lægreceastrescīr	Leicestershire
Roteland	Rutland
Norþfolc	Norfolk (Inglaterra)
Sūþfolc	Suffolk
Grantabrycgscīr	Cambridgeshire
Norþhāmtūnescīr	Northamptonshire
Westmidlandscīr	Midlands Ocidentais (condado)
Herefordscīr	Herefordshire
Wigreceastrescīr	Worcestershire
Wæringscīr	Warwickshire
Beadanfordscīr	Bedfordshire
Cornweal	Cornualha
Bricgstōw	Bristol
Defenascīr	Devon
Sumorsǣte	Somerset
Dorsǣte	Dorset
Gleawcesterscīr	Gloucestershire
Oxnafordscīr	Oxfordshire
Wiltūnscīr	Wiltshire
Hāmtūnescīr	Hampshire
Bearrucscīr	Berkshire
Buccingahāmscīr	Buckinghamshire
Ēastseaxe	Essex
Sūþrīge	Surrey
Cent	Kent
Lundenceaster	Cidade de Londres
Westmoringaland	Westmorland
Sūþseaxe	Sussex
Seofon	Sete
Taylor Lautner	Taylor Lautner
Jeremy Renner	Jeremy Renner
Īs	Gelo
Fæder ūre	Pai Nosso
Musée d'Orsay	Museu de Orsay
Hwerhwette	Pepino
Edinburg	Edimburgo
Hwīt	Branco
Sweart	Preto
Chris Pine	Chris Pine
Lordi	Lordi
6 (getæl)	Seis
Ambihtlicu sprǣc	Língua oficial
Heortæppel	Tomate
Phong Nha-Ke Bang	Parque Nacional de Phong Nha-Kẻ Bàng
Entrena	Entrena
Selena	Selena
NASA	NASA
Merida (Feneswela)	Mérida (Venezuela)
Atlanta	Atlanta
Benito Mussolini	Benito Mussolini
Bermuda	Bermudas
Hēafod	Cabeça
Weolingtūn (Nīwe Sǣland)	Wellington
Bryten	Grã-Bretanha
Alfred Nobel	Alfred Nobel
Camb (tō hǣre)	Pente
Mennisc līc	Corpo humano
Lila Downs	Lila Downs
Andrew Garfield	Andrew Garfield
Dottatiger	Acinonyx jubatus
Rosanna Davison	Rosanna Davison
Albany on Nīwum Eoforwīce	Albany (Nova Iorque)
Ūle	Strigiformes
Anguilla	Anguilla
Guernsey	Guernsey
Scearpbeorgas	Svalbard
Hrycgdēor	Vertebrados
Nowy Dwór Królewski	Nowy Dwór Królewski
Faroisc sprǣc	Língua feroesa
Catt	Felidae
Lytel Spēonland	Ilha de São Domingos
Harrisburg	Harrisburg
Hamor	Martelo
Picilemo	Pichilemu
Bryttiscan Fæmne Īegland	Ilhas Virgens Britânicas
Flēoge	Diptera
Norða	Ártico
Hund	Canídeos
Fresisc sprǣc	Língua frísia
Antoni Gaudí	Antoni Gaudí
Cliferfētedēor	Artiodátilos
Steorrfisc	Estrela-do-mar
Eurasisc bleohcrāwe	Gaio-comum
Hrōc	Gralha-calva
Ēotaland	Jutlândia
Niþeru Þēodsc sprǣc	Baixo-alemão
Mölnlycke	Mölnlycke
Coning	Coelho-europeu
Cuscan Rīce	Império Kushana
Tromsīeg	Tromsø
Eormengyld Niccolò Cusano	Università degli Studi Niccolò Cusano
Montpelier on Uermonte	Montpelier (Vermont)
Geac	Iaque
Palistiniscre Frēogunge Þēodnes	Organização para a Libertação da Palestina
Westgermanisca sprǣca	Línguas germânicas ocidentais
Taylor Swift	Taylor Swift
Cōcīega	Ilhas Cook
Brocc	Texugo-europeu
Middelasia	Ásia Central
Langaland	Langeland
Sealterland	Saterland
Ofersǣwisc rind	Canela
Jackson (Mississippi)	Jackson (Mississippi)
Concord (Nīwu Hāmtūnscīr)	Concord (Nova Hampshire)
Annapolis	Annapolis (Maryland)
Eald Corēa	Período Gojoseon
Hreaðemūs	Morcego
Ēastrīce-Ungerland	Áustria-Hungria
Tarnobrzeg	Tarnobrzeg
Wesle	Mustela
Scīr	Condado
Sandwīc (ǣt)	Sanduíche
Spearwa	Passeridae
Eormanrīc	Hermenerico
Francisco Franco	Francisco Franco
Tarja Halonen	Tarja Halonen
Willis Tower	Willis Tower
Cantwaraburg	Cantuária
Cīna	China (civilização)
Universidad Mayor	Universidade Mayor
Tracter	Funil
Englisc lagu	Common law
Seolh	Pinípedes
Ecser	Ecser
Silesisc gereord	Língua silesiana
Zhengzhou	Zhengzhou
Foresittend	Presidente
Frencisc Polynesia	Polinésia Francesa
Roðem	Ruão
Crīstesmæsse Īeg	Ilha Christmas
Bleohfugol	Psittaciformes
Cambihtere	Cacatua
Arabea	Arábia
Fȳstlāc	Boxe
Seax	Faca
Top Gear	Top Gear (2002)
Tasmansǣ	Mar de Tasman
Ceroke sprǣc	Língua cherokee
Campwīg be Tannebeorge	Batalha de Grunwald
Īsbera	Ursus maritimus
Hand	Mão
Tu Fu	Du Fu
Nīwe Scotta Ēaland	Nova Caledónia
Cecoslofacia	Checoslováquia
Lēaf	Folha
Nepal Bhasa	Língua neuari
Valparaíso (on Cilan)	Valparaíso (Chile)
Fugolīeg, Sūþgeorgia	Ilha Bird
Annenkovīeg	Ilha Annenkov
Nathalia Dill	Nathalia Dill
Oaxaca	Oaxaca
Tahitisc sprǣc	Língua taitiana
Flemisc sprǣc	Língua flamenga
Yasser Arafat	Yasser Arafat
Oxnaford	Oxford
Międzyrzec Podlaski	Międzyrzec Podlaski
Tasmania	Tasmânia
Creto	Creta
Saint-Dié-des-Vosges	Saint-Dié-des-Vosges
Eormengyld Oxnafordes	Universidade de Oxford
Þyrla	Helicóptero
Sancte Elene Īeg	Santa Helena (ilha)
Nicor	Hipopótamo-comum
Egisca Sǣ	Mar Egeu
Ichiro Mizuki	Ichiro Mizuki
Anastacia	Anastacia
Eufrāte	Rio Eufrates
James A. Garfield	James A. Garfield
Cirice	Igreja
Persisc Sǣ	Golfo Pérsico
Sand	Areia
Cyningestūn (Iamaica)	Kingston
Lafor	Leopardo
Age of Empires	Age of Empires
Tequixquiac	Tequixquiac
Ulysses S. Grant	Ulysses S. Grant
Oklahoma City	Oklahoma City
Meotedisca Mere	Mar de Azov
William McKinley	William McKinley
Cawel	Repolho
Foresittend þāra Geāndena Rīca	Lista de presidentes dos Estados Unidos
Sūþgeorgia and þā Sūþsandwic Īegland	Ilhas Geórgia do Sul e Sandwich do Sul
Webbsīde	Site
Catalão	Catalão (Goiás)
Grover Cleveland	Grover Cleveland
Ealdhēahþēodisc	Alto-alemão antigo
Ealdseaxisc sprǣc	Saxão antigo
Satan	Satanás
Wordstǣrcræft	Etimologia
Beorglēo	Puma concolor
Arabas	Árabes
Proponditis	Mar de Mármara
Ēagduru	Janela
Chester A. Arthur	Chester A. Arthur
Riffeng	Montes Urais
Rīcu þāra Geāndena Rīca American	Estados dos Estados Unidos
Pitcearnīega	Ilhas Pitcairn
Benjamin Harrison	Benjamin Harrison
Rutherford B. Hayes	Rutherford B. Hayes
Wīnlendisc panðer	Onça-pintada
Sūþaustralia	Austrália Meridional
Gotisc sprǣc	Língua gótica
Boise	Boise
Bāt	Barco
Awaisc sprǣc	Língua guarani
Gærsbēam	Bambu
Interlingua	Língua interlíngua
Bosporos	Bósforo
Smyrna	Esmirna
Lemburg	Lviv
Cwēneland	Queensland
Siligo	Siligo
Puerto Montt	Puerto Montt
Iane Austen	Jane Austen
Tægcwondo	Taekwondo
Middel Englisc sprǣc	Inglês médio
Māorisc sprǣc	Língua maori
Hannibal	Aníbal
Hōrdōm	Prostituição
Twinemniendlic nama	Nomenclatura binomial
Victoria (Australia)	Vitória (Austrália)
Geugoslafia	Jugoslávia
Ætla	Átila
Scrælingas	Povos ameríndios
Arancón	Arancón
Willelm Heretoga of Grantanbrycge	Guilherme, Duque de Cambridge
Toshiro Mifune	Toshiro Mifune
Tallahassee	Tallahassee
Sundorrīcehād	Independência
Bismarck (Norþdakota)	Bismarck (Dacota do Norte)
Aucland	Auckland
Iohannes Paulus I Pāpa	Papa João Paulo I
John Michael Talbot	John Michael Talbot
Acrotiri and Ðecelia	Acrotíri e Deceleia
Arara	Arara (Paraíba)
Cnēo	Joelho
Willelm I Engla Cyning	Guilherme I de Inglaterra
Campora Sancte Iohannes	Campora San Giovanni
Sīde	Seda
Sint-Truiden	Sint-Truiden
Lēoðlic scātung	Patinação artística no gelo
Stefn (līfcræft)	Filo
Heanrig VIII Engla Cyning	Henrique VIII de Inglaterra
Columbia (Sūþcarolīna)	Colúmbia (Carolina do Sul)
Xena: Warrior Princess	Xena: Warrior Princess
1880. gēar oþ 1889. gēar	Década de 1880
Helena (Montana)	Helena (Montana)
Wælhwelp	Cão de caça
Eormengyld Biobiwes	Universidade do Bío-Bío
Sufa	Suva
Muntgumniscīr	Montgomeryshire
Eorþmistel	Manjericão-de-folha-larga
Lēohtfȳsend	Laser
Prēossland	Prússia
Cheyenne (Wyoming)	Cheyenne (Wyoming)
Norðerne healftrendel	Hemisfério norte
Loidis	Leeds
Fūcgī Beorg	Monte Fuji
Mūs	Mus
Geolurēad	Laranja (cor)
Æcs	Machado
Seofonbyrig	Transilvânia
Tōl	Ferramenta
Alī	Ali
Hrān	Rena
Stānhencg	Stonehenge
Ágreda	Ágreda
Amazonas	Amazonas
Ajaccio	Ajaccio
Rodorcræft	Nave espacial
Lisa Gerrard	Lisa Gerrard
Thirty Seconds to Mars	30 Seconds to Mars
Paulínia	Paulínia
Pierre	Pierre (Dakota do Sul)
Crabba	Caranguejo
God Nerie þā Cwēne	God Save the Queen
Meteūtsiht	Diarreia
Anna Maria Jopek	Anna Maria Jopek
Horshwæl	Morsa
Fōrhēafod	Testa
Haile Selassie	Haile Selassie
Caðum	Caen
Sonygegyld	Sony
Mynet	Moeda (peça)
Sūðerne Healftrendel	Hemisfério sul
Cnihtas þæm Temple	Ordem dos Templários
Americanisc fōtball	Futebol americano
Tōþsticca	Palito
Folcmorðor	Genocídio
Hociȝ	Hóquei no gelo
Swīnmūþa	Świnoujście
Īrisc Sǣ	Mar da Irlanda
Tracia	Trácia
Mongolas	Mongóis
Mǣs	Rio Mosa
Talcahuano	Talcahuano
Tahitīeg	Taiti
Ontynung	Apocalipse
Abel Tasman	Abel Tasman
Gotan	Godos
Nettfrumfindend	URL
Ænglisc sprǣc	Inglês antigo
Englisc folc	Ingleses
Eoforwic	Iorque
Iron Maiden	Iron Maiden
Asterix	Asterix
Grǣg	Cinza
Wearm geard	Trópico
Hwælhuntoþ	Baleação
Sǣcū	Peixe-boi
Gregorius Pāpa I	Papa Gregório I
Cȳta (lyftcræft)	Pipa (brinquedo)
Þunor	Thor
Castel Goffredo	Castel Goffredo
Roðos	Rodes
Sanct	Santo
Wikipǣdia:FAQ	Ajuda:FAQ
Cycene	Cozinha
Wæterdraca	Crocodilo
Hlæstwægn	Camião
Carl Wēala Þēoden	Carlos, Príncipe de Gales
Villeneuve-d'Ascq	Villeneuve-d'Ascq
Crāwe	Corvo
Sūþtun on Defnum	Plymouth (Devon)
Bryttisca Indisca Garsecg Landscipe	Território Britânico do Oceano Índico
Dēoraby	Derby (Derbyshire)
Francan	Francos
Fealcen	Falcão
Nightwish	Nightwish
Mattheus se Godspellere	Mateus (evangelista)
Mac OS	Mac OS
Leyden	Leida
Montehermoso	Montehermoso
Louis the Pious	Luís I de França
Cwēnsǣ	Mar Branco
Jim Morrison	Jim Morrison
GNOME	GNOME
Hāt	Calor
Spere	Lança
Ēadig getæl	Número feliz
Charleston (Westvirginia)	Charleston (Virgínia Ocidental)
Mynster	Mosteiro
Oxnaford Englisc Wordbōc	Oxford English Dictionary
Īsearn	Guarda-rios
Carl XVI Gustaf Swēona Cyning	Carlos XVI Gustavo da Suécia
Świętochłowice	Świętochłowice
Zac Efron	Zac Efron
Monte Carlo	Monte Carlo
Elba	Ilha de Elba
The Doors	The Doors
Fylfōt	Suástica
Clerke Clūdas	Rochas Clerke
Hara	Lebre
Rīcisc edisc	Parque nacional
Boga	Arco (arma)
Byrdling	Testudinidae
Bryttisc landbūnes	Territórios britânicos ultramarinos
Brūn	Marrom
Hjaltland	Shetland
Byrddæg	Aniversário
Æx-in-Profentse	Aix-en-Provence
Gaza	Gaza
Īsbeorg	Iceberg
Ephese	Éfeso
Englisc wera rīcisc fōtballtēam	Seleção Inglesa de Futebol
Pratibha Patil	Pratibha Patil
Minte	Mentha
Spilcarte	Baralho
Bysen:Commonscat	Predefinição:Commonscat
Hālig Land	Terra Santa
Folcland Gewinn	Guerra das Malvinas
Bēowulf	Beowulf
Marīahæfen	Mariehamn
Hrǣw	Cadáver
IOS	IOS
Lee Harvey Oswald	Lee Harvey Oswald
Frumtæl	Número primo
Þ	Thorn (letra)
Orlando	Orlando
Saint Petersburg	São Petersburgo (Flórida)
Hereðaland	Hordaland
Sogn and þa Flēotas	Sogn og Fjordane
Meore and Romsdæl	Møre og Romsdal
Troms	Troms
Dǣlere	Divisor
Australisc fōtþōðer	Futebol australiano
Secglēac	Allium schoenoprasum
Stānweall sacunga	Rebelião de Stonewall
Providencia (Cile)	Providencia (Chile)
Punta Arenas	Punta Arenas
Aaron	Aarão
Wu-Tang Clan	Wu-Tang Clan
Osgar I Swēona Cyning	Óscar I da Suécia
Hwēolrinnung	Ciclismo
Aquilegia	Aquileia
Hyll	Morro
Flocc:Cyningas	Categoria:Reis
Beorneslēah	Barnsley
Soria (scīr)	Sória (província)
San Carlos (on Cilan)	San Carlos (Chile)
El Royo	El Royo
Harold V Norrena Cyning	Haroldo V da Noruega
Þēodlic Dæg	Feriado nacional
John Key	John Key
Ēadweard I Engla Cyning	Eduardo I de Inglaterra
Sūþerne Thila	Thule do Sul
Ræt	Muroidea
Vladimír Franz	Vladimír Franz
Ariel Sharon	Ariel Sharon
1050e	Década de 1050
Æneid	Eneida
Autaugaville, Alabama	Autaugaville
Forma Frencisce Rīce	Primeiro Império Francês
Brādford	Bredevoort
Se Holbytla	O Hobbit
Eocene	Eoceno
Strǣt	Rua
Superman	Superman
Heorotbrēr	Rhamnus
Wikipǣdia:Fulgōdra gewrita teohhunga	Wikipédia:Escolha do artigo em destaque
Rætswīn	Porquinho-da-índia
Iconium	Konya
Emma Goldman	Emma Goldman
Iacobus I Grēatre Bryten Cyning	Jaime VI da Escócia e I de Inglaterra
Crīstcirice	Christchurch
Coronel Fabriciano	Coronel Fabriciano
Babsk	Babsk
Englisca Ingewinn	Guerra civil inglesa
Bengal	Bengala
Morgenmete	Desjejum
1060e	Década de 1060
Pippen III Francena Cyning	Pepino, o Breve
Carl I (Grēatre Bryten Cyning)	Carlos I de Inglaterra
Ȝealdor/ᚷᛖᚪᛚᛞᚩᚱ	Magia
Cucler	Colher
Geþofted Rīcu American	Estados Confederados da América
Elpendbān	Marfim
Villarrobledo	Villarrobledo
Temuco	Temuco
Hloðwic I Francena Cyning	Clóvis
William Wallace	William Wallace
Bundesliga	Campeonato Alemão de Futebol
Fȳrland	Terra do Fogo
Frēols þǣre Sunnan (on Meridan)	Feria del Sol (Mérida)
Maria I Engla Cwēn	Maria I de Inglaterra
Angelcirice	Igreja Anglicana
Engla Cyning	Lista de monarcas da Inglaterra
Lencten (tīd)	Quaresma
Fuþorc	Runas
Lēactric	Alface
Beadu Hǣstingum	Batalha de Hastings
Ēadweard VI Engla Cyning	Eduardo VI de Inglaterra
Jacques-Yves Cousteau	Jacques-Yves Cousteau
Horatio Nelson	Horatio Nelson
Galilēa	Galileia
Gaderscypefāna	Bandeira do Reino Unido
Foldlic clūt	Litosfera
Þunor (weder)	Trovão
Þūma	Polegar
Ælfrēd Micela	Alfredo de Inglaterra
Hāmlǣrung	Ensino doméstico
Teutoburg Weald Beadu	Batalha da Floresta de Teutoburgo
Bysen:Cite book	Predefinição:Citar livro
O Canada	O Canada
Biobío	Rio Biobío
Orcanege	Órcades
Profentse	Provença
Predore	Predore
Seaxe	Saxões
Willelm II Engla Cyning	Guilherme II de Inglaterra
Limburgisc	Língua limburguesa
Eallerīca Gotena Cyning	Alarico
Tygelwīg	Cabo de guerra
Boētius	Boécio
Hunigbēo	Apis
Abbod	Abade
Mæcedonia	Macedônia (região)
Sameramis	Semíramis
Pīp	Cachimbo
Aerosol	Aerossol
Gangnihessou	Ganiehéssu
Ilfingburg	Elbląg
Mierce	Reino da Mércia
Þēodrīc Ēastgotena Cyning	Teodorico, o Grande
Westseaxena Rīce	Reino de Wessex
Hēahland	Terras Altas (Escócia)
Norþhymbra Rīce	Reino da Nortúmbria
Wulfila	Úlfilas
Bram Stoker's Dracula	Drácula de Bram Stoker
Angeow	Anjou
2011 FIFA Frēona Woruldceampscipe	Copa do Mundo de Futebol Feminino de 2011
Alexander VI Pāpa	Papa Alexandre VI
Mexiciscu rīce	Divisões políticas do México
Cethāmīga	Ilhas Chatham
Norþīg	Ilha Norte
Anne Cwēn	Ana da Grã-Bretanha
Sūþīeg	Ilha Sul
Dziecinów	Dziecinów (comuna de Otwock)
Sunnstede	Solstício
Wynton Rufer	Wynton Rufer
Regnwyrm	Minhoca
Kara	Kara (banda)
Ceadmere	Lago Chade
Getalu Rōmāniscra Cāsera	Lista de imperadores romanos
Heantun	Wolverhampton
Wascas	Bascos
Minerva	Minerva
Fȳræg	Bomba
Ashley Tisdale	Ashley Tisdale
Þrondham	Trøndelag
Nīwe Woruld	Novo Mundo
Fȳrweorc	Fogos de artifício
Æsc	Fraxinus
Galwæg	Galway
Ēadweard Andettere	Eduardo, o Confessor
Hramsa	Allium ursinum
Scīdfarung	Esqui
World of Warcraft	World of Warcraft
Byrig þāra Geāndena Rīca	Lista das cidades mais populosas dos Estados Unidos
Nemniendlic cāsus	Caso nominativo
Folcawanderung	Migrações dos povos bárbaros
Slayer	Slayer
Biliþ and lēoþcræft	IMMAGINE&POESIA
Maria Scotta Cwēn	Maria da Escócia
Indisc rīce	Estados e territórios da Índia
Scield	Escudo
Henry V Englalandes	Henrique V de Inglaterra
Sciþþia	Citas
Universidade Federal de Minas Gerais	Universidade Federal de Minas Gerais
Sceanca	Perna
Pulgare	Búlgaros
Lyftscip	Dirigível
Cnut se Micela	Canuto II da Dinamarca
Saturnus	Saturno (mitologia)
Exanceaster	Exeter
Sanctes Laurentes Ēa	Rio São Lourenço (América do Norte)
Mundlēow	Pia
Sūþhjaltland	Ilhas Shetland do Sul
Cartespil	Jogos de cartas
Basu Heorte	Purple Heart
Marianburg	Malbork
Monica Iozzi	Monica Iozzi
Carl Fǣtta Francena Cyning	Carlos, o Gordo
Þēodisc Āþbēorscipe	Confederação Germânica
Wikipǣdia:How to edit a page	Ajuda:Guia de edição/Formatação
Cantwarabyrig eorþbeofung 2011.	Sismo de Canterbury de 2011
Eorðæppelstycce	Batata frita
Rīnland	Renânia
Eormengyld Tybingenes	Universidade de Tubinga
Blōdmearh	Chouriço de sangue
Midsumor	Festa do Verão (Suécia)
Anlaf V Norrena Cyning	Olavo V da Noruega
Ēadweard Westseaxna Eorl	Eduardo, conde de Wessex
Hacun VII Norrena Cyning	Haakon VII da Noruega
Ecgbryht	Egberto de Wessex
Earnulf Carendran	Arnulfo da Caríntia
Bēda	Beda
Laplandes Gūþ	Guerra da Lapônia
Willelm-Alexander Niðerlanda Cyning	Guilherme Alexandre dos Países Baixos
Bredspearctellend	Tablet
Mathusal	Matusalém
Universidade Estadual de Feira de Santana	Universidade Estadual de Feira de Santana
Bægware	Bávaros
Europisc wild gingifer	Ásaro
Bēowyrt	Açoro
Pontcysyllte Wætertyge	Aqueduto de Pontcysyllte
Universidade Federal da Bahia	Universidade Federal da Bahia
Centro Federal de Educação Tecnológica de Minas Gerais	Centro Federal de Educação Tecnológica de Minas Gerais
Nēohwæl	Narval
Ajman	Ajman
Harold Godwinson	Haroldo II de Inglaterra
Ȳþrīdung	Surfe
Brū	Celha
Port:Stǣr	Bandeira do Tajiquistão
Kiæresburh	Cherbourg-Octeville
Bresl	Pretzel
CONCACAF	Confederação de Futebol da América do Norte, Central e Caribe
Mentha arvensis	Mentha arvensis
Searoburg	Salisbury
Lunden Ēage	London Eye
Valdivia	Valdivia (cidade)
Pachuca de Soto	Pachuca de Soto
Crāwlēac	Alho-das-vinhas
Dweorgedosle	Poejo
Landbūnes	Lista de territórios dependentes
Rēadingas	Reading
Mængo	Mangifera
Grēate Bryten Cynerīce	Reino da Grã-Bretanha
Brōcminte	Mentha longifolia
Iane Grey Hlæfdige	Joana Grey
Charmed	Charmed
Grammatisc cyn	Gênero gramatical
Nica Ūphebbung	Revolta de Nika
Sihþ	Percepção visual
Brycgāðexe	Tuatara
Hetware	Catos
Americanisc wera rīcisc fōtballtēam	Seleção de Futebol dos Estados Unidos
Maywood, Illinois	Maywood (Illinois)
Þrēo Coreaniscu Cynerīcu	Três Reinos da Coreia
Feðer (blæces)	Caneta
Pening	Pfennig
Bryttisca Antarctisca Landscipe	Território Antártico Britânico
Starcraft	StarCraft
Seofon dēadlica synna	Pecado capital
Zavodovski-īeg	Ilha Zavodovski
Finger	Dedo médio
Midwearme geardas	Clima temperado
Angleseg	Anglesey
Niðerseaxisc sprǣc	Baixo saxão
Māse	Paridae
Caselle Landi	Caselle Landi
Penwiðsteort	Land's End
Ratchet & Clank	Ratchet & Clank
Æðelstān Engla Cyning	Athelstane de Inglaterra
Ras al-Khaimah	Ras al-Khaimah
Elene Constantinoples	Helena de Constantinopla
Nintendo DS	Nintendo DS
Ēse	Aesir
Nīwe Francland	Nova França
Englalandes Fana	Bandeira de Inglaterra
Cyclades	Cíclades
Trafalgar Sǣfeoht	Batalha de Trafalgar
Iosephine Francena Caserin	Josefina de Beauharnais
Sōlate	Girassol
Cynelica Sciphere	Marinha Real Britânica
Inbærnes	Olíbano
Difelinscīr	Condado de Dublin
Æppelcyrnel (wǣpen)	Granada de mão
Helm	Capacete
Umm Al Quwain	Umm al Qaywayn
Nīwes Sǣlandes þēodlīc fōtþōðerhēap	Seleção Neozelandesa de Futebol
Ingang:Stǣr	Portal:História
The Oval	The Oval (Belfast)
2010 FIFA Woruldceampscipe	Copa do Mundo FIFA de 2010
Sunu	Filho
Caltojar	Caltojar
Grīpfealcen	Falcão-gerifalte
Snāwbordfarung	Snowboard
Ōsgeard	Asgard
Glīdflēogung	Parapente
Mageoscīr	Condado de Mayo
Berlanga de Duero	Berlanga de Duero
Australisc rīce	Estados e territórios da Austrália
Blizzard Entertainment	Blizzard Entertainment
Gerinnung	Coagulação sanguínea
Dofras	Dover
Cannae Beadu	Batalha de Canas
Herenuma	Prisioneiro de guerra
Dȳfung	Mergulho
Daguerreotype	Daguerreótipo
Dūnholm	Durham
Þrēotīene Landbūnessa	Treze Colônias
Brenda Song	Brenda Song
Lincoln	Lincoln (Inglaterra)
Syllīega	Ilhas Scilly
Smallville (TV endebyrdnes)	Smallville (série)
Helen Clark	Helen Clark
Būr	Quarto
Wēala Þēoden	Príncipe de Gales
Scōnīeg	Escânia (província)
Milanes Bann	Édito de Milão
Francforta	Cachorro-quente
Gelocen boge	Besta (arma)
Wichlawscīr	Condado de Wicklow
Striuelin	Stirling
Æðelred Unrǣd	Etelredo II de Inglaterra
Twentig Þūsend Lēowena Under þǣm Sǣ	Vinte Mil Léguas Submarinas
Baius	Bayeux
Ballōn (lyftcræft)	Balão
Colneceaster	Colchester
Meodu	Hidromel
Met (Grammaticcræft)	Modo verbal
Sǣelpend	Elefante-marinho
Grytviken	Grytviken
Fox News	Fox News Channel
Brīw	Mingau
Ēadweard se Ieldra	Eduardo, o Velho
Iþacige	Ítaca
Baius tæpped	Tapeçaria de Bayeux
San Fabián de Alico	San Fabián (Chile)
Montréal Canadiens	Canadiens de Montréal
Underburg	Subúrbio
Sharjah	Sharjah
Antrimscīr	Condado de Antrim (Irlanda do Norte)
Vigdís Finnbogadóttir	Vigdís Finnbogadóttir
Final Fantasy	Final Fantasy
Norrena Cyning	Lista de reis da Noruega
Westmynster	Westminster
Ēadmund Æðeling	Edmundo I de Inglaterra
Rachel McAdams	Rachel McAdams
Fermanagh	Condado de Fermanagh
Dūnscīr	Condado de Down
E Pluribus Unum	E pluribus unum
Foresittend Franclandes	Presidente da França
New Jersey Devils	New Jersey Devils
Philadelphia Flyers	Philadelphia Flyers
Yun Chi-ho	Yun Chi-ho
Sancte Elene Īeg, Upstigeīeg and Tristan da Cunha	Santa Helena, Ascensão e Tristão da Cunha
Tirowen	Condado de Tyrone
Jack Ruby	Jack Ruby
Ardmachusscīr	Condado de Armagh
Scene	Rio Shannon
Wīnland	Vinland
Venom (trūðhlōð)	Venom (banda)
Luel	Carlisle
Ēadgar Engla Cyning	Edgar de Inglaterra
Kea	Papagaio-da-nova-zelândia
Itumbiara	Itumbiara
A Night at the Opera	A Night at the Opera (álbum de Queen)
Queen (album)	Queen (álbum)
Þunres Hamor	Mjölnir
Oben am jungen Rhein	Oben am jungen Rhein
Guinness	Guinness
Scræfclūdas (Sūþgeorgia)	Shag Rocks
Łobez	Łobez
Liðere	Funda
Thomas Cranmer	Tomás Cranmer
Tawpomere	Lago Taupo
Universidad de Concepción	Universidade de Concepción (Chile)
Hameldūn (Nīwe Sǣland)	Hamilton (Nova Zelândia)
Stǣr þǣre Worulde	História do mundo
Rēad wulf	Lobo-vermelho
Normandisca Forcyme	Conquista normanda da Inglaterra
Vitacura	Vitacura
Yungay	Yungay
Fif Scīr	Fife
Stǣrwrītere	Historiador
Carolina Hurricanes	Carolina Hurricanes
Nebrond	Nimrod (rei)
Tampa Bay Lightning	Tampa Bay Lightning
Scrobbesburh	Shrewsbury
Fæger hǣr	Cabelo loiro
Napier (Nīwe Sǣland)	Napier
Myrra	Mirra
Harold III Norrena Cyning	Haroldo III da Noruega
Fisc and styccu	Fish and chips
Brooke Fraser	Brooke Fraser
Middeltūn þǣra de Cahaignes	Milton Keynes
Florida Panthers	Florida Panthers
Washington Capitals	Washington Capitals
Īrisc fōtþōðer	Futebol gaélico
Nīwes Sǣlandes Þēodlic Stēormǣlhēap	Partido Nacional da Nova Zelândia
West Loðene	West Lothian
Lonceaster	Lancaster (Lancashire)
Sūþalpis	Alpes do Sul
Midloðene	Midlothian (council area)
Neamere	Lago Neagh
Maðante	Mantes-la-Jolie
Ēast Loðene	East Lothian
Fermat tæl	Número de Fermat
Clackmannanscīr	Clackmannanshire
Liccidfeld	Lichfield
Sūþorcanege	Ilhas Órcades do Sul
Rænkīnes hātȝemet	Rankine
Se Fēolagascipe þæs Hringes	The Fellowship of the Ring
Cod	Gadidae
Gold (bleoh)	Dourado (cor)
Holstānburg	Sisimiut
Micel Ficgīeg	Viti Levu
Wrenna	Troglodytidae
Ciricewæl	Kirkwall
1984 (bōc)	Nineteen Eighty-Four
Folcaþing	Folketing
Underset gamen	Pacote de expansão
Elig	Ely (Cambridgeshire)
Getalu burga in Þēodsclande	Lista de cidades na Alemanha
Innuendo	Innuendo
Concepcion Hēafodcirice	Catedral de Concepción (Chile)
The Game	The Game (álbum de Queen)
Bancorena burg	Bangor
Gēol	Yule
Washington Redskins	Washington Redskins
Swīma	Vertigem
Ægelesburg	Aylesbury
Tristania	Tristania
Wuldor	Uller
Ēsatrēowþ	Asatrú
Westgeatland	Västergötland
Rosenrot	Rosenrot
Wīcinga Ieldu	Era viking
Victory (scip)	HMS Victory
Sihhem	Nablus
Beatrix Potter	Beatrix Potter
Ēadgar Æðeling	Edgar de Wessex
Grēat Rōmisc Fȳr	Grande incêndio de Roma
Mann	Pessoa (filosofia)
Tollund wer	Homem de Tollund
Levanger	Levanger
Violetta Villas	Violetta Villas
Ynce	Polegada
Gearwung (plega)	Exercício físico
Diablo (gamen)	Diablo
Anggun	Anggun
Verizon Center	Verizon Center
Wīfa rihta forðung	Direitos da mulher
Apaxco	Apaxco
Cham	Cam
Zune	Zune
Nettþōðer	Netball
Lox	Lynx
In	IN
Diablo	Diablo (desambiguação)
Wiltūn	Wilton
Roanoke	Roanoke
Cnut	Knut
Acan tūn	Acton
Eormengyld Ciles	Universidade do Chile
Offa Miercna Cyning	Offa da Mércia
Engel	Anjo
Sasha Cohen	Sasha Cohen
Rachael Taylor	Rachael Taylor
Æðelflǣd	Etelfleda
Pat Benatar	Pat Benatar
Michelle Kwan	Michelle Kwan
Berhte Cent Cwēn	Berta de Kent
D.C. United	D.C. United
Eowland	Öland
Starcraft II	StarCraft II: Wings of Liberty
Gregorius Pāpa	Papa Gregório
Allan Kardec	Allan Kardec
Deadache	Deadache
Diablo III	Diablo III
Sceadu (gyden)	Skadi
Diablo II	Diablo II
The God Delusion	The God Delusion
Canadisc fōtþōðer	Futebol canadense
Hæstingas (missenlīc gewritu)	Hastings (desambiguação)
Ealra Hālgena Ǣfen	Dia das bruxas
Ēostre	Eostre
Sūþtun	Sutton
Weorcdæg	Jornada de trabalho
Leðerhosu	Lederhosen
Bān	Osso
7 World Trade Center	World Trade Center 7
Vampire Knight	Vampire Knight
Ælfrīc Abbod of Egoneshame	Ælfric de Eynsham
Æðelbald West-Seaxna Cyning	Etelbaldo de Wessex
Æðelrǣd	Etelredo da Mércia
Æðelstān	Athelstan
Ælfweard West-Seaxes	Ethelweard de Wessex
Bēagel	Bagel
Rēcels	Incenso
Iapanisc āttorcopplic crabba	Macrocheira kaempferi
Stromnæss, Sūþgeorgia	Stromness (Geórgia do Sul)
Woruldlic Gemōt þāra Ciricena	Conselho Mundial de Igrejas
Blæcesburg, Virginia	Blacksburg (Virgínia)
Harriet Miers	Harriet Miers
Dūnhēafod	Launceston (Cornualha)
Ériu	Ériu
Marjorie Estiano	Marjorie Estiano
Ítróttarfelag Fuglafjarðar	ÍF Fuglafjørður
Fotþōðer	Futebol (desambiguação)
Transformers	Transformers (desambiguação)
Oresundes brycg	Ponte do Øresund
Denegield	Danegeld
Vadillo	Vadillo
Spell Twēgra Burga	A Tale of Two Cities
Morbid Angel	Morbid Angel
John Ashcroft	John Ashcroft
Alexander Ovechkin	Alexander Ovechkin
Orosius	Paulo Orósio
Alexis Tsipras	Aléxis Tsípras
Dufenal I Scotta	Donaldo I da Escócia
Constontinus I Scotta Cyning	Constantino I da Escócia
Joseph Serchuk	Joseph Serchuk
Seolfor (bleoh)	Prata (cor)
Babez for breakfast	Babez for Breakfast
Philip Jaisohn	Philip Jaisohn
Widukind	Viduquind
Wælheall Herig	Templo de Walhalla
Æbbandūn	Abingdon (Oxfordshire)
Law & Order	Law & Order
Westmannland	Västmanland
Moretoin	Mortain
Leaves' Eyes	Leaves' Eyes
Amol	Amol
Penda Miercna Cyning	Penda de Mércia
Dūnstān	Dunstan
Mælcolm II Scotta Cyning	Malcolm II da Escócia
Ēadgar Scotta Cyning	Edgar da Escócia
Ofergewiht	Sobrepeso
Constontinus II Scotta Cyning	Constantino II da Escócia
Pak Hon-yong	Pak Hon-Yeong
Americanisc frēona rīcisc fōtballtēam	Seleção de Futebol Feminino dos Estados Unidos
Obituary	Obituary
Berserca	Berserker
Jordan Galland	Jordan Galland
Acrassicauda	Acrassicauda
Minoru Yamasaki	Minoru Yamasaki
Canceler	Chanceler
Almaluez	Almaluez
Pulgara Cyning	Lista de reis e imperadores da Bulgária
Australisca Witenagemōt	Parlamento da Austrália
Lao	Laocianos
Wīfel	Caruncho
Agalloch	Agalloch
Godspell Mattheus	Evangelho segundo Mateus
Ēadweard Cyning Næss	Cabo Rei Eduardo
Uzumaki/ᚢᛋᚢᛗᚪᛦᛁ	Uzumaki
Ēadmund	Edmund
Palestinisce Landscipas	Territórios palestinianos
James Ēa	Rio James (Virgínia)
Ȝ	Ȝ
Gærsīeg, Sūþgeorgia	Ilha Grass
Nazarēth	Nazaré
Rise of Nations	Rise of Nations
Kate Sheppard	Kate Sheppard
Geþingedōm	Subdivisões da Escócia
Getalu Smallville-belimpdǣla	Lista de episódios de Smallville
Kwara Rīce	Kwara (estado)
Windlesōra	Windsor
America's Cup	America's Cup
Rædwald Ēastengla Cyning	Redvaldo da Ânglia Oriental
Ēadbald	Eadbaldo de Kent
Oswiu Norþhymbra Cyning	Oswiu da Nortúmbria
Brian Jacques	Brian Jacques
Paramore	Paramore
Recedham	Rochdale
Illative cāsus	Caso ilativo
Herelic munucregol	Ordem militar
Ǣȝhnōg	Eggnog
Coritiba Foot Ball Club	Coritiba Foot Ball Club
Tansonnhates Geondrīciscum Lyfthæfene	Aeroporto Internacional Tan Son Nhat
Þresc stīele	Thrash metal
The Chronicles of Narnia	As Crônicas de Nárnia
Aliud	Aliud
Baraona	Baraona
James Hetfield	James Hetfield
Keane	Keane
Medinaceli	Medinaceli
Láchar	Láchar
Burgo de Osma-Ciudad de Osma	Burgo de Osma
Suellacabras	Suellacabras
Yanguas	Yanguas
Get Heavy	Get Heavy
Pensacola	Pensacola (Flórida)
The Arockalypse	The Arockalypse
Anath	Anat
San Esteban de Gormaz	San Esteban de Gormaz
The Monsterican Dream	The Monsterican Dream
Barbourscīr, Westvirginia	Condado de Barbour (Virgínia Ocidental)
Duval Scīr, Florida	Condado de Duval (Flórida)
Hāmtūnscīr Scīr, West Virginia	Condado de Hampshire (Virgínia Ocidental)
Samsung Galaxy Note	Samsung Galaxy Note
Perfume	Perfume (banda)
Park Jung-yang	Park Jung-yang
Rōwrenoc (Virginia)	Roanoke (Virgínia)
Sūþtūn Hōh	Sutton Hoo
Tuidi	Rio Tweed
Sǣbeorg	Monte submarino
Chris Pratt	Chris Pratt
Walhshalh	Walsall
Bēdesford, Virginia	Bedford (Virgínia)
Ēadƿeard Æðeling Scīr, Virginia	Condado de Prince Edward (Virgínia)
Fiðele	Fiddle
Cañamaque	Cañamaque
Cambihtuc	Nymphicus hollandicus
Navaleno	Navaleno
Masters of the Universe	Masters of the Universe
Hwælsang	Canto das baleias
Boston Breakers	Boston Breakers
Lanercscīr	Lanarkshire
Dasaratha Maurya	Dasarata Máuria
Anna Ēastengla Cyning	Ana da Ânglia Oriental
Cannae	Canas (Apúlia)
Debauchery	Debauchery
Niht (gyden)	Nótt
Trévago	Trévago
JavaScript weorcsearu	Interpretador de JavaScript
Dévanos	Dévanos
Mexicanisc frēona rīcisc fōtballtēam	Seleção Mexicana de Futebol Feminino
Læland	Lolland
Bukan	Bukan
God Hates Us All	God Hates Us All
Gemǣne Rīca of Australie	Governador-geral da Austrália
FC Gold Pride	Football Club Gold Pride
Grahamland	Terra de Graham
Wikipǣdia:Sceortpæþ	Wikipédia:Atalho
Ólvega	Ólvega
Eormengyld Juraj Dobrila on Pula	Universidade Juraj Dobrila de Pula
Scieppend	Divindade criadora
Dopenid	Fulica
Swearttægelhara	Lebre-da-califórnia
Beadu þæs Bogn	Batalha do Boyne
Puebla FC	Puebla Fútbol Club
Minga Guazú	Minga Guazú
Atari Jaguar	Atari Jaguar
Smallville (Gēar 4)	Smallville (4ª temporada)
Hēffe Wehbig	Haifa Wehbe
Magaña	Magaña
Ulfretūn	Newbury (Berkshire)
Tæppa	Torneira
Smallville (Gēar 3)	Smallville (3ª temporada)
Tīdunghēap	Grupo de notícias
Nile (trūðhlōð)	Nile
Scēaþ	Bainha
Stǣr Angelþēode ciricean	História Eclesiástica do Povo Inglês
Rēan	Ran (mitologia)
Vindicationīeg	Ilha Vindicação
Centenera de Andaluz	Centenera de Andaluz
Blecinga īeg	Blekinge (província)
Lox (catte)	Lince
Lǣden-ofgangena stæfrǣwa	Lista de alfabetos derivados do latino
Huntandūn	Huntingdon (Inglaterra)
Hoym	Hoym
Hude (Oldenburg)	Hude
City of Heroes	City of Heroes
World of Warcraft: Wrath of the Lich King	World of Warcraft: Wrath of the Lich King
Ambihtlicu Cīnisc sprǣc	Mandarim padrão
Mans	Maine (província)
Falster	Falster
Janus (Windows beta)	Windows 3.x
Difelinburg	Castelo de Dublin
SOX leoht-fæt	Lâmpada de vapor de sódio
Madrynhȳð	Puerto Madryn
Atlanta Beat	Atlanta Beat
Gawain and se Grēna Cniht	Sir Gawain e o Cavaleiro Verde
Maroare	Morávios
Centro Federal de Educação Tecnológica Celso Suckow da Fonseca	Centro Federal de Educação Tecnológica Celso Suckow da Fonseca
Chrono Trigger	Chrono Trigger
Antônio Fagundes	Antônio Fagundes
Selfrīcsiendlica landbūnessa	Região autônoma
Berewicscīr	Berwickshire
Lex Acilia Calpurnia	Lei Acília Calpúrnia
Bloomesdæg	Bloomsday
Barca	Barca (Cirenaica)
Bardanstapol	Barnstaple
Bellingshausenīeg	Ilha Bellingshausen
Wedrebi	Wetherby
Stæfford	Stafford (Staffordshire)
Almarza	Almarza
Aldealices	Aldealices
Aldealafuente	Aldealafuente
Alentisque	Alentisque
Adradas	Adradas
Abejar	Abejar
Almajano	Almajano
Arenillas	Arenillas
Aldealpozo	Aldealpozo
Alcubilla de las Peñas	Alcubilla de las Peñas
Aldealseñor	Aldealseñor
Alcubilla de Avellaneda	Alcubilla de Avellaneda
Covaleda	Covaleda
Casarejos	Casarejos
Cerbón	Cerbón
Calatañazor	Calatañazor
Almazul	Almazul
Cidones	Cidones
Besliwdifca	Bezlyudivka
Alpanseque	Alpanseque
Arcos de Jalón	Arcos de Jalón
Aldehuela de Periáñez	Aldehuela de Periáñez
Beratón	Beratón
Almenar de Soria	Almenar de Soria
Maján	Maján
Coscurita	Coscurita
Barcones	Barcones
Castilfrío de la Sierra	Castilfrío de la Sierra
Castilruiz	Castilruiz
Miño de Medinaceli	Miño de Medinaceli
Vinuesa	Vinuesa
Cigudosa	Cigudosa
Candilichera	Candilichera
Ausejo de la Sierra	Ausejo de la Sierra
Carabantes	Carabantes
Soliedra	Soliedra
Taroda	Taroda
Nepas	Nepas
Valtajeros	Valtajeros
Arévalo de la Sierra	Arévalo de la Sierra
Pozalmuro	Pozalmuro
Cabrejas del Pinar	Cabrejas del Pinar
Villasayas	Villasayas
Cubilla	Cubilla
Castillejo de Robledo	Castillejo de Robledo
Escobosa de Almazán	Escobosa de Almazán
Estepa de San Juan	Estepa de San Juan
Carrascosa de la Sierra	Carrascosa de la Sierra
Las Aldehuelas	Las Aldehuelas
Bayubas de Arriba	Bayubas de Arriba
Borobia	Borobia
Bliecos	Bliecos
Buberos	Buberos
Muriel Viejo	Muriel Viejo
Oncala	Oncala
Fuentecambrón	Fuentecambrón
Cabrejas del Campo	Cabrejas del Campo
Frechilla de Almazán	Frechilla de Almazán
Ergo Proxy	Ergo Proxy
Valdelagua del Cerro	Valdelagua del Cerro
Ciria	Ciria
Buitrago	Buitrago
Talveila	Talveila
Salduero	Salduero
Fuentes de Magaña	Fuentes de Magaña
Viana de Duero	Viana de Duero
Tardelcuende	Tardelcuende
Duruelo de la Sierra	Duruelo de la Sierra
Bayubas de Abajo	Bayubas de Abajo
Fuentearmegil	Fuentearmegil
Fuentelmonge	Fuentelmonge
Rollamienta	Rollamienta
Villar del Ala	Villar del Ala
Velilla de los Ajos	Velilla de los Ajos
Momblona	Momblona
Fresno de Caracena	Fresno de Caracena
Valdegeña	Valdegeña
Velamazán	Velamazán
Torlengua	Torlengua
Fuentecantos	Fuentecantos
Carrascosa de Abajo	Carrascosa de Abajo
Pinilla del Campo	Pinilla del Campo
Serón de Nágima	Serón de Nágima
Blacos	Blacos
Valdeavellano de Tera	Valdeavellano de Tera
Narros	Narros
Valdeprado	Valdeprado
Borjabad	Borjabad
Fuentelsaz de Soria	Fuentelsaz de Soria
San Leonardo de Yagüe	San Leonardo de Yagüe
Muriel de la Fuente	Muriel de la Fuente
Villar del Río	Villar del Río
Valderrodilla	Valderrodilla
Espejón	Espejón
Liceras	Liceras
Matalebreras	Matalebreras
Quintana Redonda	Quintana Redonda
Nafría de Ucero	Nafría de Ucero
Sotillo del Rincón	Sotillo del Rincón
Torrubia de Soria	Torrubia de Soria
Noviercas	Noviercas
Tajueco	Tajueco
Valdenebro	Valdenebro
Villaciervos	Villaciervos
Villanueva de Gormaz	Villanueva de Gormaz
Yelo	Yelo
Montenegro de Cameros	Montenegro de Cameros
Ucero	Ucero
Langa de Duero	Langa de Duero
Quiñonería	Quiñonería
Villar del Campo	Villar del Campo
Portillo de Soria	Portillo de Soria
Gormaz	Gormaz
Santa Cruz de Yanguas	Santa Cruz de Yanguas
Villaseca de Arciel	Villaseca de Arciel
Reznos	Reznos
Cueva de Ágreda	Cueva de Ágreda
Nolay	Nolay
Cirujales del Río	Cirujales del Río
Caracena	Caracena
Cubo de la Solana	Cubo de la Solana
Miño de San Esteban	Miño de San Esteban
Fuentestrún	Fuentestrún
Espeja de San Marcelino	Espeja de San Marcelino
Matamala de Almazán	Matamala de Almazán
La Póveda de Soria	La Póveda de Soria
Quintanas de Gormaz	Quintanas de Gormaz
Santa María de Huerta	Santa María de Huerta
San Pedro Manrique	San Pedro Manrique
Valdemaluque	Valdemaluque
San Felices	San Felices
Morón de Almazán	Morón de Almazán
Los Villares de Soria	Los Villares de Soria
Torreblacos	Torreblacos
Vizmanos	Vizmanos
Tejado	Tejado
Retortillo de Soria	Retortillo de Soria
Herrera de Soria	Herrera de Soria
Deza	Deza
Monteagudo de las Vicarías	Monteagudo de las Vicarías
La Riba de Escalote	La Riba de Escalote
Montejo de Tiermes	Montejo de Tiermes
La Losilla	La Losilla
Recuerda	Recuerda
Tajahuerce	Tajahuerce
Santa María de las Hoyas	Santa María de las Hoyas
Fuentepinilla	Fuentepinilla
Rioseco de Soria	Rioseco de Soria
Gómara	Gómara
Rōmānisc Cāsere	Imperador romano
Weogornaceasterscīrsēaw	Molho Worcestershire
Picilemwes eorþbeofung 2010 gēares	Sismo de Pichilemu de 2010
Getalu ambihtlicra sprǣca	Lista de línguas oficiais
Maybach Exelero	Maybach Exelero
Īslendisc frēona rīcisc fōtþōðerhēap	Seleção Islandesa de Futebol Feminino
Worulde Fanan	Flags of the World
Hafoc	Gavião
Dēaðas in 2005. gēare	Mortes em 2005
York University	Universidade Iorque
Skræling	Skræling
Brytenwealda	Bretwalda
Glamorgan	Glamorgan
Port Authority of New York and New Jersey	Autoridade Portuária de Nova York e Nova Jersey
Getalu īega be landware	Lista de ilhas por população
Street Fighter IV	Street Fighter IV
Help:Innoþ	Ajuda:Página principal
Wikipǣdia:Tutorial	Ajuda:Tutorial
Brycgstōwīeg	Ilha Bristol
Groove is in the Heart	Groove Is in the Heart
Witch Hunter Robin	Witch Hunter Robin
Twilight of the Thunder God	Twilight of the Thunder God
Pontifícia Universidade Católica de Minas Gerais	Pontifícia Universidade Católica de Minas Gerais
Smallville (Gēar 5)	Smallville (5ª temporada)
Universidad de los Andes (Cile)	Universidade dos Andes
Oenoīeg	Oeno
3 World Trade Center	175 Greenwich Street
Landa getalu be lēodweardcynne	Lista de países por sistema de governo
Los Angeles Sol	Los Angeles Sol
Rūnstæfisc gerīmbōc	Calendário rúnico
Hrodulf se rēadnosoda hrāndēor	Rudolph, a Rena do Nariz Vermelho
Murilo Rosa	Murilo Rosa
2009–10 NHL tīma	Temporada 2009-10 da NHL
Molinos de Duero	Molinos de Duero
Vozmediano	Vozmediano
Hinojosa del Campo	Hinojosa del Campo
Elpendīeg	Ilha Elefante
Getæl īega	Lista de ilhas
Elenesburh	Helensburgh
Sūþern Strēamflēot	Kangerlussuaq
Burns Niht	Burns Suppers
Vrahovice	Vrahovice
Gēatland	Gotlândia
Būc	Estômago
Candelmæssanīeg	Ilha Candelária
Loppestre	Nephropidae
Rello	Rello
Rebollar	Rebollar (Castela e Leão)
Unicron	Unicron
Simeon II Pulgara Cyning	Simeão II da Bulgária
Lopphāma	Weta
Heortæppelbroþ	Sopa de tomate
Chicago Red Stars	Chicago Red Stars
Cutey Honey	Cutey Honey
Besancurt	Bézancourt
Clarenceīeg, Sūþhjaltland	Ilha Clarence
Umm Culþþūm	Umm Kulthum
Tenercebrai	Tinchebray
2 World Trade Center	2 World Trade Center
Cōcīeg (þāra Sūþsandwic Īeglanda)	Ilha Cook
Universidade Tecnológica Federal do Paraná	Universidade Tecnológica Federal do Paraná
Stæffordscīr hord	Terry Herbert
Gemyndigung Twintorra	Memorial & Museu Nacional do 11 de Setembro
Swamphæn	Porphyrio
Lundene Foreweard (1839.)	Tratado de Londres (1839)
Hellraiser	Hellraiser
Æsir–Vanir þurhgefeht	Guerra dos Deuses
Teach Children to Worship Satan	Teach Children to Worship Satan
Wikipǣdia:Ambihtsecghof	Wikipédia:Embaixada
Sēo Rād tō Wiganshwearfe	The Road to Wigan Pier
National Hockey League	National Hockey League
Striuelinscīr	Stirlingshire
Frōm	Frome (Somerset)
Perþscīr	Perthshire
2010 WPS tīma	Liga de futebol feminino dos Estados Unidos de 2010
Flyhthæfen	Aeroporto
Leskovīeg	Ilha Leskov
Major Antônio Couto Pereira Stadium	Estádio Major Antônio Couto Pereira
Stǣrlice gemynddagas	Lista de dias do ano
Pecland	Peak District
Uzumaki	Uzumaki (mangá)
4 World Trade Center	World Trade Center 4
KMFDM	KMFDM
Women's Professional Soccer	Liga de futebol feminino dos Estados Unidos
Sǣweardþrēat	Guarda costeira
Agnes Monica	Agnes Monica
Montaguīeg	Ilha Montagu
Evile	Evile
Flocc:Ƿeras	Categoria:Homem
Flocc:Ƿīf	Categoria:Mulheres
Flocc:Þēodscland	Categoria:Alemanha
Flocc:Italia	Categoria:Itália
Flocc:Geānedu Rīcu American	Categoria:Estados Unidos
Flocc:Russland	Categoria:Rússia
Flocc:Canada	Categoria:Canadá
Flocc:Geānede Cynerīce	Categoria:Reino Unido
Flocc:Spēonland	Categoria:Espanha
Flocc:Cīna	Categoria:China
Flocc:Iapan	Categoria:Japão
Flocc:Australia	Categoria:Austrália
Flocc:Mexico	Categoria:México
Flocc:Indea	Categoria:Índia
Flocc:Saudisc Arabea	Categoria:Arábia Saudita
Flocc:Israhēl	Categoria:Israel
Flocc:Turcland	Categoria:Turquia
Flocc:Sūðaffrica	Categoria:África do Sul
Flocc:Ǣgypt	Categoria:Egito
Flocc:Persealand	Categoria:Irão
Flocc:Nīwe Sǣland	Categoria:Nova Zelândia
Flocc:Argentina	Categoria:Argentina
Traversayīega	Ilhas Traversay
Siebenbürgen	Siebenbürgen
Sky Blue FC	Sky Blue Football Club
Flocc:Afghanistan	Categoria:Afeganistão
Flocc:Algeria	Categoria:Argélia
Flocc:Ēastrīce	Categoria:Áustria
Flocc:Bangladesc	Categoria:Bangladesh
Flocc:Cūba	Categoria:Cuba
Flocc:Sigelhearwenaland	Categoria:Etiópia
Flocc:Indonesia	Categoria:Indonésia
Flocc:Irac	Categoria:Iraque
Flocc:Niðerland	Categoria:Países Baixos
Flocc:Nigeria	Categoria:Nigéria
Flocc:Pacistan	Categoria:Paquistão
Flocc:Pōlaland	Categoria:Polónia
Flocc:Portugal	Categoria:Portugal
Flocc:Sudan	Categoria:Sudão
Flocc:Tansania	Categoria:Tanzânia
Flocc:Ucrægna	Categoria:Ucrânia
Flocc:Fietnam	Categoria:Vietname
Flocc:Rōmānisc Cāsere	Categoria:Império Romano
Flocc:Sycedēor	Categoria:Mamíferos
Flocc:Fugolas	Categoria:Aves
Flocc:Plantan	Categoria:Plantas
Flocc:Stǣr	Categoria:História
Flocc:Ferscipe	Categoria:Sociedade
Flocc:Gelēafan	Categoria:Religião
Flocc:Plegan	Categoria:Desportos
Flocc:Sprǣc	Categoria:Linguagem
Flocc:Eorþ	Categoria:Terra
Victor Iusccenco	Viktor Yushchenko
Slowly We Rot	Slowly We Rot
Surtur Rising	Surtur Rising
Thila-īeg	Ilha Thule
Saint Louis Athletica	Saint Louis Athletica
Palmerland	Terra de Palmer
Pagetbeorg	Monte Paget
Handfisc	Brachionichthyidae
Phil Keaggy	Phil Keaggy
Frēodōm	Freedom
Īsensmiþ	Ferreiro
Visokoi-īeg	Ilha Visokoi
Willisīega	Ilhas Willis
Wiogoraceastre	Worcester
Abbodesse	Abadessa
Geondrīciscra laga fōtþōðer	Futebol de regras internacionais
Mōr	Paul (ecossistema)
Ranko Matasović	Ranko Matasović
Três Pontas	Três Pontas
Saundersīeg	Ilha Saunders
The Miracles	The Miracles
Siissisoq	Siissisoq
Universidad del Desarrollo	Universidad del Desarrollo
Hwæl	Baleia
Tempest 2000	Tempest 2000
Richard Pearse	Richard Pearse
Philadelphia Independence	Philadelphia Independence
Flocc:Scīrung	Categoria:Desambiguação
Flocc:Olympisc Gamen	Categoria:Jogos Olímpicos
Flocc:Crīstendōm	Categoria:Cristianismo
Flocc:Alladōm	Categoria:Islamismo
Decatur	Decatur
Ammomanes	Ammomanes
Earn	Águia
Skaugum	Skaugum
Scyrte	Saia
Irac Cyning	Lista de reis do Iraque
Occidental (California)	Occidental (Califórnia)
Smallville	Smallville
Bochotnica	Bochotnica
Anna Hutchison	Anna Hutchison
Universidade do Estado de Minas Gerais	Universidade do Estado de Minas Gerais
Beormas	Permianos
Āhyrstod cȳse	Queijo-quente
Sceota	Salmo trutta
Þēodacynewīse Dæg	Dia da Commonwealth
Camila Morgado	Camila Morgado
Flocc:Styccelicu gewritu	Categoria:!Esboços
Flocc:Wikipedia categorization	Categoria:!Categorização da Wikipedia
Flocc:Sidaþing	Categoria:Cultura
Flocc:Gēar	Categoria:Anos
Flocc:Worulddǣl	Categoria:Continentes
Getalu þāra Atari Jaguares gamena	Lista de jogos para Atari Jaguar
Wiht (wist)	Vættir
The Tonight Show with Jay Leno	The Tonight Show with Jay Leno
Sprǣca merung	Miriwung
Wikipǣdia:Gecorene gemynddagas	Wikipédia:Efemérides
Wikipǣdia:Tutorial (Editing)	Ajuda:Tutorial/Edição
Bysen:Stēorungsunnanendebyrdnes	Predefinição:Sistema Solar
Wikipǣdia:Nīwe ēacan	Wikipédia:Sabia que
Wikipǣdia:Wikibōceras	Wikipédia:Wikipedistas
Scearseax	Barbeador
Wikipǣdia:Snell bīcniend	Portal:Conteúdo/Índice alfabético
Wikipǣdia:Recentchanges	Ajuda:Guia de edição/Menus e ferramentas/Mudanças recentes
Basu	Púrpura
Yfelland Ƿeard	Badlands Guardian
Good Monsters	Good Monsters
Perfekte Welle	Perfekte Welle
Henri Castelli	Henri Castelli
AmigaOS 4	AmigaOS 4
Bysen:Succession box	Predefinição:Caixa de sucessão
Flocc:Flēogeball	Categoria:Voleibol
Flocc:Wikipedia bots	Categoria:!Robôs
Port:Gefērscipe	Portal:Sociedade
Ened	Pato
Bysen:Cquote	Predefinição:Quote
Flocc:Þēodisc	Categoria:Alemães
Caco Ciocler	Caco Ciocler
Eormengyld ''Guglielmo Marconi''	Università degli Studi Guglielmo Marconi
Flocc:Land	Categoria:Países
Catherine	Catherine
Wikipǣdia:Bewitendas	Wikipédia:Administradores
Flocc:Lēode	Categoria:Pessoas
Wikipǣdia:Bēna tō and fram bewitendhāde	Wikipédia:Pedidos de administração
Flocc:Tīd	Categoria:Tempo
Flocc:Bodiȝlār	Categoria:Anatomia
Wikipǣdia:Betwuxsprǽclice bendas	Ajuda:Guia de edição/Interwikis
Flocc:Leornung	Categoria:Educação
Cyningesbeorg	Königsberg
Ægypt	Egito
Yulia Lipnitskaya	Julia Lipnitskaia
Flocc:Ūtwitan	Categoria:Filósofos
Bysen:Bot	Predefinição:Robô
Wikipǣdia:Hwæt Wikipǣdia Nis	Wikipédia:O que a Wikipédia não é
Canada	Canadá
Flocc:Ungerland	Categoria:Hungria
Flocc:Belgice	Categoria:Bélgica
Flocc:Cipros	Categoria:Chipre
Flocc:Cecland	Categoria:República Checa
Flocc:Denemearc	Categoria:Dinamarca
Flocc:Estland	Categoria:Estónia
Flocc:Finnland	Categoria:Finlândia
Flocc:Crecaland	Categoria:Grécia
Flocc:Lettland	Categoria:Letónia
Flocc:Īsland	Categoria:Islândia
Flocc:Letseburg	Categoria:Luxemburgo
Flocc:Liþuania	Categoria:Lituânia
Flocc:Melita	Categoria:Malta
Flocc:Swēoland	Categoria:Suécia
Flocc:Slofacia	Categoria:Eslováquia
Flocc:Īrland Cynewīse	Categoria:República da Irlanda
Flocc:Fulgōd ȝeƿritu	Categoria:!Artigos destacados
Port:Innung/Portas	Portal:Conteúdo/Resumo do conhecimento
Flocc:Spærcletelle gamen	Categoria:Jogos eletrônicos
Heofon	Céu (religião)
Fresland	Frísia
Flocc:Microsoft	Categoria:Microsoft
Wikipǣdia:Edit summary	Ajuda:Guia de edição/Menus e ferramentas/Sumário de edição
Bysen:Flagicon	Predefinição:ÍconeBandeira
Flocc:Land on Europan	Categoria:Países da Europa
Flocc:Europe	Categoria:Europa
Flocc:Wikipedia:Help	Categoria:!Ajuda
Help:Mōtungtramet	Wikipédia:Página de discussão
Wikipǣdia:Efenealde belimpas	Portal:Eventos atuais
Bysen:Documentation	Predefinição:Documentação
Wikipǣdia:Protected pages	Wikipédia:Página protegida
Flocc:Wikibōceras	Categoria:!Wikipedistas
Wikipǣdia:Gemǣnscipes Ingang	Wikipédia:Portal comunitário
Flocc:Brūcendsprǣc	Categoria:!Wikipedistas por idioma
Wikipǣdia:Fīf styde	Wikipédia:Cinco pilares
Wikipǣdia:Ānsund styccegewrit	Wikipédia:Esboço
Wikipǣdia:Bealu	Wikipédia:Vandalismo
Sung Jae-ki	Sung Jae-ki
Instituto Federal da Bahia	Instituto Federal da Bahia
Bysen:Softredirect	Predefinição:Pseudorredirecionamento
Bysen:Delete	Predefinição:ER
Snægel	Gastrópodes
Bryttisce Wealdendas	Lista de monarcas britânicos
Flocc:Searucræft	Categoria:Tecnologia
Dirty Women	Dirty Women
Flocc:Sprǣca	Categoria:Línguas
Flocc:Gerīmbōc	Categoria:Calendários
Flocc:Hāliȝdagas	Categoria:Datas comemorativas
Help:Onbregdan nīwne tramet	Ajuda:Guia de edição/Como começar uma página
Flocc:Wikipǣdia	Categoria:Wikipédia
Flocc:Unȝebēacniende trametas	Categoria:!Páginas não indexadas
Flocc:Pages with broken file links	Categoria:!Páginas com ficheiros inexistentes
Wikipǣdia:Manual of Style	Wikipédia:Livro de estilo
Bysen:Navbox	Predefinição:Navbox
Handspearctellend	Dispositivo móvel
Flocc:Byrig on Persum	Categoria:Cidades do Irão
Maryland SoccerPlex	Maryland SoccerPlex
Bysen:Sēðung þurfed	Predefinição:Carece de fontes
Angelfresisca sprǣca	Línguas anglo-frísias
Flocc:Fana bysen	Categoria:!Predefinições sobre bandeiras
Bysen:((	Predefinição:Chaves-abre
Bysen:!-	Predefinição:!-
Bysen:!!	Predefinição:!!
Bysen:=	Predefinição:=
Bysen:Navbar	Predefinição:Tnavbar
Bysen:Unicode	Predefinição:Unicode
Bysen:E	Predefinição:E
Bysen:Clear	Predefinição:Limpar
Bysen:Col-break	Predefinição:Col-break
Bysen:Col-begin	Predefinição:Col-begin
Bysen:Color	Predefinição:Color
Bysen:Anchor	Predefinição:Âncora
Wikipǣdia:List of articles all languages should have	Wikipédia:Artigos essenciais
Flocc:Affrica	Categoria:África
Flocc:Mǣdmōnaþ	Categoria:Julho
Flocc:Þorpas	Categoria:Aldeias
Flocc:Bēc	Categoria:Livros
Flocc:Mōnþas	Categoria:Meses
Bysen:Wikisource	Predefinição:Wikisource
Bysen:Babel	Predefinição:Babel
Bysen:Commons	Predefinição:Commons
Bysen:Link GA	Predefinição:Bom interwiki
Bysen:Reflist	Predefinição:Referências
Bysen:NavPeriodicTable	Predefinição:Elemento/mini tabela periódica
Wikipǣdia:Fulgōdra gewrita hwætgōdnesse	Wikipédia:O que é um artigo em destaque?
Bysen:Stycce	Predefinição:Esboço
Bysen:Brūcend de	Predefinição:User de
Bysen:Brūcend de-1	Predefinição:User de-1
Bysen:Brūcend el	Predefinição:User el
Bysen:Brūcend es	Predefinição:User es
Bysen:Brūcend de-3	Predefinição:User de-3
Bysen:Brūcend en-3	Predefinição:User en-3
Bysen:Brūcend el-1	Predefinição:User el-1
Bysen:Brūcend en-1	Predefinição:User en-1
Bysen:Brūcend en-2	Predefinição:User en-2
Bysen:Brūcend eo-2	Predefinição:User eo-2
Bysen:Brūcend en-4	Predefinição:User en-4
Bysen:Brūcend fi	Predefinição:User fi
Bysen:Brūcend en-0	Predefinição:User en-0
Bysen:Brūcend en	Predefinição:User en
Bysen:Brūcend de-2	Predefinição:User de-2
Bysen:Brūcend es-1	Predefinição:User es-1
Bysen:Brūcend fi-1	Predefinição:User fi-1
Bysen:Brūcend fr-1	Predefinição:User fr-1
Flocc:Līf	Categoria:Vida
Bysen:Brūcend he-2	Predefinição:User he-2
Bysen:Brūcend it-3	Predefinição:User it-3
Bysen:User sk	Predefinição:User sk
Bysen:Brūcend fr-2	Predefinição:User fr-2
Bysen:Brūcend ja	Predefinição:User ja
Bysen:Brūcend ja-1	Predefinição:User ja-1
Bysen:Brūcend it-1	Predefinição:User it-1
Bysen:Brūcend fr	Predefinição:User fr
Cosco	Cusco
Flocc:Solmōnaþ	Categoria:Fevereiro
Flocc:1949	Categoria:1949
Bysen:Stedefindend scite/Writ	Predefinição:Mapa de localização/info
Flocc:Ceorfdēor	Categoria:Insectos
Bysen:Fs mid	Predefinição:Football squad mid
Flocc:Asia	Categoria:Ásia
Flocc:Cile	Categoria:Chile
Flocc:21e gēarhundred	Categoria:Século XXI
Flocc:Lesotho	Categoria:Lesoto
Flocc:Brūcend uk	Categoria:Usuários uk
Flocc:Sūðamerica	Categoria:América do Sul
Flocc:Brūcend uk-M	Categoria:Usuário uk
Flocc:1918	Categoria:1918
Flocc:1954	Categoria:1954
Flocc:Ǣt	Categoria:Alimentos
Flocc:1946	Categoria:1946
Bysen:Fs player	Predefinição:Football squad player
Flocc:Gyldfōtþōðer	Categoria:Futebol
Flocc:1945	Categoria:1945
Bysen:Mod	Predefinição:Mod
Flocc:1926	Categoria:1926
Bysen:NowCommons	Predefinição:Now Commons
Bysen:Brūcend sv	Predefinição:User sv
Flocc:1920	Categoria:1920
Bysen:Brūcend it	Predefinição:User it
Bysen:Brūcend uk	Predefinição:User uk
Bysen:Brūcend es-2	Predefinição:User es-2
Bysen:Infobox Football club	Predefinição:Info/Futebol/Clube
Bysen:Welcome	Predefinição:Bem-vindo(a)
Flocc:Bysen mid ūtweardum hlence	Categoria:!Predefinições de ligações externas
Bysen:Country data Slovakia	Predefinição:Country data Eslováquia
Bysen:Country flagnavy	Predefinição:Marinha/core
Bysen:Country data Czech Republic	Predefinição:Country data República Checa
Bysen:Country data Honduras	Predefinição:Country data Honduras
Bysen:Sprec-ang	Predefinição:Pronuncia
Bysen:Country data Bolivia	Predefinição:Country data Bolívia
Bysen:Country data Denemearc	Predefinição:Country data Dinamarca
Bysen:Country data Īsland	Predefinição:Country data Islândia
Bysen:Country data Poland	Predefinição:Country data Polônia
Bysen:Scire in Irlande	Predefinição:Condados da Irlanda
Bysen:Click	Predefinição:Click
Bysen:Wikivar	Predefinição:Wikivar
Flocc:Brūcend fr-1	Categoria:Usuário fr-1
Bysen:Country data Norway	Predefinição:Country data Noruega
Bysen:Wikiquote	Predefinição:Wikiquote
Bysen:Country showdata	Predefinição:Country showdata
Bysen:Country data Mexico	Predefinição:Country data México
Bysen:Affrica	Predefinição:Países da África
Bysen:Infobox television	Predefinição:Info/Televisão
Flocc:Americisc Awendung Wig	Categoria:Revolução Americana
Bysen:FWB	Predefinição:FWB
Bysen:IUCN2008	Predefinição:IUCN2008
Bysen:Geānedu Rīcu American	Predefinição:Divisões Estados Unidos
Bysen:Country data Australia	Predefinição:Country data Austrália
Bysen:Cyþþubox ieg	Predefinição:Info/Ilha
Bysen:Country data France	Predefinição:Country data França
Bysen:Ambox	Predefinição:Ambox
Flocc:Americanisc stǣr	Categoria:História dos Estados Unidos
Bysen:Fossil range/bar	Predefinição:Período fóssil/barra
Bysen:Rnd	Predefinição:Rnd
Bysen:Infobox Country	Predefinição:Info/País
Bysen:Max	Predefinição:Max
Bysen:Country data Austria	Predefinição:Country data Áustria
Bysen:Infobox Mīlitisc Gemōt	Predefinição:Info/Conflito militar
Bysen:Documentation/docname	Predefinição:Documentação/nomedoc
Bysen:Country data Finland	Predefinição:Country data Finlândia
Wikipǣdia:Tutorial (Wikipedia links)	Ajuda:Tutorial/Ligações internas
Bysen:Country data Japan	Predefinição:Country data Japão
Bysen:Start box	Predefinição:Começa caixa
Bysen:Infobox U.S. Scīr	Predefinição:Info/Condado dos Estados Unidos
Bysen:Cleanup	Predefinição:Reciclagem
Flocc:Crabbas	Categoria:Caranguejos
Bysen:Cite journal	Predefinição:Citar periódico
Bysen:Xpd	Predefinição:Xpd
Bysen:Lang-ar	Predefinição:Lang-ar
Bysen:Brūcend es-0	Predefinição:User es-0
Bysen:Cite news	Predefinição:Citar notícia
Bysen:Featured article	Predefinição:Artigo destacado
Bysen:Country data Russia	Predefinição:Country data Rússia
Flocc:Paris	Categoria:Paris
Flocc:Brūcend en-4	Categoria:Utilizador en-4
Flocc:Brūcend en	Categoria:Usuários en
Flocc:Croatia	Categoria:Croácia
Flocc:Brūcend en-2	Categoria:Usuário en-2
Bysen:Infobox	Predefinição:Info
Bysen:Main other	Predefinição:Artigos e outros
Flocc:Francena cyningas	Categoria:Reis da França
Flocc:Stafas	Categoria:Alfabetos
Wikipǣdia:Gecorene gemynddagas/23 Hāligmōnaþ	Wikipédia:Efemérides/23 de setembro
Bysen:Template other	Predefinição:Template other
Wikipǣdia:Gecorene gemynddagas/4 Solmōnaþ	Wikipédia:Efemérides/4 de fevereiro
Wikipǣdia:Gecorene gemynddagas/22 Hāligmōnaþ	Wikipédia:Efemérides/22 de setembro
Bysen:Lang-da	Predefinição:Lang-da
Wikipǣdia:Gecorene gemynddagas/30 Blōtmōnaþ	Wikipédia:Efemérides/30 de novembro
Wikipǣdia:Gecorene gemynddagas/18 Solmōnaþ	Wikipédia:Efemérides/18 de fevereiro
Wikipǣdia:Gecorene gemynddagas/28 Æfterra Gēola	Wikipédia:Efemérides/28 de janeiro
Bysen:Legend	Predefinição:Legenda
Wikipǣdia:Gecorene gemynddagas/14 Æfterra Gēola	Wikipédia:Efemérides/14 de janeiro
Bysen:Lang-got	Predefinição:Lang-got
Wikipǣdia:Gecorene gemynddagas/25 Solmōnaþ	Wikipédia:Efemérides/25 de fevereiro
Wikipǣdia:Gecorene gemynddagas/10 Wēodmōnaþ	Wikipédia:Efemérides/10 de agosto
Flocc:Bryttisce wrīteras	Categoria:Escritores do Reino Unido
Wikipǣdia:Gecorene gemynddagas/15 Winterfylleþ	Wikipédia:Efemérides/15 de outubro
Wikipǣdia:Gecorene gemynddagas/31 Wēodmōnaþ	Wikipédia:Efemérides/31 de agosto
Wikipǣdia:Gecorene gemynddagas/12 Blōtmōnaþ	Wikipédia:Efemérides/12 de novembro
Wikipǣdia:Gecorene gemynddagas/30 Mǣdmōnaþ	Wikipédia:Efemérides/30 de julho
Wikipǣdia:Gecorene gemynddagas/3 Wēodmōnaþ	Wikipédia:Efemérides/3 de agosto
Wikipǣdia:Gecorene gemynddagas/27 Wēodmōnaþ	Wikipédia:Efemérides/27 de agosto
Bysen:Cite web	Predefinição:Citar web
Wikipǣdia:Gecorene gemynddagas/21 Æfterra Gēola	Wikipédia:Efemérides/21 de janeiro
Wikipǣdia:Gecorene gemynddagas/8 Solmōnaþ	Wikipédia:Efemérides/8 de fevereiro
Bysen:Country data Italy	Predefinição:Country data Itália
Wikipǣdia:Gecorene gemynddagas/20 Æfterra Gēola	Wikipédia:Efemérides/20 de janeiro
Wikipǣdia:Gecorene gemynddagas/23 Æfterra Gēola	Wikipédia:Efemérides/23 de janeiro
Wikipǣdia:Gecorene gemynddagas/28 Hāligmōnaþ	Wikipédia:Efemérides/28 de setembro
Bysen:Imdb title	Predefinição:IMDb título
Wikipǣdia:Gecorene gemynddagas/31 Gēolmōnaþ	Wikipédia:Efemérides/31 de dezembro
Wikipǣdia:Gecorene gemynddagas/1 Solmōnaþ	Wikipédia:Efemérides/1 de fevereiro
Wikipǣdia:Gecorene gemynddagas/14 Gēolmōnaþ	Wikipédia:Efemérides/14 de dezembro
Wikipǣdia:Gecorene gemynddagas/25 Æfterra Gēola	Wikipédia:Efemérides/25 de janeiro
Wikipǣdia:Gecorene gemynddagas/6 Wēodmōnaþ	Wikipédia:Efemérides/6 de agosto
Wikipǣdia:Gecorene gemynddagas/24 Wēodmōnaþ	Wikipédia:Efemérides/24 de agosto
Wikipǣdia:Gecorene gemynddagas/9 Blōtmōnaþ	Wikipédia:Efemérides/9 de novembro
Wikipǣdia:Gecorene gemynddagas/18 Æfterra Gēola	Wikipédia:Efemérides/18 de janeiro
Wikipǣdia:Gecorene gemynddagas/17 Wēodmōnaþ	Wikipédia:Efemérides/17 de agosto
Wikipǣdia:Gecorene gemynddagas/27 Mǣdmōnaþ	Wikipédia:Efemérides/27 de julho
Bysen:Country data	Predefinição:Dados de país
Wikipǣdia:Gecorene gemynddagas/20 Wēodmōnaþ	Wikipédia:Efemérides/20 de agosto
Wikipǣdia:Gecorene gemynddagas/1 Winterfylleþ	Wikipédia:Efemérides/1 de outubro
Wikipǣdia:Gecorene gemynddagas/5 Winterfylleþ	Wikipédia:Efemérides/5 de outubro
Wikipǣdia:Gecorene gemynddagas/8 Winterfylleþ	Wikipédia:Efemérides/8 de outubro
Wikipǣdia:Talk page	Wikipédia:Página de discussão de artigo
Wikipǣdia:Gecorene gemynddagas/15 Solmōnaþ	Wikipédia:Efemérides/15 de fevereiro
Bysen:Coor URL	Predefinição:Coor URL
Bysen:Notice	Predefinição:Notícia
Bysen:Pp-template	Predefinição:Pp-template
Bysen:·	Predefinição:·
Bysen:Brūcend nl-1	Predefinição:User nl-1
Bysen:Infobox Winodland	Predefinição:Info/Cidade da Polônia
Bysen:Min	Predefinição:Min
Bysen:Wiktionarypar2	Predefinição:Wikcionário
Bysen:Brūcend nl-2	Predefinição:User nl-2
Bysen:Lang-enm	Predefinição:Lang-enm
Bysen:Country data Sweden	Predefinição:Country data Suécia
Flocc:Byrig on Dēnum	Categoria:Cidades da Dinamarca
Bysen:Lang-ang	Predefinição:Lang-ang
Flocc:Eorþtilþ	Categoria:Agricultura
Wikipǣdia:Gecorene gemynddagas/26 Blōtmōnaþ	Wikipédia:Efemérides/26 de novembro
Wikipǣdia:Gecorene gemynddagas/26 Wēodmōnaþ	Wikipédia:Efemérides/26 de agosto
Wikipǣdia:Gecorene gemynddagas/12 Gēolmōnaþ	Wikipédia:Efemérides/12 de dezembro
Wikipǣdia:Gecorene gemynddagas/25 Gēolmōnaþ	Wikipédia:Efemérides/25 de dezembro
Wikipǣdia:Gecorene gemynddagas/10 Æfterra Gēola	Wikipédia:Efemérides/10 de janeiro
Wikipǣdia:Gecorene gemynddagas/31 Æfterra Gēola	Wikipédia:Efemérides/31 de janeiro
Wikipǣdia:Gecorene gemynddagas/6 Winterfylleþ	Wikipédia:Efemérides/6 de outubro
Wikipǣdia:Gecorene gemynddagas/6 Hrēþmōnaþ	Wikipédia:Efemérides/6 de março
Wikipǣdia:Gecorene gemynddagas/18 Hrēþmōnaþ	Wikipédia:Efemérides/18 de março
Wikipǣdia:Gecorene gemynddagas/17 Winterfylleþ	Wikipédia:Efemérides/17 de outubro
Wikipǣdia:Gecorene gemynddagas/27 Hrēþmōnaþ	Wikipédia:Efemérides/27 de março
Wikipǣdia:Gecorene gemynddagas/19 Hrēþmōnaþ	Wikipédia:Efemérides/19 de março
Wikipǣdia:Gecorene gemynddagas/2 Winterfylleþ	Wikipédia:Efemérides/2 de outubro
Wikipǣdia:Gecorene gemynddagas/2 Mǣdmōnaþ	Wikipédia:Efemérides/2 de julho
Wikipǣdia:Gecorene gemynddagas/10 Hrēþmōnaþ	Wikipédia:Efemérides/10 de março
Wikipǣdia:Gecorene gemynddagas/1 Ēastermōnaþ	Wikipédia:Efemérides/1 de abril
Wikipǣdia:Gecorene gemynddagas/31 Mǣdmōnaþ	Wikipédia:Efemérides/31 de julho
Wikipǣdia:Gecorene gemynddagas/12 Wēodmōnaþ	Wikipédia:Efemérides/12 de agosto
Wikipǣdia:Gecorene gemynddagas/26 Solmōnaþ	Wikipédia:Efemérides/26 de fevereiro
Wikipǣdia:Gecorene gemynddagas/17 Mǣdmōnaþ	Wikipédia:Efemérides/17 de julho
Wikipǣdia:Gecorene gemynddagas/5 Wēodmōnaþ	Wikipédia:Efemérides/5 de agosto
Wikipǣdia:Gecorene gemynddagas/16 Hāligmōnaþ	Wikipédia:Efemérides/16 de setembro
Wikipǣdia:Gecorene gemynddagas/31 Winterfylleþ	Wikipédia:Efemérides/31 de outubro
Wikipǣdia:Gecorene gemynddagas/12 Solmōnaþ	Wikipédia:Efemérides/12 de fevereiro
Wikipǣdia:Gecorene gemynddagas/15 Æfterra Gēola	Wikipédia:Efemérides/15 de janeiro
Wikipǣdia:Gecorene gemynddagas/19 Hāligmōnaþ	Wikipédia:Efemérides/19 de setembro
Wikipǣdia:Gecorene gemynddagas/16 Æfterra Gēola	Wikipédia:Efemérides/16 de janeiro
Wikipǣdia:Gecorene gemynddagas/13 Mǣdmōnaþ	Wikipédia:Efemérides/13 de julho
Wikipǣdia:Gecorene gemynddagas/2 Æfterra Gēola	Wikipédia:Efemérides/2 de janeiro
Wikipǣdia:Gecorene gemynddagas/9 Mǣdmōnaþ	Wikipédia:Efemérides/9 de julho
Wikipǣdia:Gecorene gemynddagas/10 Solmōnaþ	Wikipédia:Efemérides/10 de fevereiro
Wikipǣdia:Gecorene gemynddagas/5 Hrēþmōnaþ	Wikipédia:Efemérides/5 de março
Wikipǣdia:Gecorene gemynddagas/29 Sēremōnaþ	Wikipédia:Efemérides/29 de junho
Wikipǣdia:Gecorene gemynddagas/14 Blōtmōnaþ	Wikipédia:Efemérides/14 de novembro
Wikipǣdia:Gecorene gemynddagas/6 Æfterra Gēola	Wikipédia:Efemérides/6 de janeiro
Wikipǣdia:Gecorene gemynddagas/18 Mǣdmōnaþ	Wikipédia:Efemérides/18 de julho
Wikipǣdia:Gecorene gemynddagas/23 Mǣdmōnaþ	Wikipédia:Efemérides/23 de julho
Wikipǣdia:Gecorene gemynddagas/1 Mǣdmōnaþ	Wikipédia:Efemérides/1 de julho
Wikipǣdia:Gecorene gemynddagas/20 Gēolmōnaþ	Wikipédia:Efemérides/20 de dezembro
Wikipǣdia:Gecorene gemynddagas/30 Wēodmōnaþ	Wikipédia:Efemérides/30 de agosto
Wikipǣdia:Gecorene gemynddagas/11 Wēodmōnaþ	Wikipédia:Efemérides/11 de agosto
Wikipǣdia:Gecorene gemynddagas/9 Wēodmōnaþ	Wikipédia:Efemérides/9 de agosto
Wikipǣdia:Gecorene gemynddagas/29 Blōtmōnaþ	Wikipédia:Efemérides/29 de novembro
Wikipǣdia:Gecorene gemynddagas/2 Ēastermōnaþ	Wikipédia:Efemérides/2 de abril
Wikipǣdia:Gecorene gemynddagas/12 Mǣdmōnaþ	Wikipédia:Efemérides/12 de julho
Wikipǣdia:Gecorene gemynddagas/29 Wēodmōnaþ	Wikipédia:Efemérides/29 de agosto
Wikipǣdia:Gecorene gemynddagas/24 Sēremōnaþ	Wikipédia:Efemérides/24 de junho
Wikipǣdia:Gecorene gemynddagas/25 Blōtmōnaþ	Wikipédia:Efemérides/25 de novembro
Wikipǣdia:Gecorene gemynddagas/21 Wēodmōnaþ	Wikipédia:Efemérides/21 de agosto
Wikipǣdia:Gecorene gemynddagas/29 Mǣdmōnaþ	Wikipédia:Efemérides/29 de julho
Wikipǣdia:Gecorene gemynddagas/29 Æfterra Gēola	Wikipédia:Efemérides/29 de janeiro
Wikipǣdia:Gecorene gemynddagas/5 Gēolmōnaþ	Wikipédia:Efemérides/5 de dezembro
Wikipǣdia:Gecorene gemynddagas/25 Hrēþmōnaþ	Wikipédia:Efemérides/25 de março
Wikipǣdia:Gecorene gemynddagas/22 Hrēþmōnaþ	Wikipédia:Efemérides/22 de março
Wikipǣdia:Gecorene gemynddagas/9 Hrēþmōnaþ	Wikipédia:Efemérides/9 de março
Wikipǣdia:Gecorene gemynddagas/12 Hrēþmōnaþ	Wikipédia:Efemérides/12 de março
Wikipǣdia:Gecorene gemynddagas/11 Hrēþmōnaþ	Wikipédia:Efemérides/11 de março
Wikipǣdia:Gecorene gemynddagas/19 Gēolmōnaþ	Wikipédia:Efemérides/19 de dezembro
Wikipǣdia:Gecorene gemynddagas/24 Solmōnaþ	Wikipédia:Efemérides/24 de fevereiro
Wikipǣdia:Gecorene gemynddagas/13 Solmōnaþ	Wikipédia:Efemérides/13 de fevereiro
Wikipǣdia:Gecorene gemynddagas/20 Solmōnaþ	Wikipédia:Efemérides/20 de fevereiro
Wikipǣdia:Gecorene gemynddagas/5 Æfterra Gēola	Wikipédia:Efemérides/5 de janeiro
Wikipǣdia:Gecorene gemynddagas/15 Hrēþmōnaþ	Wikipédia:Efemérides/15 de março
Wikipǣdia:Gecorene gemynddagas/23 Solmōnaþ	Wikipédia:Efemérides/23 de fevereiro
Wikipǣdia:Gecorene gemynddagas/13 Hrēþmōnaþ	Wikipédia:Efemérides/13 de março
Wikipǣdia:Gecorene gemynddagas/15 Hāligmōnaþ	Wikipédia:Efemérides/15 de setembro
Wikipǣdia:Gecorene gemynddagas/15 Gēolmōnaþ	Wikipédia:Efemérides/15 de dezembro
Wikipǣdia:Gecorene gemynddagas/4 Hāligmōnaþ	Wikipédia:Efemérides/4 de setembro
Wikipǣdia:Gecorene gemynddagas/8 Hāligmōnaþ	Wikipédia:Efemérides/8 de setembro
Wikipǣdia:Gecorene gemynddagas/18 Gēolmōnaþ	Wikipédia:Efemérides/18 de dezembro
Wikipǣdia:Gecorene gemynddagas/4 Hrēþmōnaþ	Wikipédia:Efemérides/4 de março
Wikipǣdia:Gecorene gemynddagas/4 Winterfylleþ	Wikipédia:Efemérides/4 de outubro
Wikipǣdia:Gecorene gemynddagas/21 Blōtmōnaþ	Wikipédia:Efemérides/21 de novembro
Wikipǣdia:Gecorene gemynddagas/1 Hāligmōnaþ	Wikipédia:Efemérides/1 de setembro
Wikipǣdia:Gecorene gemynddagas/3 Mǣdmōnaþ	Wikipédia:Efemérides/3 de julho
Wikipǣdia:Gecorene gemynddagas/4 Mǣdmōnaþ	Wikipédia:Efemérides/4 de julho
Wikipǣdia:Gecorene gemynddagas/13 Æfterra Gēola	Wikipédia:Efemérides/13 de janeiro
Wikipǣdia:Gecorene gemynddagas/28 Sēremōnaþ	Wikipédia:Efemérides/28 de junho
Wikipǣdia:Gecorene gemynddagas/7 Sēremōnaþ	Wikipédia:Efemérides/7 de junho
Wikipǣdia:Gecorene gemynddagas/6 Hāligmōnaþ	Wikipédia:Efemérides/6 de setembro
Wikipǣdia:Gecorene gemynddagas/25 Hāligmōnaþ	Wikipédia:Efemérides/25 de setembro
Wikipǣdia:Gecorene gemynddagas/27 Æfterra Gēola	Wikipédia:Efemérides/27 de janeiro
Wikipǣdia:Gecorene gemynddagas/6 Mǣdmōnaþ	Wikipédia:Efemérides/6 de julho
Wikipǣdia:Gecorene gemynddagas/15 Mǣdmōnaþ	Wikipédia:Efemérides/15 de julho
Wikipǣdia:Gecorene gemynddagas/10 Hāligmōnaþ	Wikipédia:Efemérides/10 de setembro
Wikipǣdia:Gecorene gemynddagas/26 Hāligmōnaþ	Wikipédia:Efemérides/26 de setembro
Wikipǣdia:Gecorene gemynddagas/20 Hāligmōnaþ	Wikipédia:Efemérides/20 de setembro
Wikipǣdia:Gecorene gemynddagas/16 Mǣdmōnaþ	Wikipédia:Efemérides/16 de julho
Wikipǣdia:Gecorene gemynddagas/14 Mǣdmōnaþ	Wikipédia:Efemérides/14 de julho
Wikipǣdia:Gecorene gemynddagas/25 Mǣdmōnaþ	Wikipédia:Efemérides/25 de julho
Wikipǣdia:Gecorene gemynddagas/12 Æfterra Gēola	Wikipédia:Efemérides/12 de janeiro
Wikipǣdia:Gecorene gemynddagas/23 Wēodmōnaþ	Wikipédia:Efemérides/23 de agosto
Wikipǣdia:Gecorene gemynddagas/22 Sēremōnaþ	Wikipédia:Efemérides/22 de junho
Wikipǣdia:Gecorene gemynddagas/16 Wēodmōnaþ	Wikipédia:Efemérides/16 de agosto
Wikipǣdia:Gecorene gemynddagas/30 Gēolmōnaþ	Wikipédia:Efemérides/30 de dezembro
Wikipǣdia:Gecorene gemynddagas/4 Blōtmōnaþ	Wikipédia:Efemérides/4 de novembro
Wikipǣdia:Gecorene gemynddagas/3 Æfterra Gēola	Wikipédia:Efemérides/3 de janeiro
Wikipǣdia:Gecorene gemynddagas/30 Hāligmōnaþ	Wikipédia:Efemérides/30 de setembro
Wikipǣdia:Gecorene gemynddagas/8 Æfterra Gēola	Wikipédia:Efemérides/8 de janeiro
Wikipǣdia:Gecorene gemynddagas/1 Hrēþmōnaþ	Wikipédia:Efemérides/1 de março
Wikipǣdia:Gecorene gemynddagas/14 Solmōnaþ	Wikipédia:Efemérides/14 de fevereiro
Wikipǣdia:Gecorene gemynddagas/7 Winterfylleþ	Wikipédia:Efemérides/7 de outubro
Wikipǣdia:Gecorene gemynddagas/19 Solmōnaþ	Wikipédia:Efemérides/19 de fevereiro
Wikipǣdia:Gecorene gemynddagas/28 Hrēþmōnaþ	Wikipédia:Efemérides/28 de março
Wikipǣdia:Gecorene gemynddagas/20 Hrēþmōnaþ	Wikipédia:Efemérides/20 de março
Wikipǣdia:Gecorene gemynddagas/6 Solmōnaþ	Wikipédia:Efemérides/6 de fevereiro
Wikipǣdia:Gecorene gemynddagas/7 Solmōnaþ	Wikipédia:Efemérides/7 de fevereiro
Wikipǣdia:Gecorene gemynddagas/21 Solmōnaþ	Wikipédia:Efemérides/21 de fevereiro
Wikipǣdia:Gecorene gemynddagas/1 Wēodmōnaþ	Wikipédia:Efemérides/1 de agosto
Wikipǣdia:Gecorene gemynddagas/14 Hrēþmōnaþ	Wikipédia:Efemérides/14 de março
Wikipǣdia:Gecorene gemynddagas/28 Solmōnaþ	Wikipédia:Efemérides/28 de fevereiro
Wikipǣdia:Gecorene gemynddagas/27 Hāligmōnaþ	Wikipédia:Efemérides/27 de setembro
Wikipǣdia:Gecorene gemynddagas/8 Mǣdmōnaþ	Wikipédia:Efemérides/8 de julho
Wikipǣdia:Gecorene gemynddagas/11 Hāligmōnaþ	Wikipédia:Efemérides/11 de setembro
Wikipǣdia:Gecorene gemynddagas/22 Mǣdmōnaþ	Wikipédia:Efemérides/22 de julho
Wikipǣdia:Gecorene gemynddagas/28 Wēodmōnaþ	Wikipédia:Efemérides/28 de agosto
Wikipǣdia:Gecorene gemynddagas/1 Blōtmōnaþ	Wikipédia:Efemérides/1 de novembro
Wikipǣdia:Gecorene gemynddagas/2 Solmōnaþ	Wikipédia:Efemérides/2 de fevereiro
Wikipǣdia:Gecorene gemynddagas/4 Wēodmōnaþ	Wikipédia:Efemérides/4 de agosto
Wikipǣdia:Gecorene gemynddagas/22 Gēolmōnaþ	Wikipédia:Efemérides/22 de dezembro
Wikipǣdia:Gecorene gemynddagas/20 Winterfylleþ	Wikipédia:Efemérides/20 de outubro
Wikipǣdia:Gecorene gemynddagas/17 Æfterra Gēola	Wikipédia:Efemérides/17 de janeiro
Wikipǣdia:Gecorene gemynddagas/3 Solmōnaþ	Wikipédia:Efemérides/3 de fevereiro
Bysen:Lang-sr	Predefinição:Lang-sr
Wikipǣdia:Gecorene gemynddagas/7 Mǣdmōnaþ	Wikipédia:Efemérides/7 de julho
Wikipǣdia:Gecorene gemynddagas/24 Mǣdmōnaþ	Wikipédia:Efemérides/24 de julho
Wikipǣdia:Gecorene gemynddagas/21 Mǣdmōnaþ	Wikipédia:Efemérides/21 de julho
Wikipǣdia:Gecorene gemynddagas/6 Sēremōnaþ	Wikipédia:Efemérides/6 de junho
Wikipǣdia:Gecorene gemynddagas/11 Mǣdmōnaþ	Wikipédia:Efemérides/11 de julho
Wikipǣdia:Gecorene gemynddagas/8 Wēodmōnaþ	Wikipédia:Efemérides/8 de agosto
Wikipǣdia:Gecorene gemynddagas/15 Wēodmōnaþ	Wikipédia:Efemérides/15 de agosto
Wikipǣdia:Gecorene gemynddagas/10 Mǣdmōnaþ	Wikipédia:Efemérides/10 de julho
Wikipǣdia:Gecorene gemynddagas/16 Hrēþmōnaþ	Wikipédia:Efemérides/16 de março
Wikipǣdia:Gecorene gemynddagas/14 Winterfylleþ	Wikipédia:Efemérides/14 de outubro
Wikipǣdia:Gecorene gemynddagas/17 Hrēþmōnaþ	Wikipédia:Efemérides/17 de março
Wikipǣdia:Gecorene gemynddagas/24 Hrēþmōnaþ	Wikipédia:Efemérides/24 de março
Wikipǣdia:Gecorene gemynddagas/21 Hrēþmōnaþ	Wikipédia:Efemérides/21 de março
Wikipǣdia:Gecorene gemynddagas/5 Solmōnaþ	Wikipédia:Efemérides/5 de fevereiro
Wikipǣdia:Gecorene gemynddagas/3 Winterfylleþ	Wikipédia:Efemérides/3 de outubro
Wikipǣdia:Gecorene gemynddagas/7 Hāligmōnaþ	Wikipédia:Efemérides/7 de setembro
Wikipǣdia:Gecorene gemynddagas/26 Mǣdmōnaþ	Wikipédia:Efemérides/26 de julho
Wikipǣdia:Gecorene gemynddagas/14 Sēremōnaþ	Wikipédia:Efemérides/14 de junho
Flocc:Beorgas	Categoria:Montanhas
Bysen:Brūcend ru	Predefinição:User ru
Flocc:20e gēarhundred	Categoria:Século XX
Bysen:IPA	Predefinição:AFI
Bysen:Bēc þǣre Nīwan Gecȳþnesse	Predefinição:Novo Testamento
Bysen:HāligmōnaþGerīmbōc	Predefinição:Calendário de setembro
Bysen:USpresidents	Predefinição:Presidentes dos Estados Unidos
Wikipǣdia:Gecorene gemynddagas/7 Hrēþmōnaþ	Wikipédia:Efemérides/7 de março
Wikipǣdia:Gecorene gemynddagas/29 Hrēþmōnaþ	Wikipédia:Efemérides/29 de março
Flocc:Bysen Brūcend Box Spræc	Categoria:!Predefinições de babel
Wikipǣdia:Gecorene gemynddagas/28 Ēastermōnaþ	Wikipédia:Efemérides/28 de abril
Bysen:LangWithName	Predefinição:Língua com nome
Flocc:Hwæsingatūn	Categoria:Washington
Flocc:Wihta	Categoria:Criaturas fantásticas
Wikipǣdia:Gecorene gemynddagas/30 Hrēþmōnaþ	Wikipédia:Efemérides/30 de março
Wikipǣdia:Gecorene gemynddagas/22 Solmōnaþ	Wikipédia:Efemérides/22 de fevereiro
Wikipǣdia:Gecorene gemynddagas/31 Hrēþmōnaþ	Wikipédia:Efemérides/31 de março
Wikipǣdia:Gecorene gemynddagas/23 Hrēþmōnaþ	Wikipédia:Efemérides/23 de março
Wikipǣdia:Gecorene gemynddagas/17 Solmōnaþ	Wikipédia:Efemérides/17 de fevereiro
Bysen:Birth date and age	Predefinição:Ani
Bysen:MONTHNAME	Predefinição:MONTHNAME
Wikipǣdia:Gecorene gemynddagas/30 Æfterra Gēola	Wikipédia:Efemérides/30 de janeiro
Wikipǣdia:Gecorene gemynddagas/9 Solmōnaþ	Wikipédia:Efemérides/9 de fevereiro
Wikipǣdia:Gecorene gemynddagas/8 Hrēþmōnaþ	Wikipédia:Efemérides/8 de março
Bysen:Sortname	Predefinição:Sortname
Flocc:Gebēd	Categoria:Orações
Wikipǣdia:Gecorene gemynddagas/29 Solmōnaþ	Wikipédia:Efemérides/29 de fevereiro
Wikipǣdia:Gecorene gemynddagas/2 Hrēþmōnaþ	Wikipédia:Efemérides/2 de março
Bysen:Country data Ireland	Predefinição:Country data Irlanda
Wikipǣdia:Gecorene gemynddagas/27 Solmōnaþ	Wikipédia:Efemérides/27 de fevereiro
Wikipǣdia:Gecorene gemynddagas/26 Hrēþmōnaþ	Wikipédia:Efemérides/26 de março
Flocc:Country data templates	Categoria:!Predefinições Country data
Bysen:Namespace detect	Predefinição:Namespace detect
Bysen:Fmbox	Predefinição:Fmbox
Bysen:Country data England	Predefinição:Country data Inglaterra
Flocc:19e gēarhundred	Categoria:Século XIX
Bysen:Country data Republic of Ireland	Predefinição:Country data República da Irlanda
Flocc:Wrīteras	Categoria:Escritores
Bysen:Country data Switzerland	Predefinição:Country data Suíça
Flocc:Eormengyld	Categoria:Universidades
Bysen:Lang-cs	Predefinição:Lang-cs
Bysen:Lang-he	Predefinição:Lang-he
Bysen:Infobox OS	Predefinição:Info/SO
Bysen:Brūcend pt-1	Predefinição:User pt-1
Flocc:Æfterra Gēola	Categoria:Janeiro
Bysen:Lang-fa	Predefinição:Lang-fa
Bysen:Brūcend pl	Predefinição:User pl
Bysen:Brūcend nl	Predefinição:User nl
Bysen:Tab	Predefinição:Separador
Wikipǣdia:Gecorene gemynddagas/12 Winterfylleþ	Wikipédia:Efemérides/12 de outubro
Bysen:Brūcend no-2	Predefinição:User no-2
Bysen:Start tab	Predefinição:Fim dos separadores
Wikipǣdia:Gecorene gemynddagas/11 Solmōnaþ	Wikipédia:Efemérides/11 de fevereiro
Bysen:Australia	Predefinição:Austrália
Wikipǣdia:Gecorene gemynddagas/5 Blōtmōnaþ	Wikipédia:Efemérides/5 de novembro
Wikipǣdia:Gecorene gemynddagas/11 Æfterra Gēola	Wikipédia:Efemérides/11 de janeiro
Wikipǣdia:Gecorene gemynddagas/3 Hāligmōnaþ	Wikipédia:Efemérides/3 de setembro
Wikipǣdia:Gecorene gemynddagas/24 Hāligmōnaþ	Wikipédia:Efemérides/24 de setembro
Bysen:Please don't change this page	Wikipédia:Introdução/2
Bysen:Tlx	Predefinição:Tlx
Bysen:CAN	Predefinição:CAN
Bysen:Lang-de	Predefinição:Lang-de
Bysen:Country data Austria-Hungary	Predefinição:Country data Áustria-Hungria
Bysen:Sæternes Bōtm	Predefinição:Luas de Saturno
Bysen:Lang-la	Predefinição:Lang-la
Bysen:Lang-af	Predefinição:Lang-af
Bysen:Infobox Album	Predefinição:Info/Álbum
Bysen:User	Predefinição:Usuário2
Wikipǣdia:Gecorene gemynddagas/16 Gēolmōnaþ	Wikipédia:Efemérides/16 de dezembro
Wikipǣdia:Gecorene gemynddagas/9 Æfterra Gēola	Wikipédia:Efemérides/9 de janeiro
Wikipǣdia:Gecorene gemynddagas/7 Æfterra Gēola	Wikipédia:Efemérides/7 de janeiro
Wikipǣdia:Gecorene gemynddagas/19 Mǣdmōnaþ	Wikipédia:Efemérides/19 de julho
Wikipǣdia:Gecorene gemynddagas/13 Wēodmōnaþ	Wikipédia:Efemérides/13 de agosto
Wikipǣdia:Gecorene gemynddagas/12 Hāligmōnaþ	Wikipédia:Efemérides/12 de setembro
Wikipǣdia:Gecorene gemynddagas/2 Hāligmōnaþ	Wikipédia:Efemérides/2 de setembro
Wikipǣdia:Gecorene gemynddagas/7 Wēodmōnaþ	Wikipédia:Efemérides/7 de agosto
Wikipǣdia:Gecorene gemynddagas/4 Ēastermōnaþ	Wikipédia:Efemérides/4 de abril
Wikipǣdia:Gecorene gemynddagas/22 Æfterra Gēola	Wikipédia:Efemérides/22 de janeiro
Wikipǣdia:Gecorene gemynddagas/4 Æfterra Gēola	Wikipédia:Efemérides/4 de janeiro
Wikipǣdia:Gecorene gemynddagas/19 Wēodmōnaþ	Wikipédia:Efemérides/19 de agosto
Wikipǣdia:Gecorene gemynddagas/18 Hāligmōnaþ	Wikipédia:Efemérides/18 de setembro
Wikipǣdia:Gecorene gemynddagas/4 Gēolmōnaþ	Wikipédia:Efemérides/4 de dezembro
Wikipǣdia:Gecorene gemynddagas/2 Wēodmōnaþ	Wikipédia:Efemérides/2 de agosto
Wikipǣdia:Gecorene gemynddagas/21 Gēolmōnaþ	Wikipédia:Efemérides/21 de dezembro
Wikipǣdia:Gecorene gemynddagas/20 Mǣdmōnaþ	Wikipédia:Efemérides/20 de julho
Wikipǣdia:Gecorene gemynddagas/18 Wēodmōnaþ	Wikipédia:Efemérides/18 de agosto
Wikipǣdia:Gecorene gemynddagas/24 Æfterra Gēola	Wikipédia:Efemérides/24 de janeiro
Wikipǣdia:Brōðra rǣdscēawung	Wikipédia:Processo de revisão
Bysen:Year nav	Predefinição:Cabeçalho dos anos
Flocc:Flyhthæfenan on Fietname	Categoria:Aeroportos do Vietname
Bysen:Brūcend pl-1	Predefinição:User pl-1
Flocc:Bryttisce cyningas	Categoria:Monarcas britânicos
Bysen:Brūcend fr-3	Predefinição:User fr-3
Bysen:GRA mid rīce namum	Predefinição:USA imagemap with state names small
Bysen:Imdb name	Predefinição:Imdb nome
Flocc:Tunisia	Categoria:Tunísia
Bysen:PD	Predefinição:DomínioPúblico
Bysen:Cyþþubox Ira tun	Predefinição:Info/Cidade da Irlanda
Bysen:Wikispell	Predefinição:Wikinotícias
Bysen:Brūcend lt	Predefinição:User lt
Bysen:Cc-by-sa-2.0	Predefinição:Cc-by-sa-2.0
Bysen:Mbox	Predefinição:Mbox
Bysen:Oppose	Predefinição:Discordo
Bysen:Coord/link	Predefinição:Coord/link
Bysen:Infobox UK place	Predefinição:Info/Cidade do Reino Unido
Bysen:Brūcend is-1	Predefinição:User is-1
Bysen:Brūcend is-2	Predefinição:User is-2
Bysen:Brūcend is	Predefinição:User is
Bysen:Dagas þǣre wuce	Predefinição:Dias da semana
Flocc:Norþ Carolīna	Categoria:Carolina do Norte
Flocc:Puerto Rico	Categoria:Porto Rico
Bysen:ColBreak	Predefinição:Multicol-break
Flocc:Byrig þāra Geāndena Rīca American	Categoria:Cidades dos Estados Unidos
Bysen:Country data West Germany	Predefinição:Country data Alemanha Ocidental
Bysen:Lang-ru	Predefinição:Lang-ru
Bysen:Country data East Germany	Predefinição:Country data Alemanha Oriental
Bysen:Browsebar	Predefinição:Barra de portais
Bysen:Timeline Temperature Conversion	Predefinição:Retas de Conversão de Temperatura
Bysen:SolmōnaþGerīmbōc	Predefinição:Calendário de fevereiro
Flocc:Brittisca Here	Categoria:Exército Britânico
Bysen:Disambig	Predefinição:Desambiguação
Bysen:Country data Nazi Germany	Predefinição:Country data Alemanha Nazi
Bysen:Doi	Predefinição:DOI
Bysen:Country data German Empire	Predefinição:Country data Império Alemão
Flocc:Coreanisc stǣr	Categoria:História da Coreia
Bysen:Elisabeþericiu	Predefinição:Reinos da Comunidade das Nações
Bysen:Lang-grc	Predefinição:Lang-grc
Bysen:Brūcend ksh	Predefinição:User ksh
Bysen:Infobox Film	Predefinição:Info/Filme
Bysen:Lang-en	Predefinição:Lang-en
Bysen:Fix	Predefinição:Fix
Bysen:Lang-id	Predefinição:Lang-id
Bysen:Period end	Predefinição:Período fim
Bysen:Tn	Predefinição:Tn
Bysen:Brūcend sv-2	Predefinição:User sv-2
Bysen:Brūcend it-2	Predefinição:User it-2
Bysen:Lang-fr	Predefinição:Lang-fr
Flocc:Angelseaxisc Englaland	Categoria:Reinos anglo-saxões
Bysen:Fossil range	Predefinição:Período fóssil
Bysen:Australia Labelled Map	Predefinição:Australia Labelled Map
Bysen:Brūcend pt-0	Predefinição:User pt-0
Bysen:Editnotice	Predefinição:Editnotice
Bysen:Betwuxwici	Predefinição:InterWiki
Flocc:Byrig in þǣm Niðerlandum	Categoria:Cidades dos Países Baixos
Bysen:Coord	Predefinição:Coord
Bysen:Brūcend pt-3	Predefinição:User pt-3
Bysen:TemplatePAGENAME	Predefinição:TemplatePAGENAME
Bysen:Country data Kalmar Union	Predefinição:Country data União de Kalmar
Bysen:Brūcend pt-2	Predefinição:User pt-2
Flocc:Wyoming	Categoria:Wyoming
Wikipǣdia:Gecorene gemynddagas/14 Hāligmōnaþ	Wikipédia:Efemérides/14 de setembro
Wikipǣdia:Gecorene gemynddagas/20 Sēremōnaþ	Wikipédia:Efemérides/20 de junho
Wikipǣdia:Gecorene gemynddagas/22 Wēodmōnaþ	Wikipédia:Efemérides/22 de agosto
Wikipǣdia:Gecorene gemynddagas/9 Hāligmōnaþ	Wikipédia:Efemérides/9 de setembro
Wikipǣdia:Gecorene gemynddagas/13 Hāligmōnaþ	Wikipédia:Efemérides/13 de setembro
Wikipǣdia:Gecorene gemynddagas/1 Æfterra Gēola	Wikipédia:Efemérides/1 de janeiro
Wikipǣdia:Gecorene gemynddagas/14 Wēodmōnaþ	Wikipédia:Efemérides/14 de agosto
Wikipǣdia:Gecorene gemynddagas/6 Gēolmōnaþ	Wikipédia:Efemérides/6 de dezembro
Flocc:Grēneland	Categoria:Gronelândia
Bysen:Brūcend la-1	Predefinição:User la-1
Bysen:Land on Europan	Predefinição:Países da Europa
Flocc:User sk	Categoria:Usuários sk
Flocc:Brūcend eo	Categoria:Usuários eo
Flocc:Brūcend fr	Categoria:Usuários fr
Flocc:Brūcend cy	Categoria:Usuários cy
Flocc:Brūcend la	Categoria:Usuários la
Flocc:Brūcend lt	Categoria:Usuários lt
Flocc:Brūcend pt	Categoria:Usuários pt
Flocc:Brūcend sv	Categoria:Usuários sv
Flocc:Brūcend fr-3	Categoria:Usuário fr-3
Flocc:Brūcend cy-3	Categoria:Usuário cy-3
Flocc:Brūcend it-3	Categoria:Usuário it-3
Flocc:Brūcend pl-3	Categoria:Usuário pl-3
Flocc:Brūcend fi-1	Categoria:Usuário fi-1
Flocc:Brūcend cy-1	Categoria:Usuário cy-1
Flocc:Brūcend nl-1	Categoria:Usuário nl-1
Flocc:Brūcend pl-1	Categoria:Usuário pl-1
Flocc:Brūcend fr-2	Categoria:Usuário fr-2
Flocc:Brūcend cy-2	Categoria:Usuário cy-2
Flocc:Brūcend it-2	Categoria:Usuário it-2
Flocc:Brūcend la-2	Categoria:Usuário la-2
Flocc:Brūcend pl-2	Categoria:Usuário pl-2
Flocc:Brūcend sv-2	Categoria:Usuário sv-2
Flocc:Brūcend fr-M	Categoria:Usuário fr
Flocc:Brūcend cy-M	Categoria:Usuário cy
Flocc:Brūcend is-M	Categoria:Usuário is
Flocc:Brūcend lt-N	Categoria:Usuário lt
Flocc:Brūcend nl-M	Categoria:Usuário nl
Flocc:Brūcend ru-M	Categoria:Usuário ru
Flocc:Feormung	Categoria:Entretenimento
Flocc:Hēafodstōlas þæs Sericus Gārsecges	Categoria:Capitais da Oceania
Flocc:Law & Order	Categoria:Law & Order
Flocc:Turcas and Caicos Īegland	Categoria:Turks e Caicos
Bysen:Sūþhjaltland	Predefinição:Shetlands do Sul
Flocc:Articles that need to be wikified	Categoria:!Artigos precisando de wikificação
Flocc:Byrig on Canadan	Categoria:Assentamentos no Canadá
Flocc:Īega	Categoria:Ilhas
Flocc:Sericus Garsecg	Categoria:Oceano Pacífico
Flocc:User sk-N	Categoria:Usuário sk
Flocc:Brūcend de	Categoria:Usuários de
Flocc:Brūcend de-2	Categoria:Usuário de-2
Flocc:Brūcend de-3	Categoria:Usuário de-3
Flocc:Brūcend el	Categoria:Usuários el
Flocc:Brūcend el-1	Categoria:Usuário el-1
Flocc:Brūcend el-2	Categoria:Usuário el-2
Flocc:Brūcend el-3	Categoria:Usuário el-3
Flocc:Brūcend el-N	Categoria:Usuário el
Flocc:Sūþgeorgia and þā Sūþsandwic Īegland	Categoria:Ilhas Geórgia do Sul e Sandwich do Sul
Flocc:Brūcend en-3	Categoria:Usuário en-3
Flocc:Brūcend en-M	Categoria:Usuário en
Flocc:Brūcend eo-2	Categoria:Usuário eo-2
Flocc:Brūcend es	Categoria:Usuários es
Flocc:Brūcend es-1	Categoria:Usuário es-1
Flocc:Brūcend es-2	Categoria:Usuário es-2
Flocc:Puilla	Categoria:Apúlia (Itália)
Flocc:Brūcend es-3	Categoria:Usuário es-3
Flocc:Brūcend es-4	Categoria:Usuário es-4
Flocc:Brūcend es-N	Categoria:Usuário es
Flocc:Brūcend fi	Categoria:Usuários fi
Flocc:Brūcend fi-M	Categoria:Usuário fi
Flocc:Brūcend fo	Categoria:Usuários fo
Flocc:Brūcend fo-1	Categoria:Usuário fo-1
Flocc:Brūcend fo-2	Categoria:Usuário fo-2
Flocc:Brūcend fo-M	Categoria:Usuário fo
Flocc:Brūcend is	Categoria:Usuários is
Flocc:Brūcend is-1	Categoria:Usuário is-1
Flocc:Brūcend is-2	Categoria:Usuário is-2
Flocc:Brūcend is-3	Categoria:Usuário is-3
Flocc:Mexiciscu rīce	Categoria:Subdivisões do México
Bysen:Brūcend la-3	Predefinição:User la-3
Flocc:Frencisc Guiana	Categoria:Guiana Francesa
Ǣht	Propriedade (direito)
Flocc:Hebrēisc sprǣc	Categoria:Língua hebraica
Flocc:Brūcend pt-3	Categoria:Usuário pt-3
Flocc:Bryttisc bōccræft	Categoria:Literatura do Reino Unido
Flocc:Brūcend pl-N	Categoria:Usuário pl
Flocc:Brūcend pt-1	Categoria:Usuário pt-1
Bysen:Country data Germany	Predefinição:Country data Alemanha
Bysen:Country data Geāned Cynerīce	Predefinição:Country data Reino Unido
Wikipǣdia:Gecorene gemynddagas/17 Gēolmōnaþ	Wikipédia:Efemérides/17 de dezembro
Bysen:Lang-be	Predefinição:Lang-be
Bysen:Cite encyclopedia	Predefinição:Citar enciclopédia
Bysen:Country data Scotland	Predefinição:Country data Escócia
Wikipǣdia:Tutorial (Formatting)	Ajuda:Tutorial/Formatação
Flocc:Brūcend it	Categoria:Usuários it
Flocc:Brūcend it-1	Categoria:Usuário it-1
Flocc:Rīcu þāra Geāndena Rīca American	Categoria:Estados dos Estados Unidos
Flocc:Brūcend ksh	Categoria:Usuários ksh
Bysen:Mpl	Predefinição:Pml
Flocc:Brūcend la-1	Categoria:Usuário la-1
Wikipǣdia:Gecorene gemynddagas/29 Hāligmōnaþ	Wikipédia:Efemérides/29 de setembro
Flocc:Brūcend la-3	Categoria:Usuário la-3
Flocc:Brūcend la-N	Categoria:Usuário la
Wikipǣdia:Gecorene gemynddagas/5 Hāligmōnaþ	Wikipédia:Efemérides/5 de setembro
Bysen:Cite doi	Predefinição:Cite doi
Flocc:Fȳrbeorgas	Categoria:Vulcões
Flocc:Dēorabyscīr	Categoria:Derbyshire
Flocc:Byrig on Latie	Categoria:Comunas do Lácio
Bysen:Englaland Scīra	Predefinição:Condados da Inglaterra
Flocc:Feohtan	Categoria:Artes marciais
Bysen:Country data Australasia	Predefinição:Country data Australásia
Flocc:Blōtmōnaþ	Categoria:Novembro
Flocc:Difelinscīr	Categoria:Condado de Dublin
Wikipǣdia:Babel	Wikipédia:Babel
Bysen:Help contents back	Predefinição:Ajuda conteúdo volta
Flocc:Lēodweard	Categoria:Posições de autoridade
Flocc:Byrig on Australie	Categoria:Assentamentos na Austrália
Flocc:Scopas	Categoria:Poetas
Bysen:BlōtmōnaþGerīmbōc	Predefinição:Calendário de novembro
Flocc:Hāligmōnaþ	Categoria:Setembro
Flocc:Winterfylleþ	Categoria:Outubro
Flocc:Sǣ	Categoria:Mares
Flocc:Gēolmōnaþ	Categoria:Dezembro
Flocc:Wēodmōnaþ	Categoria:Agosto
Flocc:Þrimilcemōnaþ	Categoria:Maio
Bysen:ÞrimilcemōnaþGerīmbōc	Predefinição:Calendário de maio
Flocc:Brandenburg	Categoria:Brandemburgo
Flocc:Englaland	Categoria:Inglaterra
Wikipǣdia:Gecorene gemynddagas/22 Blōtmōnaþ	Wikipédia:Efemérides/22 de novembro
Flocc:Ēastermōnaþ	Categoria:Abril
Bysen:IPA2	Predefinição:IPA-tudo
Flocc:Līfnamrǣden	Categoria:Taxonomia
Bysen:Lang-it	Predefinição:Lang-it
Bysen:Coord/dms2dec	Predefinição:Coord/dms2dec
Bysen:Country data Brazil	Predefinição:Country data Brasil
Flocc:Gestorfen in 988	Categoria:Mortos em 988
Flocc:Wæter	Categoria:Água
Leslie E. Robertson	Leslie Earl Robertson
Flocc:Hēafod and swēor	Categoria:Cabeça e pescoço
Flocc:Geboren in 121	Categoria:Nascidos em 121
Wikipǣdia:MediaWiki namespace	Wikipédia:Domínio MediaWiki
Flocc:180	Categoria:180
Flocc:Gestorfen in 180	Categoria:Mortos em 180
Flocc:Drincas	Categoria:Bebidas
Flocc:Gestorfen in 2005	Categoria:Mortos em 2005
Flocc:450	Categoria:450
Bysen:Start date and age	Predefinição:Data de lançamento
Flocc:Geboren in 1974	Categoria:Nascidos em 1974
Flocc:Geboren in 1899	Categoria:Nascidos em 1899
Flocc:Oklahoma	Categoria:Oklahoma
Flocc:Iapanisc sangeras	Categoria:Cantores do Japão
Flocc:Forman Þegnas	Categoria:Primeiros-ministros
Flocc:Geboren in 1954	Categoria:Nascidos em 1954
Flocc:850	Categoria:850
Flocc:Geboren in 850	Categoria:Nascidos em 850
Flocc:Hwītrussland	Categoria:Bielorrússia
Flocc:Alberta	Categoria:Alberta
Flocc:Ontario	Categoria:Ontário
Flocc:Nīwe Scotland	Categoria:Nova Escócia
Flocc:899	Categoria:899
Flocc:Gestorfen in 899	Categoria:Mortos em 899
Flocc:Geocon Landscipe	Categoria:Yukon
Flocc:Massachusetts	Categoria:Massachusetts
Flocc:924	Categoria:924
Flocc:Gestorfen in 924	Categoria:Mortos em 924
Bysen:Country data Ungerland	Predefinição:Country data Hungria
Flocc:Land on Affrice	Categoria:Países de África
Bysen:ÆfterraGēolaGerīmbōc	Predefinição:Calendário de janeiro
Bysen:Canadan underrīce	Predefinição:Províncias e territórios do Canadá
Bysen:Template reference list	Predefinição:Referências de predefinição
Flocc:Geboren in 1239	Categoria:Nascidos em 1239
Flocc:1249	Categoria:1249
Flocc:1289	Categoria:1289
Flocc:1305	Categoria:1305
Flocc:Gestorfen in 1305	Categoria:Mortos em 1305
Flocc:1307	Categoria:1307
Bysen:Brūcend pt-4	Predefinição:User pt-4
Bysen:Country data New Zealand	Predefinição:Country data Nova Zelândia
Bysen:Brūcend es-3	Predefinição:User es-3
Flocc:Ēa Franclandes	Categoria:Rios da França
Flocc:Brūcend pt-2	Categoria:Usuário pt-2
Flocc:Brūcend pt-4	Categoria:Usuário pt-4
Flocc:Brūcend pt-5	Categoria:Usuário pt-5
Flocc:Brūcend pt-N	Categoria:Usuário pt
Flocc:Brūcend ru	Categoria:Usuários ru
Flocc:Brūcend sv-M	Categoria:Usuário sv
Flocc:1634	Categoria:1634
Flocc:1638	Categoria:1638
Bysen:En icon	Predefinição:((en))
Flocc:1719	Categoria:1719
Flocc:Gestorfen in 1719	Categoria:Mortos em 1719
Bysen:Country data Faroe Islands	Predefinição:Country data Ilhas Faroe
Flocc:121	Categoria:121
Bysen:Lang	Predefinição:Lang
Wikipǣdia:Gecorene gemynddagas/21 Hāligmōnaþ	Wikipédia:Efemérides/21 de setembro
Bysen:Country data Americanisc	Predefinição:Country data Estados Unidos
Bysen:Template example row	Predefinição:Template example row
Bysen:Next period	Predefinição:Próximo período
Flocc:Trēowu	Categoria:Árvores
Bysen:Infobox ea	Predefinição:Info/Rio
Flocc:Geboren in 1634	Categoria:Nascidos em 1634
Flocc:Geboren in 1638	Categoria:Nascidos em 1638
Flocc:Geboren in 1852	Categoria:Nascidos em 1852
Flocc:Geboren in 1892	Categoria:Nascidos em 1892
Flocc:Geboren in 1918	Categoria:Nascidos em 1918
Flocc:Geboren in 1945	Categoria:Nascidos em 1945
Flocc:Geboren in 1949	Categoria:Nascidos em 1949
Flocc:Geboren in 1981	Categoria:Nascidos em 1981
Flocc:Geboren in 1993	Categoria:Nascidos em 1993
Flocc:1715	Categoria:1715
Bysen:Period color	Predefinição:Período cor
Flocc:11e gēarhundred	Categoria:Século XI
Flocc:988	Categoria:988
Flocc:10e gēarhundred	Categoria:Século X
Flocc:7e gēarhundred	Categoria:Século VII
Bysen:WēodmōnaþGerīmbōc	Predefinição:Calendário de agosto
Flocc:1239	Categoria:1239
Flocc:Gestorfen in 1307	Categoria:Mortos em 1307
Flocc:Corsica	Categoria:Córsega
Flocc:Gestorfen in 1715	Categoria:Mortos em 1715
Flocc:Australisce hēafodstōlas	Categoria:Capitais da Austrália
Flocc:Russisce bōccræft	Categoria:Literatura da Rússia
Flocc:Sardinia	Categoria:Sardenha
Bysen:Lang-hi	Predefinição:Lang-hi
Flocc:Florida	Categoria:Flórida
Flocc:Normandig	Categoria:Normandia
Bysen:Convert/And0	Predefinição:Convert/And0
Bysen:Coord/dec2dms/dm	Predefinição:Coord/dec2dms/dm
Flocc:Francena caseras	Categoria:Imperadores da França
Flocc:Nevada	Categoria:Nevada
Flocc:Nebraska	Categoria:Nebraska
Flocc:Norþ Dakota	Categoria:Dakota do Norte
Flocc:Nīwe Eoforwīc	Categoria:Estado de Nova Iorque
Flocc:Rhode Īeg	Categoria:Rhode Island
Flocc:Louisiāna	Categoria:Luisiana
Flocc:Marianland	Categoria:Maryland
Flocc:Maine	Categoria:Maine
Flocc:Minnesota	Categoria:Minnesota
Flocc:Michigan	Categoria:Michigan
Flocc:Mississippi	Categoria:Mississippi
Flocc:Missouri	Categoria:Missouri
Flocc:Vermont	Categoria:Vermont
Flocc:Virginia	Categoria:Virgínia
Flocc:Idaho	Categoria:Idaho
Flocc:Iowa	Categoria:Iowa
Flocc:Arkansas	Categoria:Arkansas
Flocc:Alaska	Categoria:Alasca
Flocc:Arizona	Categoria:Arizona
Flocc:Alabama	Categoria:Alabama
Flocc:Ohio	Categoria:Ohio
Flocc:Westvirginia	Categoria:Virgínia Ocidental
Flocc:Wisconsin	Categoria:Wisconsin
Flocc:Indiāna	Categoria:Indiana
Flocc:Illinois	Categoria:Illinois
Flocc:Kansas	Categoria:Kansas
Flocc:California	Categoria:Califórnia
Flocc:Kentucky	Categoria:Kentucky
Flocc:Connecticut	Categoria:Connecticut
Flocc:Colorado	Categoria:Colorado
Flocc:Texas	Categoria:Texas
Flocc:Hawaii	Categoria:Havaí
Bysen:Fs end	Predefinição:Football squad end
Bysen:Fs start	Predefinição:Football squad start
Bysen:WPMILHIST Infobox style	Predefinição:WPMILHIST Infobox style
Flocc:Ōðru Woruldgūþ	Categoria:Segunda Guerra Mundial
Flocc:Nīwes Sǣlandes byrig	Categoria:Cidades da Nova Zelândia
Bysen:Fossil range/marker	Predefinição:Período fóssil/marcador
Flocc:Hundas	Categoria:Cães
Flocc:OS X gamen	Categoria:Jogos para OS X
Flocc:Cattas	Categoria:Felídeos
Wikipǣdia:Gecorene gemynddagas/16 Solmōnaþ	Wikipédia:Efemérides/16 de fevereiro
Wikipǣdia:Gecorene gemynddagas/25 Wēodmōnaþ	Wikipédia:Efemérides/25 de agosto
Flocc:Russisce wrīteras	Categoria:Escritores da Rússia
Bysen:•	Predefinição:•
Flocc:1066	Categoria:1066
Flocc:Gestorfen in 1066	Categoria:Mortos em 1066
Bysen:WinterfylleþGerīmbōc	Predefinição:Calendário de outubro
Flocc:Angola	Categoria:Angola
Flocc:Botswana	Categoria:Botswana
Flocc:Elpendbānrima	Categoria:Costa do Marfim
Flocc:Æriþrea	Categoria:Eritreia
Flocc:Gabon	Categoria:Gabão
Flocc:Gambia	Categoria:Gâmbia
Flocc:Guinea	Categoria:Guiné
Flocc:Camerun	Categoria:Camarões
Flocc:Grēnenæs Īega	Categoria:Cabo Verde
Flocc:Cenia	Categoria:Quénia
Flocc:Liberia	Categoria:Libéria
Flocc:Libia	Categoria:Líbia
Flocc:Morocco	Categoria:Marrocos
Flocc:Mauritania	Categoria:Mauritânia
Flocc:1451	Categoria:1451
Flocc:Namibia	Categoria:Namíbia
Flocc:Delaware	Categoria:Delaware
Flocc:Georgia (America)	Categoria:Geórgia (Estados Unidos)
Flocc:Montāna	Categoria:Montana
Flocc:Eall gewritu þe hlȳtrunge þurfaþ	Categoria:!Páginas a reciclar
Bysen:Merge	Predefinição:Fusão
Flocc:Tennessee	Categoria:Tennessee
Bysen:Sūðamerica	Predefinição:Países da América do Sul
Flocc:Baden-Wyrttemberg	Categoria:Baden-Württemberg
Flocc:1852	Categoria:1852
Flocc:1892	Categoria:1892
Flocc:Gestorfen in 1926	Categoria:Mortos em 1926
Flocc:1973	Categoria:1973
Flocc:Gestorfen in 1973	Categoria:Mortos em 1973
Flocc:1975	Categoria:1975
Flocc:1981	Categoria:1981
Flocc:Gestorfen in 1982	Categoria:Mortos em 1982
Flocc:2004	Categoria:2004
Flocc:Gestorfen in 2004	Categoria:Mortos em 2004
Flocc:2005	Categoria:2005
Flocc:2006	Categoria:2006
Flocc:2007	Categoria:2007
Flocc:2008	Categoria:2008
Flocc:Ēa	Categoria:Rios
Bysen:Brūcend el-2	Predefinição:User el-2
Bysen:Brūcend fo-1	Predefinição:User fo-1
Bysen:Brūcend fo-3	Predefinição:User fo-3
Bysen:Brūcend la-2	Predefinição:User la-2
Bysen:Brūcend no-1	Predefinição:User no-1
Bysen:Brūcend pl-2	Predefinição:User pl-2
Bysen:Brūcend pt	Predefinição:User pt
Flocc:Sūþsudan	Categoria:Sudão do Sul
Flocc:Cead	Categoria:Chade
Flocc:Uganda	Categoria:Uganda
Flocc:Rōmānisce Cāseras	Categoria:Imperadores romanos
Flocc:Brūcend nl	Categoria:Usuários nl
Flocc:Sūþhjaltland	Categoria:Ilhas Shetland do Sul
Flocc:Brūcend no-1	Categoria:Usuário no-1
Flocc:Brūcend no-2	Categoria:Usuário no-2
Flocc:Brūcend no	Categoria:Usuários no
Flocc:Niðerlanda Cyningas	Categoria:Reis dos Países Baixos
Flocc:Norrena cyningas	Categoria:Reis da Noruega
Flocc:Swēona cyningas	Categoria:Reis da Suécia
Flocc:Armenia	Categoria:Arménia
Flocc:Bahrain	Categoria:Bahrein
Flocc:Mennisc bodiȝlār	Categoria:Anatomia humana
Flocc:Feorrsīen	Categoria:Televisão
Flocc:14e gēarhundred	Categoria:Século XIV
Flocc:13e gēarhundred	Categoria:Século XIII
Flocc:2e gēarhundred	Categoria:Século II
Flocc:4e gēarhundred	Categoria:Século IV
Flocc:5e gēarhundred	Categoria:Século V
Flocc:18e gēarhundred	Categoria:Século XVIII
Flocc:6e gēarhundred	Categoria:Século VI
Flocc:Nīwlicu Word	Categoria:Neologismos
Flocc:Nīwesǣlendisce wrīteras	Categoria:Escritores da Nova Zelândia
Flocc:Seaxland-Anhalt	Categoria:Saxônia-Anhalt
Flocc:Niðerseaxland	Categoria:Baixa Saxônia
Flocc:Russe	Categoria:Russos
Flocc:Unƿǣre lēode	Categoria:Personagens fictícias
Flocc:Crēcisc ūtwitan	Categoria:Filósofos da Grécia
Flocc:Sūþseaxe	Categoria:Sussex
Flocc:Bægwaraland	Categoria:Baviera
Flocc:Superman	Categoria:Superman
Flocc:Ēage	Categoria:Olho
Flocc:Corn	Categoria:Cereais
Flocc:Nīweoforwīcburg	Categoria:Nova Iorque
Flocc:Norþfolc	Categoria:Norfolk
Flocc:Norþhāmtūnescīr	Categoria:Northamptonshire
Flocc:NBC	Categoria:NBC
Flocc:Gamen	Categoria:Recreação
Flocc:Snotingahāmscīr	Categoria:Nottinghamshire
Flocc:15e gēarhundred	Categoria:Século XV
Flocc:Georgia (land)	Categoria:Geórgia
Flocc:Cambodia	Categoria:Camboja
Flocc:Americanisc sangeras	Categoria:Cantores dos Estados Unidos
Flocc:Bryttisce scopas	Categoria:Poetas do Reino Unido
Flocc:Stǣr þæs Cynerices Greatbryttenes	Categoria:História do Reino Unido
Flocc:Iamaica	Categoria:Jamaica
Bysen:Lang-hy	Predefinição:Lang-hy
Flocc:Scotta cyningas	Categoria:Reis da Escócia
Flocc:Bryttiscan Fæmne Īegland	Categoria:Ilhas Virgens Britânicas
Flocc:Corēa	Categoria:Coreia
Flocc:Burma	Categoria:Myanmar
Flocc:Taprabane	Categoria:Sri Lanka
Flocc:Tacgicastan	Categoria:Tajiquistão
Flocc:Ēasttimor	Categoria:Timor-Leste
Flocc:Turcmenistan	Categoria:Turquemenistão
Flocc:Usbecastan	Categoria:Uzbequistão
Flocc:Geānedan Arabiscan Bregorīce	Categoria:Emirados Árabes Unidos
Flocc:9e gēarhundred	Categoria:Século IX
Flocc:Sofiet Gesamnung	Categoria:União Soviética
Bysen:Bēc þǣre Ealdan Gecȳþnesse	Predefinição:Antigo Testamento
Flocc:Wēalas	Categoria:País de Gales
Flocc:Foresittendas þāra Geāndena Rīca American	Categoria:Presidentes dos Estados Unidos
Flocc:Europisc stǣr	Categoria:História da Europa
Flocc:Hascemisce Cynerīce þæs Iordanes	Categoria:Jordânia
Flocc:Bosnia and Herzegovina	Categoria:Bósnia e Herzegovina
Flocc:Norþweg	Categoria:Noruega
Flocc:Barbados	Categoria:Barbados
Flocc:Paraguay	Categoria:Paraguai
Flocc:Ficgiege	Categoria:Fiji
Flocc:Lēohtenstān	Categoria:Liechtenstein
Flocc:Uruguay	Categoria:Uruguai
Flocc:Andorra	Categoria:Andorra
Flocc:Serbia	Categoria:Sérvia
Flocc:Ecuador	Categoria:Equador
Flocc:Peru	Categoria:Peru
Flocc:Bolifia	Categoria:Bolívia
Flocc:Albania	Categoria:Albânia
Flocc:Monaco	Categoria:Mónaco
Flocc:Land on Norðamerican	Categoria:Países da América do Norte
Flocc:Fiscas	Categoria:Peixes
Flocc:Mūþ	Categoria:Boca
Flocc:Wyrta	Categoria:Hortaliças
Flocc:Ofet	Categoria:Frutos
Flocc:Nīwu Gecȳþnes	Categoria:Novo Testamento
Flocc:Musea	Categoria:Museus
Flocc:Rímcræft	Categoria:Funções matemáticas
Flocc:Landscipas Swēolandes	Categoria:Condados da Suécia
Flocc:Stǣrlice Sprǣccræft	Categoria:Linguística histórica
Flocc:Dūnholmscīr	Categoria:Durham (condado)
Flocc:Manga	Categoria:Mangá
Flocc:Eoferwicscīr	Categoria:Yorkshire
Flocc:Oferhæleðas	Categoria:Super-heróis
Flocc:Calpis	Categoria:Gibraltar
Flocc:Beadwe	Categoria:Batalhas
Flocc:Weorcendebyrdnessa	Categoria:Sistemas operativos
Flocc:Mexicorīce	Categoria:Estados do México
Flocc:Hidalgo Rīce	Categoria:Hidalgo
Flocc:Hetwaraland	Categoria:Hesse
Flocc:Canadan underrīce and landscipas	Categoria:Territórios do Canadá
Flocc:Lunden	Categoria:Londres
Flocc:Lincolnscīr	Categoria:Lincolnshire
Bysen:Incubator	Predefinição:Incubadora
Flocc:Dæg þæs gēares	Categoria:Dias do ano
Flocc:Wikimedian geweorc	Categoria:Wikimedia
Flocc:Byrig on Buccingahamscīre	Categoria:Cidades de Buckinghamshire
Flocc:Wiltūnscīr	Categoria:Wiltshire
Flocc:Wigreceastrescīr	Categoria:Worcestershire
Flocc:Haran	Categoria:Lepus
Flocc:Americanisce Ingefeoht	Categoria:Guerra Civil Americana
Flocc:Byrig on Tuscanie	Categoria:Comunas da Toscana
Flocc:Dēor	Categoria:Animais
Flocc:Hweorfdēor	Categoria:Vertebrados
Flocc:Pitcearnīega	Categoria:Pitcairn
Flocc:Cægman Īegland	Categoria:Ilhas Cayman
Flocc:Folcland Īegland	Categoria:Ilhas Malvinas
Flocc:Land on Sūðamerican	Categoria:Países da América do Sul
Flocc:Colombia	Categoria:Colômbia
Bysen:Contents pages (header bar)	Predefinição:Conteúdo-cabeçalho
Flocc:Anime	Categoria:Anime
Flocc:Oxnafordscīr	Categoria:Oxfordshire
Flocc:Hociȝ	Categoria:Hóquei
Flocc:Heortfordscīr	Categoria:Hertfordshire
Flocc:Sicilia	Categoria:Sicília
Flocc:Grantabrycgscīr	Categoria:Cambridgeshire
Flocc:Līþ	Categoria:Bebidas alcoólicas
Flocc:Spearctellas	Categoria:Consolas de jogos
Flocc:Englisc scīr	Categoria:Condados da Inglaterra
Flocc:Æþelingas	Categoria:Príncipes
Flocc:Ceasterscīr	Categoria:Cheshire
Flocc:Sūþrige	Categoria:Surrey
Flocc:Defenascīr	Categoria:Devon
Flocc:Se Hlāford þāra Hringa	Categoria:O Senhor dos Anéis
Flocc:Rōmāniscu Folclār	Categoria:Mitologia romana
Flocc:Beadanfordscīr	Categoria:Bedfordshire
Flocc:Bēor	Categoria:Cerveja
Flocc:Sang	Categoria:Canções
Flocc:Eormengyld byrig	Categoria:Cidades universitárias
Flocc:Hēafodstōlas	Categoria:Capitais
Flocc:Byrig on Paraguay	Categoria:Localidades do Paraguai
Flocc:Stōwlice hēafodstōlas Canadan	Categoria:Cidades do Canadá
Flocc:Ēastseaxe	Categoria:Essex
Flocc:Middelasia	Categoria:Ásia Central
Flocc:NFL	Categoria:National Football League
Flocc:Tuscania	Categoria:Toscana
Flocc:Latium	Categoria:Lácio
Flocc:Lonceasterscīr	Categoria:Lancashire
Flocc:Hāmtūnescīr	Categoria:Hampshire
Flocc:Brūcend pl	Categoria:Usuários pl
Flocc:Gleawcesterscīr	Categoria:Gloucestershire
Flocc:Rōmānisca sprǣca	Categoria:Línguas românicas
Flocc:Fōr	Categoria:Transporte
Flocc:Sund	Categoria:Natação
Flocc:Hēapplegan	Categoria:Desportos coletivos
Flocc:Toys	Categoria:Brinquedos
Flocc:Hīwscipe	Categoria:Família
Flocc:Cornweall	Categoria:Cornualha
Flocc:Cīna Caseras	Categoria:Imperadores da China
Flocc:Antarctica	Categoria:Antártida
Flocc:Norðamerica	Categoria:América do Norte
Flocc:Sangestre	Categoria:Cantores
Flocc:Euxinus	Categoria:Mar Negro
Flocc:Meras	Categoria:Lagos
Bysen:Flagcountry	Predefinição:Flagcountry
Bysen:Country data Weimar Republic	Predefinição:Country data República de Weimar
Flocc:Sweartbeorg	Categoria:Montenegro
Flocc:Indisc Gārsecg	Categoria:Oceano Índico
Flocc:Wægnas	Categoria:Automóveis
Bysen:Brūcend af-2	Predefinição:User af-2
Wealhmoru	Cenoura
Flocc:Cent	Categoria:Kent
Flocc:Byrig on Fietname	Categoria:Cidades do Vietname
Flocc:Byrig on þǣm Ucrægnan	Categoria:Cidades da Ucrânia
Flocc:Byrig on Eotolwarum	Categoria:Cidades da Itália
Flocc:Beorgas on Brettum	Categoria:Picos do Reino Unido
Flocc:Scotland	Categoria:Escócia
Flocc:Spēonisc bōccræft	Categoria:Literatura da Espanha
Flocc:Hēafodstōlas in Europe	Categoria:Capitais da Europa
Flocc:Hēafodstōlas in Asie	Categoria:Capitais da Ásia
Flocc:Norðerne Īrland	Categoria:Irlanda do Norte
Flocc:Nīwesǣlendisc bōccræft	Categoria:Literatura da Nova Zelândia
Flocc:Īrisc bōccræft	Categoria:Literatura da Irlanda
Bysen:CompactTOC	Predefinição:Peqind
Flocc:Geāsparedu līc	Categoria:Múmias
Flocc:Wendelsǣ	Categoria:Mediterrâneo
Bysen:Dmbox	Predefinição:Dmbox
Flocc:Wikipedia tutorial	Categoria:!Tutorial
Bysen:Wikia	Predefinição:Wikia
Flocc:World Trade Center	Categoria:World Trade Center
Flocc:Loidis	Categoria:Leeds
Flocc:Australisc Hēafodburg Landscipe	Categoria:Território da Capital da Austrália
Bysen:Country data Cænada	Predefinição:Country data Canadá
Bysen:Color box	Predefinição:Caixa cor
Bysen:Coord/dec2dms	Predefinição:Coord/dec2dms
Bysen:Coord/dec2dms/dms	Predefinição:Coord/dec2dms/dms
Bysen:Coord/prec dec	Predefinição:Coord/prec dec
Flocc:Cyþþubox	Categoria:!Predefinições de caixas de navegação laterais
Bysen:Flag	Predefinição:Flag
Bysen:Country data Barbados	Predefinição:Country data Barbados
Bysen:Country data Empire of Japan	Predefinição:Country data Império do Japão
Bysen:Country data Free French	Predefinição:Country data Forças Francesas Livres
Bysen:Country data Martinique	Predefinição:Country data Martinica
Bysen:Country data Åland Islands	Predefinição:Country data Ilhas Åland
Bysen:Lang-pl	Predefinição:Lang-pl
Bysen:Brūcend pl-3	Predefinição:User pl-3
Flocc:Flæmingaland	Categoria:Flandres
The Narrative	The Narrative
Flocc:Byrig on Difelinscīre	Categoria:Cidades do Condado de Dublin
Flocc:Miercna cyningas	Categoria:Reis da Mércia
Flocc:Norþhymbra cyningas	Categoria:Reis da Nortúmbria
Flocc:Westseaxna cyningas	Categoria:Reis de Wessex
Trojany (Masovian Voivodship)	Trojany
Flocc:Willelm Shakespeare	Categoria:William Shakespeare
Flocc:Byrig þāra Faroiscan Īegena	Categoria:Cidades das Ilhas Faroés
Flocc:Sigelhearwena Cāseras	Categoria:Imperadores da Etiópia
Flocc:Land on Asie	Categoria:Países da Ásia
Bysen:Fapages	Predefinição:PáginasAD
Flocc:Windows gamen	Categoria:Jogos para Windows
Bysen:Landskap	Predefinição:Províncias históricas da Suécia
Bysen:Plegere-stycce	Predefinição:Esboço-ator-cinema
Bysen:Nigerie Rīce	Predefinição:Nigéria/estados
Bysen:Brūcend la	Predefinição:User la
Bysen:Brūcend is-3	Predefinição:User is-3
Bysen:Brūcend fo-2	Predefinição:User fo-2
Bysen:Brūcend fo	Predefinição:User fo
Bysen:Brūcend el-3	Predefinição:User el-3
Bysen:Brūcend cy-3	Predefinição:User cy-3
Bysen:Brūcend cy-2	Predefinição:User cy-2
Bysen:Brūcend cy-1	Predefinição:User cy-1
Bysen:Brūcend cy	Predefinição:User cy
Bysen:Lang-sq	Predefinição:Lang-sq
Bysen:Lang-ro	Predefinição:Lang-ro
Bysen:Lang-kl	Predefinição:Lang-kl
Bysen:IPAc-en	Predefinição:IPAc-en
Bysen:Lang-es	Predefinição:Lang-es
Bysen:Lang-cy	Predefinição:Lang-cy
Bysen:Lang-bn	Predefinição:Lang-bn
Bysen:ĒastermōnaþGerīmbōc	Predefinição:Calendário de abril
Bysen:SēremōnaþGerīmbōc	Predefinição:Calendário de junho
Bysen:HrēþmōnaþGerīmbōc	Predefinição:Calendário de março
Flocc:Westmidlandscīr	Categoria:Midlands Ocidentais (condado)
Bysen:StarCraft endebyrdnes	Predefinição:StarCraft
Bysen:Country data Ryūkyū Kingdom	Predefinição:Country data Reino de Ryūkyū
Flocc:Wæringscīr	Categoria:Warwickshire
Flocc:Wīcinga Ieldu	Categoria:Era Viking
Flocc:Seolh	Categoria:Pinnipedia
Flocc:Engla cyningas	Categoria:Reis anglo-saxões
Flocc:Quebec	Categoria:Quebec
Flocc:Bryttisce ofersǣ landscipas	Categoria:Territórios britânicos ultramarinos
Flocc:Ostsǣ	Categoria:Mar Báltico
Flocc:Bysen Brūcend Box	Categoria:!Userboxes
Flocc:Dēaþstīele glīwdrēame clīwene	Categoria:Bandas de death metal
Flocc:Gūþ	Categoria:Guerra
Flocc:Ēastgermanisca sprǣca	Categoria:Línguas germânicas orientais
Flocc:Elisabeþ II	Categoria:Isabel II do Reino Unido
Flocc:Fif Scīr	Categoria:Fife
Flocc:Lēoðlic scātung	Categoria:Patinação artística no gelo
Bysen:Lang-zh	Predefinição:Lang-zh
Bysen:Lang-mn	Predefinição:Lang-mn
Bysen:Lang-fi	Predefinição:Lang-fi
Bysen:Lang-sv	Predefinição:Lang-sv
Flocc:Frencisc Polynesia	Categoria:Polinésia Francesa
Flocc:Germanisca sprǣca	Categoria:Línguas germânicas
Bysen:Precision1	Predefinição:Precision1
Bysen:Precision/tz	Predefinição:Precision/tz
Bysen:Precision/tz/1	Predefinição:Precision/tz/1
Flocc:Hāmtūnscīr Scīr, West Virginia	Categoria:Condado de Hampshire (Virgínia Ocidental)
Flocc:Herefordscīr	Categoria:Herefordshire
Flocc:Īshocig	Categoria:Hóquei no gelo
Wikipǣdia:Edit conflicts	Wikipédia:Conflito de edição
Flocc:Īrland	Categoria:Irlanda
Flocc:Constantinopolis	Categoria:Istambul
Wikipǣdia:Page history	Ajuda:Guia de edição/Menus e ferramentas/Histórico
Flocc:Kwara Rīce	Categoria:Kwara (estado)
Flocc:Mintan	Categoria:Lamiaceae
Flocc:Bysen Sprǣc	Categoria:!Predefinições de lang
Flocc:Lægreceastrescīr	Categoria:Leicestershire
Flocc:Langbeardnaland	Categoria:Lombardia
Wikipǣdia:Snellbred	Ajuda:Referência rápida
Wikipǣdia:Show preview	Ajuda:Guia de edição/Menus e ferramentas/Mostrar previsão
Flocc:Rōm	Categoria:Roma
Flocc:Norþhymbraland	Categoria:Northumberland
Flocc:Rūncræft	Categoria:Runas
Flocc:Sancte Elene Īeg, Upstigeīeg and Tristan da Cunha	Categoria:Santa Helena, Ascensão e Tristão da Cunha
Flocc:Hjaltland	Categoria:Ilhas Shetland
Flocc:Scipu	Categoria:Navios
Flocc:Scrobbesbyrigscīr	Categoria:Shropshire
Flocc:Byrig on Gleawcesterscīre	Categoria:Cidades de Gloucestershire
Flocc:Napoleon I Francena Casere	Categoria:Napoleão
Flocc:NHL	Categoria:NHL
Flocc:Byrig on Nīwum Hāmtūnscīre	Categoria:Cidades de Nova Hampshire
Flocc:Byrig on Dūnholmscīre	Categoria:Cidades de Durham (condado)
Flocc:Byrig on Dēorabyscīre	Categoria:Cidades de Derbyshire
Flocc:Byrig on Defenum	Categoria:Cidades de Devon
Flocc:Byrig on Lonceasterscīre	Categoria:Cidades de Lancashire
Flocc:Americanisc fōtball	Categoria:Futebol americano
Flocc:Stæffordscīr	Categoria:Staffordshire
Flocc:Bermuda	Categoria:Bermudas
Flocc:Bearrucscīr	Categoria:Berkshire
Flocc:Byrig on Bearrucscīre	Categoria:Cidades de Berkshire
Flocc:Norþgermanisca sprǣca	Categoria:Línguas nórdicas
Flocc:São Paulo	Categoria:São Paulo (cidade)
Flocc:Ucrægnisc sprǣc	Categoria:Língua ucraniana
Flocc:Westgermanisca sprǣca	Categoria:Línguas germânicas ocidentais
Flocc:Byrig on Sūþrigum	Categoria:Cidades de Surrey
Flocc:Byrig on Grantabrycgscīre	Categoria:Cidades de Cambridgeshire
Flocc:Byrig on Cornweallum	Categoria:Cidades da Cornualha
Flocc:Byrig on Cent	Categoria:Cidades de Kent
Flocc:Byrig on Oxnafordscīre	Categoria:Cidades de Oxfordshire
Flocc:Byrig on Westmidlandscīre	Categoria:Cidades de Midlands Ocidentais (condado)
Flocc:Dȳfung	Categoria:Mergulho
Flocc:Byrig on Scrobbesbyrigscīre	Categoria:Cidades de Shropshire
Flocc:Byrig on Stæffordscīre	Categoria:Cidades de Staffordshire
Flocc:Byrig on Wigreceastrescīre	Categoria:Cidades de Worcestershire
Flocc:Byrig on Wæringscīre	Categoria:Cidades de Warwickshire
Flocc:Wichlawscīr	Categoria:Condado de Wicklow
Flocc:Byrig on Wiltūnscīre	Categoria:Cidades do Wiltshire
Flocc:Nīwre Gecȳþnesse bōc	Categoria:Livros do Novo Testamento
Flocc:Antrimscīr	Categoria:Condado de Antrim (Irlanda do Norte)
Flocc:Mageoscīr	Categoria:Condado de Mayo
Flocc:Celtisc sprǣc	Categoria:Línguas célticas
Flocc:Coritiba Foot Ball Club	Categoria:Coritiba Foot Ball Club
Flocc:Bryttisce Scīre	Categoria:Condados do Reino Unido
Flocc:Landscipas Denemearce	Categoria:Penínsulas da Dinamarca
Flocc:Wendelsǣs īega	Categoria:Ilhas do Mediterrâneo
Flocc:Byrig on Ēastseaxum	Categoria:Cidades do East Sussex
Flocc:Tūnas on Mageoscīre	Categoria:Cidades do Condado de Mayo
Flocc:Gyldfōtþōðres styccelicu gewritu	Categoria:!Esboços sobre futebol
Flocc:Byrig	Categoria:Cidades
Flocc:Brūcend fo-3	Categoria:Usuário fo-3
Flocc:Lēode ȝehered in Ƿælhealle Heriȝe	Categoria:Templo de Walhalla
Flocc:Bretta Æþelingas	Categoria:Príncipes do Reino Unido
Bárbara Paz	Bárbara Paz
Wikipǣdia:Tutorial (External links)	Ajuda:Tutorial/Referência
Flocc:Personal life	Categoria:Vida pessoal
Flocc:Byrig on Brettum	Categoria:Cidades do Reino Unido
Bysen:Coord/display/title	Predefinição:Coord/display/title
Bysen:Year in other calendars	Predefinição:Outros calendários
Bysen:Ombox/core	Predefinição:Ombox/core
Flocc:Brūcend en-1	Categoria:Usuário en-1
Flocc:Geboren in 1946	Categoria:Nascidos em 1946
Flocc:Brūcend de-1	Categoria:Usuário de-1
Flocc:Geboren in 1920	Categoria:Nascidos em 1920
Flocc:Byrig on Spēnum	Categoria:Vilas da Espanha
Flocc:Skrælingcynn	Categoria:Ameríndios
Hunna Rīce	Império Huno
Universidade Fundação Mineira de Educação e Cultura	Universidade Fundação Mineira de Educação e Cultura
Bysen:Virginia	Predefinição:Virgínia
Bysen:Bo	Predefinição:Bo
Bysen:Kylie Minogue	Predefinição:Kylie Minogue
Bysen:Mennisc bodiglārlicu ansīen	Predefinição:Características anatômicas humanas
Bysen:GēolmōnaþGerīmbōc	Predefinição:Calendário de dezembro
Bysen:MǣdmōnaþGerīmbōc	Predefinição:Calendário de julho
Wikipǣdia:Tutorial (Talk pages)	Ajuda:Tutorial/Discussão
Wikipǣdia:Tutorial (Related site links)	Ajuda:Tutorial/A reter
Bysen:Start date	Predefinição:Data de início
Bysen:Portas	Predefinição:Portais1
Wikipǣdia:Inlǽdung 3	Wikipédia:Introdução/3
Bysen:WPS Labelled Map	Predefinição:WPS Mapa 2009
Bysen:FPO number	Predefinição:Número de portais destacados
Wikipǣdia:10 þing þe þu nāst ymbe Wicipǣdian	Wikipédia:Dez coisas que talvez você não sabia sobre a Wikipédia
Bysen:SGSSI	Predefinição:Ilhas Geórgia do Sul e Sandwich do Sul
Bleohcrāwe	Gralha
Bysen:Italy-hist-stub	Predefinição:Esboço-históriait
Bysen:Lang-kw	Predefinição:Lang-kw
Bysen:Infobox/row	Predefinição:Infobox/row
Wikipǣdia:Tutorial (Wrap-up and more info)	Ajuda:Tutorial/Sumário
Wikipǣdia:Tutorial (Registration)	Ajuda:Tutorial/Registo
Wikipǣdia:Lārcwide/TabsHeader	Ajuda:Tutorial/AbasCabeçalho
Wikipǣdia:Templates	Wikipédia:Predefinições
Wikipǣdia:Deletion log	Wikipédia:Deletion log
Bysen:End	Predefinição:Fim
Bysen:Syndrigebocstafas	Predefinição:Caracteres especiais
Bysen:Xpda	Predefinição:Xpda
Bysen:Country flagairforce	Predefinição:Força aérea/core
Bysen:Image label verysmall	Predefinição:Image label verysmall
Lorde	Lorde (cantora)
Georgius Grantanbrycge Æþeling	Jorge de Cambridge
Portal:Box-header/1	Portal:Box-header/1
Portal:Contents/Types TOC	Portal:Conteúdo/Tipos TOC
Wikipǣdia:Lārcwide/Tabs	Ajuda:Tutorial/Abas
Wikipǣdia:Lārcwide/Tab1	Wikipédia:Tutorial/Aba1
Wikipǣdia:Lārcwide/Tab2	Ajuda:Tutorial/Aba2
Wikipǣdia:Lārcwide/TabsBottom	Ajuda:Tutorial/AbasFundo
Module:Yesno	Módulo:Yesno
Module:Category handler	Módulo:Category handler
Yun Hyon-seok	Yun Hyon-seok
Module:Arguments	Módulo:Arguments
Syndrig:RecentChanges	Especial:Mudanças recentes
Flocc:Byrig on Langbeardum	Categoria:Comunas da Lombardia
Module:Namespace detect	Módulo:Namespace detect
Flocc:Gestorfen in 1975	Categoria:Mortos em 1975
Module:Namespace detect/data	Módulo:Namespace detect/data
Module:Namespace detect/config	Módulo:Namespace detect/config
Gōs	Ganso
