ܐܦܪܝܩܐ	África
ܝܦܢ	Japão
ܐܡܪܝܩܐ ܬܝܡܢܝܬܐ	América do Sul
ܢܘܪܒܝܓ	Noruega
ܩܘܛܢܝܘܬܐ ܕܐܝܪܠܢܕ	República da Irlanda
ܡܓܪ	Hungria
ܐܣܦܢܝܐ	Espanha
ܐܘܚܕܢܐ ܡܚܝܕܐ	Estados Unidos
ܒܠܓܝܩܐ	Bélgica
ܠܘܟܣܡܒܘܪܓ	Luxemburgo
ܬܒܝܠ	Universo
ܐܪܥܐ	Terra
ܡܘܬܐ	Morte
ܒܪ ܐܢܫܐ	Homo sapiens
ܓܘܪܓ ܘܐܫܝܢܓܛܘܢ	George Washington
ܦܝܢܠܢܕ	Finlândia
ܣܘܝܕ	Suécia
ܕܐܢܡܐܪܩ	Dinamarca
ܦܘܠܢܕ	Polónia
ܠܬܘܢܝܐ	Lituânia
ܐܝܛܠܝܐ	Itália
ܣܘܝܣܪܐ	Suíça
ܢܡܣܐ	Áustria
ܝܘܢ	Grécia
ܛܘܪܩܝܐ	Turquia
ܦܘܪܛܘܓܠ	Portugal
ܐܘܪܘܦܐ (ܝܒܫܬܐ)	Europa
ܐܣܝܐ (ܝܒܫܬܐ)	Ásia
ܐܡܪܝܩܐ ܓܪܒܝܝܬܐ	América do Norte
ܐܢܛܐܪܩܛܝܩܐ	Antártida
ܘܝܩܝܦܕܝܐ	Wikipédia
ܗܘܠܢܕܐ	Países Baixos
ܢܝܘ ܝܘܪܩ (ܡܕܝܢܬܐ)	Nova Iorque
ܘܐܫܢܓܛܘܢ (ܐܪܫܟܝܬܐ)	Washington, D.C.
ܒܪܠܝܢ	Berlim
ܚܫܘܒܐ (ܡܐܟܢܐ)	Computador
ܒܪܢ	Berna
ܬܣܝܪܝܟ	Zurique
ܐܢܛܪܢܛ	Internet
ܒܪܐܩ ܐܘܒܐܡܐ	Barack Obama
ܠܘܢܕܘܢ	Londres
ܐܠܟܣܢܕܪܝܐ	Alexandria
ܚܙܘܪܐ	Maçã
ܦܐܪܝܣ	Paris
ܡܟܣܝܩܘ	México
ܐܘܩܝܢܘܣ ܐܛܠܢܛܝܐ	Oceano Atlântico
ܐܘܩܝܢܘܣ ܫܝܢܝܐ	Oceano Pacífico
ܒܘܣܛܘܢ	Boston
ܬܪܝܢܒܫܒܐ	Segunda-feira
ܟܢܘܢ ܒ	Janeiro
ܫܒܛ	Fevereiro
ܐܕܪ	Março
ܟܘܫ	Etiópia
ܢܝܣܢ	Abril
ܐܝܪ	Maio
ܚܙܝܪܢ	Junho
ܬܡܘܙ	Julho
ܐܒ	Agosto
ܐܝܠܘܠ	Setembro
ܬܫܪܝܢ ܐ	Outubro
ܬܫܪܝܢ ܒ	Novembro
ܟܢܘܢ ܐ	Dezembro
ܬܠܬܒܫܒܐ	Terça-feira
ܐܪܒܥܒܫܒܐ	Quarta-feira
ܚܡܫܒܫܒܐ	Quinta-feira
ܥܪܘܒܬܐ	Sexta-feira
ܫܒܬܐ (ܙܒܢܐ)	Sábado
ܚܕܒܫܒܐ	Domingo
ܐܪܝܐ	Leão
ܦܪܢܣܐ	França
ܟܠܒܐ	Canis lupus familiaris
ܡܠܟܘܬܐ ܡܚܝܕܬܐ	Reino Unido
ܩܛܐ	Gato
ܩܘܛܢܝܘܬܐ ܥܡܡܝܬܐ ܕܨܝܢ	República Popular da China
ܠܫܢܐ ܦܪܢܣܝܐ	Língua francesa
ܒܪܐܙܝܠ	Brasil
ܪܘܣܝܐ	Rússia
ܝܡܐ	Mar
ܝܡܐ ܐܘܟܡܐ	Mar Negro
Π	Π
ܐܠܒܐܡܐ	Alabama
ܣܐܘ ܦܐܘܠܘ	São Paulo (cidade)
ܩܝܒܩ (ܗܘܦܪܟܝܐ)	Quebec
ܓܪܡܢ	Alemanha
ܒܠܐܪܘܣ	Bielorrússia
ܠܫܢܐ ܓܪܡܢܝܐ	Língua alemã
ܐܠܗܐ	Deus
ܐܣܛܘܢܝܐ	Estónia
ܛܝܣܬܐ	Avião
ܩܪܒܐ	Guerra
1 (ܡܢܝܢܐ)	Um
2 (ܡܢܝܢܐ)	Dois
3 (ܡܢܝܢܐ)	Três
4 (ܡܢܝܢܐ)	Quatro
5 (ܡܢܝܢܐ)	Cinco
ܠܐܛܒܝܐ	Letónia
ܐܘܩܪܐܝܢܐ	Ucrânia
ܬܫܝܟ	República Checa
ܣܠܘܒܩܝܐ	Eslováquia
ܣܠܘܒܢܝܐ	Eslovénia
ܡܘܠܕܘܒܐ	Moldávia
ܪܘܡܢܝܐ	Roménia
ܒܘܠܓܐܪܝܐ	Bulgária
ܪܗܘܡܐ (ܡܕܝܢܬܐ)	Roma
ܩܘܛܢܝܘܬܐ ܕܡܩܕܘܢܝܐ	República da Macedónia
ܐܠܒܢܝܐ	Albânia
ܩܪܘܐܛܝܐ	Croácia
ܒܘܣܢܐ ܘܗܪܬܣܓܘܒܝܢܐ	Bósnia e Herzegovina
ܐܙܪܒܝܓܐܢ	Azerbaijão
ܐܢܕܘܪܐ	Andorra
ܩܘܦܪܘܣ	Chipre
ܓܘܪܓܝܐ (ܐܬܪܐ)	Geórgia
ܩܙܩܣܛܐܢ	Cazaquistão
ܡܝܠܛܐ	Malta
ܡܘܢܐܩܘ	Mónaco
ܛܘܪܐ ܐܘܟܡܐ	Montenegro
ܡܕܝܢܬܐ ܕܘܛܝܩܢ	Vaticano
ܣܢ ܡܪܝܢܘ	San Marino
ܒܪܘܟܣܠ	Bruxelas
ܠܘܕܒܝܓ ܒܐܢ ܒܝܛܗܘܒܢ	Ludwig van Beethoven
ܠܫܢܐ ܛܘܪܩܝܐ	Língua turca
ܓܙܐܐܪ	Argélia
ܐܘܙܒܩܣܛܐܢ	Uzbequistão
ܘܐܪܣܘ	Varsóvia
ܚܡܪܐ (ܫܬܝܐ)	Vinho
ܡܝܐ	Água
ܦܪܣ ܚܙܘܐ	Televisão
ܬܫܝܠܝ	Chile
ܐܠ ܓܪܝܩܘ	El Greco
ܝܫܘܥ	Jesus
ܠܫܢܐ (ܡܡܠܠܐ)	Linguagem
ܫܘܠܛܢ ܛܪܘܢܘܬܐ	Ditadura
ܡܡܠܠܘܬ ܟܘܟܒܐ	Astronomia
ܡܪܝܡ (ܐܡܗ ܕܝܫܘܥ)	Maria (mãe de Jesus)
ܠܝܟܛܢܫܛܝܢ	Liechtenstein
ܐܕܘܠܦ ܗܝܛܠܪ	Adolf Hitler
ܠܝܢܘܟܣ	Linux
ܠܫܢܐ ܠܐܛܝܢܝܐ	Língua latina
ܒܚܪܝܢ	Bahrein
ܐܪܡܢܝܐ	Arménia
ܣܪܒܝܐ	Sérvia
ܣܗܪܐ	Lua
ܐܝܣܛܢܒܘܠ (ܡܕܝܢܬܐ)	Istambul
ܐܘܣܛܪܠܝܐ (ܐܬܪܐ)	Austrália
ܦܝܣܝܟ	Física
ܩܘܪܐܢ	Alcorão
ܐܣܠܐܡ	Islão
ܟܡܬܪܐ	Pera
ܠܟ ܒܐܘܢܣܐ	Lech Wałęsa
ܫܠܡܐ (ܫܝܢܐ)	Paz
ܚܘܝܕܐ ܐܘܪܘܦܝܐ	União Europeia
ܐܢܬܬܐ	Mulher
ܛܝܙܐ	Ânus
ܫܚܬܐ (ܝܘܠܦܢ ܨܪܘܝܘܬܐ)	Axila
ܗܒܒܐ	Flor
ܝܘܠܦܢ ܨܪܘܝܘܬܐ	Anatomia
ܡܕܝܢܬܐ	Cidade
ܢܐܦܠܝܘܢ ܒܘܢܐܦܪܛ	Napoleão Bonaparte
ܟܘܟܒܐ	Estrela
ܫܡܫܐ	Sol
ܩܪܝܬܐ	Aldeia
ܝܡܐ ܕܡܕܢܚܐ	Mar Báltico
ܫܢܐ	Dente
ܘܝܩܝܡܝܕܝܐ ܩܘܡܡܘܢܣ	Wikimedia Commons
ܟܬܒܐ (ܣܦܪܐ)	Livro
ܝܘܡܐ	Dia
ܠܠܝܐ	Noite
ܫܢܬܐ (ܙܒܢܐ)	Ano
ܕܪܐ	Século
ܐܘܣܠܘ	Oslo
ܠܫܒܘܢܐ	Lisboa
ܦܠܝܛܐ	Planeta
ܙܡܪܘܬܐ	Música
ܡܘܣܩܒܐ	Moscovo
ܠܫܢܐ ܐܝܛܠܝܐ	Língua italiana
ܬܫܐܕ	Chade
ܬܝܡܢܐ	Norte
ܢܝܘ ܙܝܠܢܕ	Nova Zelândia
ܓܪܒܝܐ	Sul
ܗܢܕܘ	Índia
ܦܪܙܠܐ	Ferro
ܡܥܪܒܐ	Oeste
ܡܕܢܚܐ	Leste
ܒܢܙܘܝܠܐ	Venezuela
ܛܠܦܣܢܐ	Xadrez
ܡܝܢ	Maine
ܣܘܣܝܐ	Equus ferus caballus
ܐܡܣܛܪܕܐܡ	Amesterdão
ܙܝܢܐ	Arma
ܚܝܘܬܐ	Animalia
ܩܘܠܘܡܒܝܐ	Colômbia
ܢܝܘ ܗܐܡܦܫܪ	Nova Hampshire
ܠܝܘܢܪܕܘ ܕܗ ܒܢܬܫܝ	Leonardo da Vinci
ܡܐܣܐܬܫܘܣܬܣ	Massachusetts
ܐܘܛܪܝܟܛ (ܗܘܦܪܟܝܐ)	Utrecht (província)
ܟܘܢܝܬܝܟܬ	Connecticut
ܐܝܪܐܢ	Irão
ܥܝܪܐܩ	Iraque
ܐܠܐܣܟܐ	Alasca
ܐܝܣܪܐܝܠ	Israel
ܐܘܛܪܝܟܛ (ܡܕܝܢܬܐ)	Utrecht
ܝܡܢ	Iémen
ܠܫܢܐ ܦܘܠܢܕܝܐ	Língua polaca
ܝܘܪܕܢܢ	Jordânia
ܩܝܪܓܝܙܣܛܐܢ	Quirguistão
ܐܪܝܙܘܢܐ	Arizona
ܟܘܘܝܬ (ܐܬܪܐ)	Kuwait
ܠܒܢܢ	Líbano
ܐܘܪܝܓܘܢ	Oregon
ܐܡܪܝܩܐ	América
ܝܘܬܐ	Utah
ܥܘܡܐܢ	Omã
ܦܐܩܣܛܐܢ	Paquistão
ܩܛܪ	Catar
ܣܥܘܕܝܐ	Arábia Saudita
ܝܘܣܦ ܣܛܐܠܝܢ	Josef Stalin
ܣܘܪܝܐ	Síria
ܛܐܓܝܩܣܛܐܢ	Tajiquistão
ܦܪܣ ܩܠܐ	Rádio (telecomunicações)
ܛܘܪܩܡܢܣܛܐܢ	Turquemenistão
ܐܡܝܪܘܬܐ ܥܪܒܝܬܐ ܡܚܝܕܬܐ	Emirados Árabes Unidos
ܐܦܓܐܢܣܛܐܢ	Afeganistão
ܕܗܒܐ	Ouro
ܡܠܝ	Mali
ܦܝܠܝܦܝܢܝܐ	Filipinas
ܩܘܛܢܝܘܬܐ ܕܐܦܪܝܩܐ ܡܨܥܝܬܐ	República Centro-Africana
ܐܝܣܚܩ ܢܝܘܛܢ	Isaac Newton
ܫܥܘܬܐ (ܓܘܢܐ)	Amarelo
ܬܘܢܣ (ܐܬܪܐ)	Tunísia
ܬܝܡܢܐ ܕܣܘܕܐܢ	Sudão do Sul
ܩܘܛܢܝܘܬܐ ܕܩܘܢܓܘ	República do Congo
ܩܘܛܢܝܘܬܐ ܕܩܘܢܓܘ ܕܝܡܘܩܪܛܝܬܐ	República Democrática do Congo
ܦܐܦܐ ܝܘܚܢܢ ܦܘܠܘܣ ܬܪܝܢܐ	Papa João Paulo II
ܛܒܝܠܝܣܝ	Tbilisi
ܩܐܡܪܘܢ	Camarões
ܠܘܒܐ	Líbia
ܡܘܪܝܛܢܝܐ	Mauritânia
ܡܓܪܒ	Marrocos
ܢܝܓܪ	Níger
ܣܘܕܐܢ	Sudão
ܩܫܬܐ ܕܡܪܢ	Arco-íris
ܗܐܡܒܘܪܓ	Hamburgo
ܝܡܬܐ ܕܐܘܢܛܪܝܘ	Lago Ontário
ܝܡܬܐ ܕܣܘܦܝܪܝܘܪ	Lago Superior
ܓܐܘܓܪܦܝܐ	Geografia
ܠܒܐ	Coração
ܡܘܚܐ	Cérebro
ܓܠܕܐ	Pele
ܓܘܢܐ	Cor
ܦܪܐܓ	Praga
ܙܪܩܐ	Azul
ܟܣܦܐ (ܣܐܡܐ)	Prata
ܡܫܝܓܢ	Michigan
ܝܡܬܐ ܕܡܝܫܝܓܢ	Lago Michigan
ܐܠܝܢܘܝ	Illinois
ܢܘܪܬ ܕܐܟܘܬܐ	Dakota do Norte
ܣܐܘܬ ܕܐܟܘܬܐ	Dakota do Sul
ܡܘܢܬܐܢܐ	Montana
ܘܐܝܘܡܝܢܓ	Wyoming
ܐܘܪܫܠܡ	Jerusalém
ܐܝܕܐܗܘ	Idaho
ܢܝܒܐܕܐ	Nevada
ܐܘܩܝܢܘܣ ܗܢܕܘܝܐ	Oceano Índico
ܟܘܠܘܪܐܕܘ	Colorado
ܫܝܩܓܘ	Chicago
ܣܬܘܐ	Inverno
ܬܕܐܐ	Primavera
ܩܝܛܐ	Verão
ܬܫܪܝܬܐ	Outono
ܨܕܐܡ ܚܘܣܝܢ	Saddam Hussein
ܠܫܢܐ ܐܣܦܢܝܐ	Língua castelhana
ܓܘܓܝ	Aranha
ܐܒܐ (ܦܐܪܐ)	Fruto
ܩܘܦܐ	Macaco
ܒܪܓܝܢܝܐ	Virgínia
ܝܡܬܐ ܕܝܘܪܘܢ	Lago Huron
ܢܝܘ ܝܘܪܩ (ܐܘܚܕܢܐ ܡܚܝܕܐ)	Nova Iorque (estado)
ܪܘܕ ܐܝܠܐܢܕ	Rhode Island
ܪܚܫܐ	Insetos
ܡܐܪܝܠܐܢܕ	Maryland
ܕܝܠܐܘܝܪ	Delaware
ܐܘܗܐܝܘ	Ohio
ܦܢܣܝܠܒܐܢܝܐ	Pensilvânia
ܐܝܛܙܢ	Uetersen
ܐܓܘܣܛܘܣ ܩܣܪ	Augusto
ܢܝܘ ܓܝܪܣܝ	Nova Jérsia
ܐܢܕܝܐܢܐ	Indiana
ܪܕܝܬܐ	Automóvel
ܓܘܪܓܝܐ (ܐܘܚܕܢܐ ܡܚܝܕܐ)	Geórgia (Estados Unidos)
ܣܩܠܝܐ	Sicília
ܣܢ (ܢܗܪܐ)	Sena
ܛܘܩܝܘ	Tóquio
ܦܪܕܝܢܢܕ ܡܓܝܠܢ	Fernão de Magalhães
ܢܝܘ ܡܝܟܣܝܟܘ	Novo México
ܐܬܢܘܣ	Atenas
ܡܢܝܣܘܬܐ	Minnesota
ܒܓܕܐܕ (ܡܕܝܢܬܐ)	Bagdá
ܘܝܣܟܘܢܣܢ	Wisconsin
ܐܝܐܘܐ	Iowa
ܢܝܒܪܐܣܟܐ	Nebraska
ܟܐܢܣܐܣ	Kansas
ܡܝܙܘܪܝ	Missouri
ܐܪܟܢܣܐܣ	Arkansas
ܠܫܢܐ ܕܐܘܪܕܘ	Língua urdu
ܐܘܟܠܐܗܘܡܐ	Oklahoma
ܝܡܐ ܕܓܪܒܝܐ	Mar do Norte
ܒܝܝܢܐ	Viena
ܩܘܦܢܗܐܓܢ	Copenhaga
ܣܛܘܩܗܘܠܡ	Estocolmo
ܗܠܣܢܩܝ	Helsínquia
ܕܒܠܢ	Dublin
ܒܪܛܝܣܠܐܒܐ	Bratislava
ܟܬܒܐ ܩܕܝܫܐ	Bíblia
ܥܕܬܐ ܫܪܝܪܬܐ ܕܝܫܘܥ	Verdadeira Igreja de Jesus
ܠܫܢܐ ܐܢܓܠܝܐ	Língua inglesa
ܩܘܢܣܦܣܝܘܢ (ܬܫܝܠܝ)	Concepción (Chile)
ܐܘܢܛܐܪܝܘ	Ontário
ܡܐܢܝܛܘܒܐ	Manitoba
ܐܠܒܪܛܐ	Alberta
ܢܘܒܐ ܣܩܘܛܝܐ	Nova Escócia
ܩܘܢܣܩܘܒܘܠܐ	Końskowola
ܢܝܘ ܒܪܘܢܙܘܝܩ	Nova Brunswick
ܩܘܠܘܡܒܝܐ ܒܪܝܛܝܬܐ	Colúmbia Britânica
ܓܙܪܬܐ ܕܐܡܝܪܐ ܐܕܘܐܪܕ	Ilha do Príncipe Eduardo
ܣܐܣܩܐܬܫܘܐܢ	Saskatchewan
2012	2012
2011	2011
2010	2010
2009	2009
ܢܝܘܦܐܘܢܕܠܢܕ ܘܠܐܒܪܐܕܘܪ	Terra Nova e Labrador
2008	2008
ܐܘܚܕܢܐ ܓܪܒܝܝܐ-ܡܥܪܒܝܐ	Territórios do Noroeste
ܝܘܩܘܢ	Yukon
2005	2005
2006	2006
ܢܘܢܐܒܘܛ	Nunavut
2007	2007
ܡܐܟܘܠܬܐ	Alimento
ܚܘܝܐ	Serpente
ܩܘܪܘܦ	Kurów
ܟܝܡܝܐ	Química
1968	1968
ܩܛܠܥܡܐ ܝܗܘܕܝܐ	Holocausto
ܡܕܪܝܕ (ܡܕܝܢܬܐ)	Madrid
ܗܘܦܪܟܝܣ ܘܐܘܚܕܢܐ ܕܩܢܕܐ	Províncias e territórios do Canadá
ܣܢܛܝܐܓܘ ܕܐ ܬܫܝܠܝ	Santiago (Chile)
ܚܐܪܘܬܐ	Liberdade
ܣܝܕܢܝ	Sydney
ܝܪܘܩܐ	Verde
ܡܠܒܘܪܢ	Melbourne
ܣܘܡܩܐ	Vermelho
ܢܘܪܐ (ܕܠܩܐ)	Fogo
ܢܝܠܘܣ	Rio Nilo
ܓܙܐܐܪ (ܡܕܝܢܬܐ)	Argel
ܬܘܢܣ (ܡܕܝܢܬܐ)	Tunes
ܛܗܪܐܢ	Teerã
ܐܢܩܪܐ	Ancara
ܢܝܐܡܝ	Niamey
ܒܡܩܘ	Bamako
ܕܪܡܣܘܩ	Damasco
ܥܡܐܢ	Amã
ܒܝܪܘܬ	Beirute
ܒܝܬ ܨܘܒܐ	Universidade
ܒܝܬܐ (ܒܢܝܢܐ)	Casa
ܐܘܣܛܪܠܝܐ (ܝܒܫܬܐ)	Austrália (continente)
ܢܗܪܐ	Rio
ܪܝܫܐ ܕܣܒܪܐ ܛܒܐ	Cabo da Boa Esperança
ܫܘܚܡܠܐ	Investimento
ܩܘܪܝܛܝܒܐ	Curitiba
ܥܒܐ	Floresta
ܩܘܢܦܘܫܝܘܣ	Confúcio
ܩܢܐ	Ninho
ܐܘܪܘ	Euro
ܝܡܐ ܚܘܪܐ ܡܨܥܝܐ	Mar Mediterrâneo
ܓܘܪܓܝܐ	Geórgia (desambiguação)
ܡܫܝܚܝܘܬܐ	Cristianismo
ܩܠܒܐ:ܐܘܝܐ	Predefinição:Concordo
ܪܘܙܐ	Arroz
ܝܒܫܬܐ	Continente
ܛܝܪܐ	Aves
ܐܪܫܟܝܬܐ	Capital
ܠܫܢܐ ܦܘܪܛܘܓܠܝܐ	Língua portuguesa
ܝܪܚܐ	Mês
ܡܘܨܛܦܐ ܟܡܐܠ ܐܛܐܛܘܪܩ	Mustafa Kemal Atatürk
ܐܠܡܐܙܢ	Almazán
ܠܫܢܐ ܝܦܢܝܐ	Língua japonesa
ܦܐܬܐ ܪܝܫܝܬܐ	Wikipédia:Página principal
ܦܪܢܣܝܣܩܘ ܓܘܝܐ	Francisco de Goya
ܝܡܐ ܐܚܪܝܐ	Mar Cáspio
ܝܡܬܐ ܕܐܝܪܝ	Lago Erie
ܣܠܒܐܕܘܪ ܕܐܠܝ	Salvador Dalí
ܒܢܣܢܬ ܦܢ ܟܘܟ	Vincent van Gogh
ܦܪܝܕܐ ܩܐܠܘ	Frida Kahlo
ܗܢܪܝ ܡܐܛܝܣ	Henri Matisse
ܡܝܟܠܐܢܓܠܘ	Michelangelo
ܦܒܠܘ ܦܝܩܐܣܘ	Pablo Picasso
ܪܡܒܪܢܛ	Rembrandt
ܐܢܕܝ ܘܘܪܗܘܠ	Andy Warhol
ܢܝܢܘܐ (ܡܕܝܢܬܐ)	Nínive
ܒܒܠ	Babilônia (cidade)
ܐܝܪܝܚܘ	Jericó
ܩܛܠܘܢܝܐ	Catalunha
ܡܕܪܝܕ (ܗܘܦܪܟܝܐ)	Comunidade autónoma de Madrid
ܒܝܬ ܠܚܡ	Belém (Palestina)
ܣܕܪܐ:Candidates for speedy deletion	Categoria:!Páginas para eliminação rápida
ܪܫܡܠܘܬܐ	Capitalismo
ܐܘܡܬܐ	Nação
ܩܪܬܐܓܘ	Cartago
ܣܕܪܐ:ܐܣܛܪܘܢܘܡܝܐ	Categoria:Astronomia
ܨܚܪܐܐ	Deserto do Saara
ܫܐܕܐ	Diabo
ܒܝܬ ܟܬܒܐ	Biblioteca
ܫܘܠܛܢܘܬܐ (ܫܘܬܐܣܐ)	Governo
ܬܫܝܢ ܫܝ ܗܘܐܢܓ	Qin Shihuang
ܡܕܢܚܐ ܡܨܥܝܬܐ	Médio Oriente
ܡܠܟܘܬܐ	Monarquia
ܩܘܛܢܝܘܬܐ	República
ܐܬܪܐ	Estado
ܓܒܐ	Partido político
ܝܗܘܕܝܐ	Judeu
ܝܡܡܬܐ ܪܘܪܒܬܐ	Grandes Lagos da América do Norte
ܐܘܩܝܢܘܣ ܬܝܡܢܝܐ	Oceano Antártico
ܐܕܢܐ (ܝܘܠܦܢ ܨܪܘܝܘܬܐ)	Orelha
ܢܚܝܪܐ	Nariz
ܥܝܢܐ (ܝܘܠܦܢ ܨܪܘܝܘܬܐ)	Olho
ܥܘܩܒܪܬܐ	Músculo
ܙܡܝܪܬܐ	Canção
ܓܡܠܐ	Camelo
ܫܘܫܡܢܐ	Formiga
ܕܒܫܬܐ	Anthophila
ܠܫܢܐ ܗܘܠܢܕܝܐ	Língua neerlandesa
ܐܡܐ (ܒܝܬܝܘܬܐ)	Mãe
ܐܒܐ (ܒܝܬܝܘܬܐ)	Pai
1847	1847
ܨܦܪܐ (ܙܒܢܐ)	Manhã
ܩܛܝܢܬܐ	Minuto
ܠܫܢܐ ܪܘܣܝܐ	Língua russa
ܩܢܘܢܐ	Direito
ܠܫܢܐ ܨܝܢܝܐ	Língua chinesa
ܕܡܐ	Sangue
ܬܓܪܘܡܬܐ	Esqueleto
ܪܐܬܐ	Pulmão humano
ܠܫܢܐ ܪܘܡܢܝܐ	Língua romena
ܡܛܪܐ	Chuva
ܢܠܣܘܢ ܡܐܢܕܝܠܐ	Nelson Mandela
ܐܒܢܐ	Rocha
ܥܢܢܐ	Nuvem
ܩܢܘܢܐ ܕܠܥܙܐ	Gramática
ܠܫܢܐ ܓܘܪܓܝܐ	Língua georgiana
ܝܘܠܦܢ ܡܡܫܚܘܬܐ	Economia
ܙܘܙܐ	Moeda
ܡܕܐܬܐ	Imposto
ܐܠܦܒܝܬ ܥܪܒܝܐ	Alfabeto árabe
ܐܠܦܒܝܬ ܝܘܢܝܐ	Alfabeto grego
ܐܠܦܒܝܬ ܠܐܛܝܢܝܐ	Alfabeto latino
ܣܕܪܐ:ܦܪܢܣܐ	Categoria:França
ܟܢܫܐ	Sociedade
ܓܒܪܐ	Homem
ܙܘܘܓܐ	Casamento
ܙܕܩܐ ܕܒܪܢܫܐ	Direitos humanos
ܩܪܒܐ ܓܘܝܐ	Guerra civil
ܓܪܡܐ ܕܣܢܘܢܝܬܐ	Esterno
ܬܪܝܢܐ	Suco
ܚܠܒܐ (ܕܝܘܒܐ)	Leite
ܛܘܪܐ	Montanha
ܡܕܒܪܐ	Deserto
ܠܫܢܐ ܐܠܒܢܝܐ	Língua albanesa
ܠܫܢܐ ܐܪܡܢܝܐ	Língua arménia
ܝܘܗܐܢ ܓܘܛܢܒܪܓ	Johannes Gutenberg
ܠܫܢܐ ܣܘܝܕܝܐ	Língua sueca
ܢܝܩܘܠܐ ܛܣܠܐ	Nikola Tesla
ܡܘܫܐ	Moisés
ܬܕܐ	Mama
ܢܘܗܪܐ (ܚܙܝܬܐ)	Luz
ܠܫܢܐ ܝܘܢܝܐ	Língua grega
ܠܫܢܐ ܦܪܣܝܐ	Língua persa
ܬܘܕܝܬܐ	Religião
ܐܒܪܗܡ	Abraão
ܣܦܪܐ ܕܒܪܝܬܐ	Gênesis
ܠܫܢܐ ܩܢܛܘܢܝܐ	Cantonês
ܠܫܢܐ ܡܢܕܪܝܢܝܐ	Língua mandarim
ܦܘܠܘܣ ܫܠܝܚܐ	Paulo de Tarso
ܙܝܓܡܘܢܕ ܦܪܘܝܕ	Sigmund Freud
ܙܠܛܐ	Salada
ܝܗܘܕܝܘܬܐ	Judaísmo
ܠܫܢܐ ܥܒܪܝܐ	Língua hebraica
ܟܒܕܐ	Fígado
ܛܚܠܐ	Baço
ܟܘܠܝܬܐ	Rim
ܫܠܦܘܚܬܐ	Bexiga
ܐܫܟܐ	Testículo
ܐܘܩܝܢܘܣ	Oceano
ܒܘܕܗܐ	Sidarta Gautama
ܡܘܚܡܕ	Maomé
ܟܪܣܐ	Abdómen
ܚܒܠܐ ܟܘܒܝܐ	Medula espinhal
ܘܪܝܕܐ	Veia
ܡܪܒܥܐ	Útero
ܠܫܢܐ (ܗܕܡܐ)	Língua
ܓܝܕܐ	Nervo
ܨܘܪܐ (ܝܘܠܦܢ ܨܪܘܝܘܬܐ)	Pescoço
ܦܘܡܐ	Boca
ܓܓܪܬܐ	Laringe
ܡܥܝܐ	Intestino
ܫܪܝܬܐ	Articulação
ܚܕܝܐ	Peito
ܬܝܪܬܐ	Glândula
ܚܠܒܐ (ܝܘܠܦܢ ܨܪܘܝܘܬܐ)	Músculo diafragma
ܫܪܝܢܐ	Artéria
A	A
B	B
ܢܘܛܦܬܐ	Sémen
G	G
U	U
Z	Z
F	F
J	J
ܐܠܦܒܝܬ	Alfabeto
T	T
C	C
R	R
D	D
Α	Α
Ω	Ω
I	I
Μ	Μ
E	E
H	H
ܗܐܪܠܡ (ܗܘܠܢܕܐ)	Haarlem
K	K
L	L
M	M
N	N
O	O
Q	Q
S	S
V	V
W	W
X	X
Y	Y
ܐܢܫܟܕܐ	Enschede
Φ	Φ
ܝܘܢܐ	Columbidae
ܐܝܠܢܐ	Árvore
Λ	Λ
ܓܒܬܐ	Queijo
ܥܢܒܬܐ	Uva
ܕܒܫܐ	Mel
ܒܣܪܐ	Carne
ܫܟܪ	Açúcar
ܣܦܪܙܒܢܐ	Jornal
ܙܥܘܩܐ	Telefone
ܡܪܕܘܬܐ	Cultura
ܡܥܝܐ ܥܒܝܐ	Intestino grosso
ܡܥܝܐ ܩܛܝܢܐ	Intestino delgado
ܣܘܪܓܕܐ ܝܘܠܝܝܐ	Calendário juliano
ܐܣܝܘܬܐ	Medicina
ܡܠܚܐ (ܐܨܪܐ)	Sal de cozinha
ܣܕܪܐ:ܒܪܐܙܝܠ	Categoria:Brasil
ܙܘܝܬܐ (ܡܚܪܘܬܐ)	Ângulo
ܬܘܩܦܐ	Energia
ܣܦܝܢܬܐ	Navio
ܩܠܐ (ܨܘܬܐ)	Som
ܙܓܘܓܝܬܐ	Vidro
ܫܛܝܚܘܬܐ	Área
ܡܢܝܢܐ	Número
ܪܦܦܐ	Segundo
ܣܥܪܬܐ	Cevada
ܘܘܗܐܢ	Wuhan
ܡܟܬܒܢܘܬܐ ܕܐܬܪܘܬܐ	Lista de Estados soberanos
ܒܝܬ ܢܗܪܝܢ	Mesopotâmia
ܕܒܐ	Ursidae
ܬܠܗܝܐ	Cancro
ܡܠܟܐ	Rei
ܚܛܬܐ	Trigo
ܣܘܪܓܕܐ	Calendário
ܟܘܪܗܢܐ	Doença
ܣܘܪܓܕܐ ܓܪܝܓܘܪܝܐ	Calendário gregoriano
ܟܦܣܐ	Menstruação
ܥܡܐ ܩܪܕܘܝܐ	Curdos
ܓܫܪܐ	Ponte
ܡܓܕܠܐ (ܒܢܝܢܐ)	Torre
ܐܡܪܝܩܐ ܠܐܛܝܢܝܬܐ	América Latina
ܟܗܪܒܐ	Eletricidade
ܡܙܝܥܢܐ ܕܩܝܕܐ ܓܘܝܐ	Motor de combustão interna
ܣܝܦܐ (ܙܝܢܐ)	Espada
ܫܡܥܘܢ ܩܢܢܝܐ	Simão, o Zelote
ܩܪܩܦܬܐ	Crânio
ܓܘܡܠܐ!	Joomla
ܐܦܫܬܐ	Passa
ܠܫܢܐ ܥܪܒܝܐ	Língua árabe
ܠܫܢܐ ܐܦܪܝܩܐܢܝܐ	Língua africâner
Β	Β
Γ	Γ
Δ	Δ
Ε	Ε
Ζ	Ζ
Η	Η
Θ	Θ
Ι	Ι
Κ	Κ
Ν	Ν
Ξ	Ξ
Ο	Ο
Ρ	Ρ
Σ	Σ
Τ	Τ
Υ	Υ
Χ	Χ
Ψ	Ψ
ܐܬܐ	Bandeira
ܟܪܦܬܐ	Mobiliário
ܟܘܪܣܝܐ	Cadeira
ܣܦܬܐ	Lábio
ܦܣܡܐ	Bigode
ܥܩܠܐ	Pé
1000000000 (ܡܢܝܢܐ)	1000000000
ܓܪܡܐ ܕܨܕܥܐ	Osso temporal
ܩܠܝܕܐ (ܓܪܡܐ)	Clavícula
ܟܬܦܐ	Ombro
ܦܟܐ ܬܚܬܝܐ	Mandíbula
ܩܠܒܐ:Link FA	Predefinição:Link FA
ܥܠܡܐ (ܐܪܥܐ)	Mundo
ܘܝܩܝܦܕܝܐ:ܬܪܥܐ ܕܟܢܫܐ	Wikipédia:Esplanada
ܒܝܪܡܘܢܬ	Vermont
ܩܘܣܛܢܛܝܢܘܦܘܠܝܣ	Constantinopla
ܒܝܬ ܟܪܝܗܐ	Hospital
ܥܕܬܐ	Igreja (edifício)
ܕܝܬܝܩܝ ܚܕܬܐ	Novo Testamento
9 (ܡܢܝܢܐ)	Nove
1002	1002
ܦܘܕܘܠܣܟ	Podolsk
ܦܐܦܐ	Papa
5	5
4	4
ܢܝܒܐ	Canino (dente)
3	3
2	2
ܒܝܬ ܥܬܩܐ ܕܠܘܒܪ	Museu do Louvre
ܓܒܐ ܕܚܐܪܘܬܐ ܕܦܘܐܪܛܘ ܪܝܩܘ	Partido Independentista Portorriquenho
6	6
ܕܝܬܝܩܝ ܥܬܝܩܬܐ	Antigo Testamento
ܥܐܕܐ ܕܒܝܬ ܝܠܕܐ	Natal
ܠܫܢܐ ܪܘܡܐܢܣܝܐ	Línguas românicas
ܡܬܠܬܐ	Triângulo
ܫܢܬܐ ܟܒܝܫܬܐ	Ano bissexto
ܡܘܥܡܪ ܐܠܩܕܐܦܝ	Muammar al-Gaddafi
ܥܐܕܐ ܕܩܝܡܬܐ	Páscoa
ܢܝܘ ܝܘܪܩ	Nova Iorque (desambiguação)
ܢܦܛܐ	Petróleo
ܣܐܘܢܐ	Sapato
ܒܝܬ ܥܘܪܦܢܐ	Banco
ܟܪܡܐ	Vinha
ܐܝܪܠܢܕ (ܓܙܪܬܐ)	Irlanda (ilha)
1	1
ܠܘ ܫܘܢ	Lu Xun (escritor)
10	10
20	20
9	9
7	7
8	8
7 (ܡܢܝܢܐ)	Sete
8 (ܡܢܝܢܐ)	Oito
12	12
ܡܠܐܐ ܘܬܘܒܐ	Maré
ܫܒܘܥܐ	Semana
ܓܠܝܕܐ	Gelo
ܨܠܘܬܐ ܡܪܢܝܬܐ	Pai Nosso
ܝܡܬܐ	Lago
ܝܡܐ ܣܘܡܩܐ	Mar Vermelho
13	13
ܩܛܘܬܐ (ܝܥܝܬܐ)	Pepino
ܓܙܪܬܐ	Ilha
ܚܘܪܐ	Branco
ܐܘܟܡܐ	Preto
6 (ܡܢܝܢܐ)	Seis
ܠܫܢܐ ܪܘܫܡܝܐ	Língua oficial
11	11
15	15
14	14
17	17
ܣܦܪ ܡܠܐ	Dicionário
18	18
19	19
16	16
21	21
ܦܠܣܛܝܢ	Palestina
10 (ܡܢܝܢܐ)	Dez
ܡܣܘܪܩܐ (ܡܐܢܐ)	Pente
ܠܝܠܐ ܕܘܢܤ	Lila Downs
ܝܡܐ ܕܡܠܚܐ	Mar Morto
ܫܘܚܠܦܐ ܕܫܢܬܐ	Estação do ano
ܠܝܒܪܦܘܠ	Liverpool
ܩܘܦܬܐ (ܛܝܪܐ)	Strigiformes
ܫܥܬܐ	Hora
ܢܐܘܝ ܕܘܪ ܟܪܘܠܣܟܝ	Nowy Dwór Królewski
ܐܪܙܦܬܐ	Martelo
ܝܘܢܫܘܦܝܢ	Jönköping
ܥܘܠܐ ܚܝܐ	Feto
ܐܠܦܒܝܬ ܣܘܪܝܝܐ	Alfabeto siríaco
ܐܠܦܒܝܬ ܐܪܡܝܐ	Alfabeto aramaico
ܐܣܝܐ ܡܥܪܒܝܬܐ	Sudoeste Asiático
ܙܡܪܐ	Canto (música)
ܫܓܠܐ	Amarelinha
ܩܠܦܬܐ ܕܒܣܡܐ	Canela
ܡܙܬܐ	Pelo
ܠܫܢܐ ܐܪܡܝܐ	Aramaico
ܨܦܪܐ (ܛܝܪܐ)	Passeridae
ܐܦܣܩܘܦܐ	Bispo
ܨܝܢ (ܐܪܥܐ)	China (civilização)
ܓܒܐ ܕܝܡܘܩܪܛܝܐ (ܐܘܚܕܢܐ ܡܚܝܕܐ)	Partido Democrata (Estados Unidos)
ܒܝܐܛܪܝܟܣ ܕܒܝܬ ܗܘܠܢܕܝܐ	Beatriz dos Países Baixos
ܡܠܟܘܬܐ ܕܗܘܠܢܕܐ	Reino dos Países Baixos
ܐܒܪܝܠ ܠܐܒܝܢ	Avril Lavigne
ܪܝܫ ܩܘܛܢܝܘܬܐ	Presidente
ܐܪܒܝܐ	Arábia
ܡܪܩܘܣ ܐܘܢܓܠܣܛܐ	São Marcos
ܥܘܠܐ	Embrião
ܫܘܫܡܢܝܬܐ (ܝܥܝܬܐ)	Cardamomo-verdadeiro
ܠܫܢܐ ܕܓܐܢ	Chinês gan
ܒܝܬ ܥܬܩܐ	Museu
ܐܠܦܒܝܬ ܥܒܪܝܐ	Alfabeto hebraico
ܠܫܢܐ ܣܘܪܝܝܐ	Língua siríaca
ܒܪܩܐ	Raio (meteorologia)
ܐܝܕܐ	Mão
ܫܡܥܘܢ ܟܐܦܐ	São Pedro
ܬܠ ܐܒܝܒ	Tel Aviv
ܒܐܠܦܐܪܐܝܣܘ	Valparaíso (Chile)
ܛܘܪܝܐ	Língua turoyo
ܠܫܢܐ ܫܝܡܝܐ	Línguas semíticas
ܚܘܣܢܝ ܡܘܒܐܪܟ	Hosni Mubarak
ܘܐܟܐܩܐ	Oaxaca
ܚܐܘܬܐ	Manteiga
ܐܘܢܓܠܝܘܢ	Evangelho
ܠܫܢܐ ܕܘܘ	Língua wu
ܪܘܛܪܕܐܡ	Roterdão
ܩܪܛܐ	Creta
ܐܘܪܚܐ	Estrada
ܩܘܪܨܐ ܚܠܝܨܐ	Compact Disc
ܨܒܥܐ	Dedo
ܦܪܬ	Rio Eufrates
ܩܝܘܛܘ	Quioto
ܥܣܪܐ ܦܘܩܕܢܐ	Dez Mandamentos
ܒܪܩܩܐ ܦܪܣܝܐ	Golfo Pérsico
ܚܠܐ (ܕܚܝܚܐ)	Areia
ܘܪܕܐ	Rosa
ܓܙܪܬܐ ܝܒܫܢܝܬܐ	Península
ܐܘܪܝܬܐ	Torá
ܟܘܘܝܬ (ܡܕܝܢܬܐ)	Kuwait (cidade)
ܡܚܙܝܬܐ	Espelho
ܥܡܐ ܥܪܒܝܐ	Árabes
ܟܘܬܐ	Janela
ܠܫܢܐ ܝܘܢܝܐ ܥܬܝܩܐ	Língua grega antiga
ܠܫܢܐ ܐܟܕܝܐ	Língua acádia
ܕܩܠܬ	Rio Tigre
ܐܬܪܘܬܐ ܕܐܬܪܘܬܐ ܡܚܝܕܐ ܕܐܡܪܝܩܐ	Estados dos Estados Unidos
ܡܥܡܘܕܝܬܐ	Batismo
ܩܘܢܓܘ	Congo
ܐܝܢܛܪܠܝܢܓܘܐ	Língua interlíngua
ܐܘܪܟܐ	Comprimento
ܚܠܡܐ	Sonho
ܠܫܢܐ ܩܪܕܘܝܐ	Língua curda
ܩܡܚܐ	Farinha
ܕܢ ܗܐܟ	Haia
ܠܫܢܐ ܦܘܢܝܩܝܐ	Língua fenícia
ܣܝܢܝ (ܓܙܪܬܐ ܝܒܫܢܝܬܐ)	Sinai
ܟܪܘܙܘܬܐ ܕܝܘܚܢܢ	Evangelho segundo João
ܬܪܥܐ (ܒܒܐ)	Porta
ܪܝܗܐܢܐ	Rihanna
ܛܦܪܐ	Unha
ܐܦܐ	Face
ܨܨܐ (ܨܢܥܬܐ)	Prego
ܙܝܬܐ	Oliveira
ܬܠܝܬܝܘܬܐ	Trindade (cristianismo)
ܓܠܠܐ	Onda
ܟܬܒܬܐ	Escrita
ܪܘܚܐ ܕܩܘܕܫܐ	Espírito Santo
100 (ܡܢܝܢܐ)	Cem
ܒܘܪܟܐ	Joelho
ܫܘܩܐ (ܬܐܓܪܘܬܐ)	Mercado
ܠܫܢܐ ܥܪܒܝܐ ܝܗܘܕܝܐ	Línguas judaico-árabes
ܒܠܛܝ	Bălţi
1000000 (ܡܢܝܢܐ)	Milhão
ܛܐܒܐ	Notícia
ܐܫܬܐ (ܐܣܝܘܬܐ)	Febre
ܩܫܬܐ ܓܪܒܝܝܬܐ ܕܐܪܥܐ	Hemisfério norte
ܡܡܘܢܐ ܕܡܝܟܪܐ	Microeconomia
ܠܝܕܣ	Leeds
ܥܘܩܒܪܐ	Mus
ܦܘܪܬܩܠܐ	Laranja (cor)
ܒܪܩܩܐ	Baía
ܒܝܬ ܩܒܘܪܐ	Cemitério
ܐܣܝܐ (ܫܕܬܐ)	Médico
ܡܩܕܘܢܝܐ	Macedónia
ܦܢܛܝܩܘܣܛܝ	Pentecostes
ܫܓܕܬܐ	Amendoeira
ܟܪܘܙܘܬܐ ܕܠܘܩܐ	Evangelho segundo Lucas
ܩܘܢܣܦܣܝܘܢ (ܗܘܦܪܟܝܐ)	Concepción (província do Chile)
ܢܗܪܐ ܕܝܘܪܕܢܢ	Rio Jordão
ܣܦܪ ܝܡܐ	Praia
ܐܢܛܐܠܝܐ (ܗܘܦܪܟܝܐ)	Antália (província)
ܦܪܟܣܝܣ ܕܫܠܝܚܐ	Atos dos Apóstolos
ܥܪܘܒܬܐ ܕܚܫܐ	Sexta-Feira Santa
ܚܒܘܫܝܐ	Prisão
ܐܕܢܐ (ܗܘܦܪܟܝܐ)	Adana (província)
ܝܘܚܢܢ ܡܥܡܕܢܐ	João Batista
ܨܠܝܒܐ	Cruz
ܚܙܒܐܠܠܗ	Hizbollah
ܒܝܬ ܓܒܝܢܐ	Testa
ܡܙܡܘܪܐ	Livro de Salmos
ܐܬܘܪ	Assíria
ܒܢܝܢܐ	Edifício
ܚܠܒ (ܡܕܝܢܬܐ)	Alepo
ܩܫܬܐ ܬܝܡܢܝܬܐ ܕܐܪܥܐ	Hemisfério sul
ܚܠܐ (ܚܡܪܐ)	Vinagre
ܒܝܬ ܕܝܢܐ	Tribunal
ܚܝܦܐ	Haifa
ܫܛܪܐ ܬܐܒܝܠܝܐ ܕܓܝܢܝܣ	Guinness World Records
ܟܘܕܢܝܐ	Mula
ܒܪܩܩܐ ܕܥܕܢ	Golfo de Áden
ܓܠܝܢܐ ܕܝܘܚܢܢ	Apocalipse
ܐܫܬܐ (ܝܘܠܦܢ ܨܪܘܝܘܬܐ)	Nádegas
ܨܠܘܬܐ ܡܪܝܡܝܬܐ	Ave Maria
ܝܩܕܐ	Combustível
ܝܨܝܠܐ	Cotovelo
ܟܗܢܐ	Sacerdote
ܕܩܢܐ	Barba
ܢܒܝܐ	Profeta
ܐܘܪܟܝܣܛܪܐ	Orquestra
1000 (ܡܢܝܢܐ)	Mil
ܣܘܦܝܐ ܪܘܛܐܪܘ	Sofia Rotaru
ܬܫܢܝܬܐ	Seguro
ܛܘܟܣܐ	Organização
ܣܦܪܓܠܐ	Marmeleiro
ܐܢܕܪܐܘܣ ܫܠܝܚܐ	Santo André
ܬܪܥܣܪ ܫܠܝܚܐ	Apóstolo
ܢܩܒܬܐ	Fêmea
ܕܪܥܐ (ܗܕܡܐ)	Braço
ܡܬܝ ܡܟܣܐ	Mateus (evangelista)
ܬܐܘܡܐ ܫܠܝܚܐ	São Tomé
ܦܝܠܝܦܘܣ ܫܠܝܚܐ	Filipe (apóstolo)
ܒܘܪܨܐ (ܗܘܦܪܟܝܐ)	Bursa (província)
ܐܝܘܐܢܢܝܣ ܦܘܡܐ ܕܕܗܒܐ	João Crisóstomo
ܒܢܝܡܝܢ ܢܬܢܝܗܘ	Benjamin Netanyahu
ܐܪܬܒܝܢ (ܗܘܦܪܟܝܐ)	Artvin (província)
ܓܒܝܢܐ	Sobrancelha
ܫܘܪܬܐ	Umbigo
ܐܕܝܐܡܐܢ (ܗܘܦܪܟܝܐ)	Adıyaman (província)
ܝܗܘܕܐ ܫܠܝܚܐ	Judas Tadeu
ܒܪܬܘܠܡܝ ܫܠܝܚܐ	São Bartolomeu
ܝܥܩܘܒ ܒܪ ܙܒܕܝ	Santiago Maior
ܡܬܝܐ ܫܠܝܚܐ	Matias (apóstolo)
ܝܥܩܘܒ ܒܪ ܚܠܦܝ	Santiago Menor
ܕܟܪܐ	Macho
ܐܝܓܢܐܛܝܘܣ ܢܘܪܢܐ	Inácio de Antioquia
ܪܕܝܘܗܕ	Radiohead
ܒܫܐܪ ܐܠܐܣܕ	Bashar al-Assad
ܪܚܝܐ	Moinho
ܨܘܡܐ	Jejum
ܕܝܪܐ	Mosteiro
ܠܡܐܢܐ	Porto (transporte)
ܡܠܚܐ (ܢܘܛܐ)	Marinheiro
ܐܦܝܘܢ (ܗܘܦܪܟܝܐ)	Afyonkarahisar (província)
ܡܝܟܐܝܠ (ܡܠܐܟܐ)	Miguel (arcanjo)
ܒܝܠܓܝܟ (ܗܘܦܪܟܝܐ)	Bilecik (província)
ܒܝܬ ܥܬܩܐ ܕܐܣܪܐܝܠ	Museu de Israel
ܒܐܠܝܟܣܝܪ (ܗܘܦܪܟܝܐ)	Balıkesir (província)
ܒܝܬ ܝܠܕܐ	Aniversário
ܬܘܠܥܐ	Verme
ܬܘܩܢ ܓܝܕܝܐ ܩܢܛܪܘܢܝܐ	Sistema nervoso central
ܛܘܪܐ ܕܓܠܝܕܐ	Iceberg
ܡܫܠܡܢܐ	Muçulmano
ܢܢܥܐ	Mentha
ܩܠܒܐ:Commonscat	Predefinição:Commonscat
ܒܨܪܐ (ܡܕܝܢܬܐ)	Baçorá
ܐܓܪܬܐ ܕܠܘܬ ܪܗܘܡܝܐ	Epístola aos Romanos
ܬܡܪܐ ܕܥܝܢܐ	Pálpebra
ܗܘܦܪܟܝܣ ܕܛܘܪܩܝܐ	Províncias da Turquia
ܡܪܝ ܓܝܘܪܓܝܣ ܣܗܕܐ	São Jorge
ܐܣܘܬܐ ܕܠܐ ܬܚܘܡܐ	Médicos sem Fronteiras
ܐܪܙܐ (ܡܫܝܚܝܘܬܐ)	Sacramento (cristianismo)
ܐܓܪܬܐ ܕܠܘܬ ܦܝܠܝܦܣܝܐ	Epístola aos Filipenses
ܐܢܛܘܠܝܐ	Anatólia
ܡܫܝܚܐ	Messias
ܚܫܡܝܬܐ ܐܚܪܝܬܐ	Última Ceia
ܩܢܘܢܐ ܕܗܝܡܢܘܬܐ	Credo dos Apóstolos
ܒܢܝ ܐܝܣܪܐܝܠ	Tribos de Israel
ܡܓܘܫܐ ܬܠܬܐ	Três Reis Magos
ܝܘܚܢܢ ܕܪܡܣܘܩܝܐ	João Damasceno
ܒܒܐ (ܬܪܥܐ)	Portão
ܣܕܪܐ:ܡܠܟܐ	Categoria:Reis
ܣܕܪܐ:ܪܘܟܒ ܫܘܠܛܢܘܬܐ	Categoria:Formas de governo
ܠܫܢܐ ܕܡܝܢ	Línguas min
ܥܘܪܡܫܐ	Poluição
ܒܒܠ (ܗܘܦܪܟܝܐ)	Babil
ܫܘܡܪܐ	Fuligem
ܐܫܩܠܘܢ	Ascalão
ܕܘܢܒܐ	Cauda
ܩܐܕܣܝܐ (ܗܘܦܪܟܝܐ)	Al-Qadisiyyah (província)
ܡܪܝܡ ܡܓܕܠܝܬܐ	Maria Madalena
ܡܪܪܬܐ	Vesícula biliar
ܥܕܬܐ ܟܠܕܝܬܐ ܩܬܘܠܝܩܝܬܐ	Igreja Católica Caldeia
ܥܕܬܐ ܡܪܘܢܝܬܐ	Igreja Maronita
ܡܪܬܐ	Bile
ܩܘܪܒܢܐ	Eucaristia
ܐܘܘܫܐ	Cerúmen
ܕܡܥܬܐ	Lágrima
ܟܘܬܝܢܐ	Camisa
ܝܘܗܐܢ ܐܠܙܪ	Georg Elser
ܒܝܢܓܘܠ (ܗܘܦܪܟܝܐ)	Bingöl (província)
ܥܡܐ ܐܪܡܢܝܐ	Armênios
ܐܝܕܝܢ (ܗܘܦܪܟܝܐ)	Aydın (província)
ܩܛܠܥܡܐ ܐܪܡܢܝܐ	Genocídio armênio
ܐܡܐܣܝܐ (ܗܘܦܪܟܝܐ)	Amásia (província)
ܦܪܝܙܘܢ ܒܪܝܟ	Prison Break
ܐܓܪܝ (ܗܘܦܪܟܝܐ)	Ağrı (província)
ܒܘܪܕܘܪ (ܗܘܦܪܟܝܐ)	Burdur (província)
ܐܓܪܬܐ ܩܕܡܝܬܐ ܕܠܘܬ ܩܘܪܢܬܝܐ	Primeira Epístola aos Coríntios
ܝܗܘܕܐ ܣܟܪܝܘܛܐ	Judas Iscariotes
ܐܒܪܐ	Pena
ܡܚܪܐ	Engenheiro
ܚܪܛܘܡܢܐ	Grão-de-bico
ܐܬܪܘܬܐ ܕܫܐܡ	Levante (Mediterrâneo)
ܬܪܘܕܐ	Colher
ܓܒܪܐܝܠ (ܡܠܐܟܐ)	Gabriel (anjo)
ܓܪܡܦܝܠܐ	Marfim
ܨܘܪ	Tiro
ܒܘܠܘ (ܗܘܦܪܟܝܐ)	Bolu (província)
ܙܢܩܐ	Queixo
ܨܘܡܐ ܕܐܪܒܥܝܢ	Quaresma
ܐܓܪܐ ܕܒܢܝܢܐ	Telhado
ܒܝܛܠܝܣ (ܗܘܦܪܟܝܐ)	Bitlis (província)
ܓܠܝܠܐ	Galileia
ܪܥܡܐ	Trovão
ܡܘܨܠ	Mossul
ܟܪܬܐ	Polegar
ܥܡܐ ܛܘܪܩܝܐ	Turcos
ܦܐܦܐ ܫܢܘܕܐ ܬܠܝܬܝܐ	Shenouda III de Alexandria
ܒܝܥܬܐ	Ovo (alimento)
ܒܣܕܝܐ	Travesseiro
ܙܓܐ (ܢܩܘܫܐ)	Sino
ܫܒܬܐ (ܝܗܘܕܝܘܬܐ)	Shabat
ܫܡܝܪܡ	Semíramis
ܫܝܓܪܐ	Gengiva
ܝܗ	Tetragrama YHVH
ܡܫܝܚܝܐ	Cristão
ܟܪܘܙܘܬܐ ܕܡܪܩܘܣ	Evangelho segundo Marcos
ܟܟܪܝܬܐ ܕܕܒܫܐ	Favo
ܐܓܪܬܐ ܕܠܘܬ ܩܘܪܢܬܝܐ ܕܬܪܬܝܢ	Segunda Epístola aos Coríntios
ܛܥܡܐ	Paladar
ܓܢܬ ܫܒܪܐ	Jardim de infância
ܝܡܬܐ ܕܓܠܝܠܐ	Mar da Galileia
ܡܪܝ ܝܘܣܦ	São José
ܠܘܩܐ ܐܘܢܓܠܣܛܐ	São Lucas
ܐܓܪܬܐ ܕܠܘܬ ܥܒܪܝܐ	Epístola aos Hebreus
ܐܓܪܬܐ ܕܠܘܬ ܓܠܛܝܐ	Epístola aos Gálatas
ܡܪܝ ܡܝܟܐܝܠ ܪܒܐ	Miguel, o Sírio
Ϝ	Ϝ
Ϙ	Qoopa
ܥܛܡܐ	Coxa
ܬܢܢܐ	Fumo
ܡܘܚܘܢܐ	Cerebelo
ܐܓܪܬܐ ܕܠܘܬ ܩܘܠܣܝܐ	Epístola aos Colossenses
ܐܓܪܬܐ ܕܝܥܩܘܒ	Epístola de Tiago
ܐܓܪܬܐ ܩܕܡܝܬܐ ܕܝܘܚܢܢ	Primeira Epístola de João
ܐܓܪܬܐ ܕܠܘܬ ܦܝܠܡܘܢ	Epístola a Filémon
ܐܓܪܬܐ ܕܠܘܬ ܬܣܠܘܢܝܩܝܐ ܕܬܪܬܝܢ	Segunda Epístola aos Tessalonicenses
ܐܓܪܬܐ ܩܕܡܝܬܐ ܕܠܘܬ ܬܣܠܘܢܝܩܝܐ	Primeira Epístola aos Tessalonicenses
ܐܓܪܬܐ ܩܕܡܝܬܐ ܕܦܛܪܘܣ	Primeira Epístola de Pedro
ܐܓܪܬܐ ܕܬܪܬܝܢ ܕܦܛܪܘܣ	Segunda Epístola de Pedro
ܐܓܪܬܐ ܩܕܡܝܬܐ ܕܠܘܬ ܛܝܡܬܐܘܣ	Primeira Epístola a Timóteo
Ϛ	Ϛ
ܡܪܕܝܢ (ܗܘܦܪܟܝܐ)	Mardin (província)
ܚܡܨ (ܡܕܝܢܬܐ)	Homs
Ͳ	Ͳ
ܘܐܟܐܩܐ ܕܝ ܟܘܐܪܝܣ	Oaxaca de Juárez
ܐܓܪܬܐ ܕܬܪܬܝܢ ܕܝܘܚܢܢ	Segunda Epístola de João
ܐܓܪܬܐ ܕܬܠܬ ܕܝܘܚܢܢ	Terceira Epístola de João
ܐܓܪܬܐ ܕܝܗܘܕܐ	Epístola de Judas
ܐܓܪܬܐ ܕܠܘܬ ܛܝܡܬܐܘܣ ܕܬܪܬܝܢ	Segunda Epístola a Timóteo
ܐܓܪܬܐ ܕܠܘܬ ܛܛܘܣ	Epístola a Tito
ܫܝܪܢܐܟ (ܡܕܝܢܬܐ)	Şırnak
ܓܘܣܢܐ	Refugiado
Ϻ	Ϻ
ܩܠܝܕܐ (ܡܐܢܐ)	Chave
ܥܕܥܐܕܐ	Festival
ܐܪܒܝܠ (ܡܕܝܢܬܐ)	Arbil
ܪܓܠܐ	Perna
ܚܨܐ	Costas
ܐܠܝܐ ܢܒܝܐ	Elias
ܙܚܘܪܝܬܐ (ܬܘܠܥܬܐ)	Bicho-da-seda
ܚܘܦܝܐ	Eclipse
ܡܚܛܐ	Agulha
ܥܠܡܐ ܥܪܒܝܐ	Mundo árabe
ܩܛܡܐ	Cinzas
ܢܘܗܕܪܐ (ܡܕܝܢܬܐ)	Dohuk
ܨܒܥܐ ܕܪܓܠܐ	Artelho
ܠܘܚܐ (ܚܫܘܒܬܐ)	Tablet
ܪܒܝܬܐ	Usura
ܡܟܝܪܘܬܐ	Noivado
ܫܘܪܡܐ	Reto
ܐܪܡܝܐ (ܢܒܝܐ)	Jeremias
ܬܐܡܐ	Gêmeos
ܬܠܝܦܐ	Celha
ܫܥܬܐ ܕܐܪܥܐ	Hora do Planeta
ܦܪܡܝܬܐ	Botão
ܟܘܟܒܐ ܕܕܘܝܕ	Estrela de Davi
ܡܪܝ ܐܣܛܦܢܘܣ	Santo Estêvão
ܡܫܡܫܢܐ	Diácono
ܢܓܒ	Neguev
ܟܢܥܢ	Canaã
ܢܘܨܦܐ	Crepúsculo
ܒܝܢܐ	Tamarix
ܬܓܪܝܬ	Tikrit
ܚܠܐ (ܥܦܪܐ)	Poeira
ܬܪܥܐ ܕܕܡܐ	Hemorragia
ܥܪܒܐ ܕܫܡܫܐ	Pôr do sol
ܐܡܝܫܐ	Pântano
ܡܨܥܝܬܐ (ܨܒܥܐ)	Dedo médio
ܣܒܐ (ܒܝܬܝܘܬܐ)	Avós
ܩܘܪܨܠܐ	Tornozelo
ܒܪ ܐܝܕܐ	Luva
ܢܫܒܐ ܕܥܝܢܐ	Retina
ܬܘܩܢ ܓܝܕܝܐ ܡܚܕܘܪܝܐ	Sistema nervoso periférico
ܛܝܢܐ	Lama
ܓܓܘܠܬܐ	Calvário
ܗܢܝܢܐ (ܡܡܫܚܘܬܐ)	Juro
ܐܫܘܪ ܒܢܐܦܠ	Assurbanípal
ܓܕܫܐ	Acidente
ܦܛܪܝܪܟܐ	Patriarca
ܚܟܐ	Palato
ܟܪܟ ܣܠܘܟ (ܡܕܝܢܬܐ)	Kirkuk
ܒܒܬܐ	Pupila
ܩܒܪܐ	Túmulo
ܠܒܘܢܬܐ	Olíbano
ܚܡܬ (ܡܕܝܢܬܐ)	Hama
ܝܫܛܐ	Esófago
ܟܝܣܐ ܕܐܫܟܐ	Escroto
ܕܒܪܐ	Zona rural
ܚܪܘܫܬܐ	Traqueia
ܓܪܡܐ ܕܥܛܡܐ	Fêmur
ܒܪܐ (ܒܝܬܝܘܬܐ)	Filho
ܫܚܘܪܐ	Carvão vegetal
ܐܘܟܡܐ ܕܥܝܢܐ	Íris
ܫܦܠܘܗܝ ܕܢܝܠܘܣ	Delta do Nilo
ܐܘܪܡܝܐ	Úrmia
Ϸ	Ϸ
ܓܙܪܬܐ ܐܝܘܠܝܬܐ	Ilhas Eólias
ܓܒܐ ܕܒܥܬ	Partido Baath
ܦܩܪܐ	Vértebra
ܒܪ ܩܠܐ	Eco
ܟܝܡܪܐ	Quimera
ܠܘܓܡܐ	Osso maxilar
ܛܪܘܢܐ	Ditador
ܬܝܒܘܬܐ	Confissão (sacramento)
ܩܒܠܘܬܐ	Obstetriz
ܐܪܙܝܪܐ	Sturnidae
ܣܦܪܐ (ܩܢܘܢܝܐ)	Jurisconsulto
Ͱ	Ͱ
ܥܡܐ ܐܪܡܝܐ	Arameus
ܐܒܐ (ܐܠܗܐ)	Deus, o Pai
ܐܢܒܐܪ (ܗܘܦܪܟܝܐ)	Al-Anbar
ܡܪܕܝܢ (ܡܕܝܢܬܐ)	Mardin
ܣܪܛܢܐ	Câncer (desambiguação)
ܡܘܪܘܢ	Crisma
ܚܠܡܬܐ	Mamilo
ܢܘܠܐ ܕܓܘܓܝ	Teia de aranha
ܐܫܥܝܐ	Isaías
ܒܝܬ ܟܬܒܐ ܐܬܪܝܐ ܕܐܣܪܐܝܠ	Biblioteca Nacional de Israel
ܥܪܫܐ	Molar (dente)
ܢܝܢܘܐ (ܗܘܦܪܟܝܐ)	Ninawa
ܢܘܗܕܪܐ (ܗܘܦܪܟܝܐ)	Dahuk (província)
ܘܐܣܛ (ܗܘܦܪܟܝܐ)	Wasit (província)
ܨܠܐܚ ܐܠܕܝܢ (ܗܘܦܪܟܝܐ)	Salah-ad-Din (província)
ܟܢܘܫܝܐ ܕܠܫܢܐ ܥܒܪܝܐ	Academia da Língua Hebraica
ܥܘܕ	Oud
ܒܓܕܐܕ (ܗܘܦܪܟܝܐ)	Bagdad (província)
ܣܪܓܐ	Sela
ܒܨܪܐ (ܨܒܥܐ)	Anular
ܩܛܝܣܦܘܢ	Ctesifonte
ܟܒܘܫܐ	Pesadelo
ܢܓܦ (ܗܘܦܪܟܝܐ)	An-Najaf (província)
ܟܪܟ ܣܠܘܟ (ܗܘܦܪܟܝܐ)	Kirkuk (província)
ܕܢܚܐ ܕܫܡܫܐ	Nascer do sol
ܬܐܪܬܐ	Consciência (moral)
ܒܨܪܐ (ܗܘܦܪܟܝܐ)	Baçorá (província)
ܡܫܚܐ ܕܟܪܝܗܐ	Unção dos enfermos
ܦܠܫܬ	Filisteus
ܐܠܥܐ (ܝܘܠܦܢ ܨܪܘܝܘܬܐ)	Costela
ܥܕܬܐ ܐܝܓܘܦܛܝܬܐ	Igreja Ortodoxa Copta
ܐܢܛܝܘܟܝܐ	Antioquia
ܐܦܪܝܡ ܣܘܪܝܝܐ	Efrém da Síria
ܐܝܙܝܕܝܐ	Yazidi
ܪܝܫܘܢ ܠܬܣܝܘܢ	Rishon LeZion
ܟܢܪܐ	Lira (instrumento musical)
ܥܕܬܐ ܕܡܕܢܚܐ ܕܐܬܘܪܝܐ	Igreja Assíria do Oriente
ܬܠܐ ܕܚܕ ܐܝܠܢ	One Tree Hill
ܡܘܪܐ	Mirra
ܐܠܝܫܥ	Eliseu
ܗܟܐܪܝ (ܡܕܝܢܬܐ)	Hakkâri
ܣܢܚܪܝܒ	Senaqueribe
ܩܘܪܝܐܠܝܣܘܢ	Kyrie eleison
ܟܢܘܫܝܐ ܕܐܣܪܐܝܠ ܕܝܘܠܦܢܐ ܘܐܢܫܝܬܐ	Academia de Ciências e Humanidades de Israel
ܣܘܟܢܐ	Leme (navegação)
ܥܕܬܐ ܣܘܪܝܝܬܐ ܐܪܬܘܕܟܣܝܬܐ	Igreja Ortodoxa Síria
ܟܣܬܐ	Forragem animal
ܩܡܫܠܝ	Al-Qamishli
ܡܘܬܢܐ (ܗܘܦܪܟܝܐ)	Al-Muthanna
ܡܝܫܢ (ܗܘܦܪܟܝܐ)	Maysan
ܣܘܠܝܡܐܢܝܐ (ܗܘܦܪܟܝܐ)	As-Sulaymaniyah (província)
ܐܪܒܝܠ (ܗܘܦܪܟܝܐ)	Arbil (província)
ܚܠܒ (ܗܘܦܪܟܝܐ)	Alepo (distrito)
ܟܪܒܠܐܐ (ܗܘܦܪܟܝܐ)	Karbala (província)
ܦܪܨܘܦܐ	Pessoa (filosofia)
ܕܝ ܩܐܪ (ܗܘܦܪܟܝܐ)	Dhi Qar
ܐܢܕܪܢܝܩ ܡܐܪܓܐܪܝܐܢ	Andranik Margaryan
ܡܡܠܠܘܬ ܐܠܗܘܬܐ	Teologia cristã
ܓܘܙܐ	Juglandaceae
ܕܝܐܠܐ (ܗܘܦܪܟܝܐ)	Diyala
ܟܒܒ	Khabab
ܩܪܫܬܐ	Teto
ܐܡܬܐ (ܝܘܠܦܢ ܨܪܘܝܘܬܐ)	Antebraço
ܣܝܢܝ	Sinai (desambiguação)
ܬܐܘܡܐ	Thomas
ܐܝܒܪܝܐ	Ibéria (desambiguação)
ܚܡܬ (ܗܘܦܪܟܝܐ)	Hama (distrito)
ܟܢܘܢܬܐ ܕܐܝܕܐ	Carpo
ܐܝܣܪܐܝܠ (ܬܘܚܡܐ ܐܚܪܢܐ)	Israel (desambiguação)
ܡܠܐܟܐ	Anjo
ܫܢܬܐ ܦܫܝܛܬܐ	Ano comum
ܡܣܘܪܩܐ ܕܐܝܕܐ	Metacarpo
ܡܠܟܘܬܐ ܕܒܝܬ ܥܣܪ ܥܝܢܐ	Osroena
ܕܪܥܐ (ܡܕܝܢܬܐ)	Daraa (cidade)
ܣܘܣܝܐ ܐܝܣܠܢܕܝܐ	Cavalo islandês
ܩܠܐ	Nota
ܛܘܘܝܐ	Grelhado
ܓܪܡܐ	Osso
ܒܪܝܐܢܝ	Biryani
ܠܒܠܒܬܐ	Úvula
ܙܓܐ ܕܣܦܝܢܬܐ	Sino de navio
ܥܪܒܝܐ	Árabe
ܓܝܕܐ ܕܓܢܫܝܐ	Nervo ciático
ܗܪܗܪܐ	Miragem
ܒܝܬ ܢܗܪܝܢ ܥܠܝܬܐ	Mesopotâmia Superior
ܛܐܪܩ ܥܙܝܙ	Tariq Aziz
ܡܣܘܪܩܐ ܕܪܓܠܐ	Metatarso
ܥܪܩ	Arak
ܫܠܦܐ	Lâmina (ferramenta de corte)
ܛܘܪ ܠܒܢܢ	Monte Líbano
ܐܘܛܪܝܟܛ	Utrecht (desambiguação)
ܩܪܕܘܝܐ	Curdo
ܟܝܢܐ	Natureza (desambiguação)
ܩܕܠܐ	Nuca
ܥܡܐ ܐܬܘܪܝܐ/ܣܘܪܝܝܐ	Assírios
ܛܘܪܐ ܕܣܝܢܝ	Monte Sinai
ܦܘܪܬܥܢܐ	Siphonaptera
ܟܪܘܙܘܬܐ ܕܡܬܝ	Evangelho segundo Mateus
ܡܕܝܢܬܐ ܡܝܬܬܐ	Cidades Mortas (Síria)
ܐܓܪܬܐ ܕܠܘܬ ܐܦܣܝܐ	Epístola aos Efésios
ܚܡܬ	Hama (desambiguação)
10000 (ܡܢܝܢܐ)	Dez mil
ܒܢܦܫܐ	Violeta (cor)
ܢܨܪܬ	Nazaré
ܟܬܒܐ ܕܡܘܪܡܘܢ	Livro de Mórmon
ܐܝܓܢܐܛܝܘܣ ܡܘܫܐ ܩܕܡܝܐ ܕܐܘܕ	Ignace Moussa I Daoud
ܒܫܐܪܐ ܦܛܪܘܣ ܐܠܪܐܥܝ	Béchara Pierre Raï
ܥܡܢܘܐܝܠ ܬܠܝܬܝܐ ܕܠܝ	Emmanuel III Delly
ܥܡܘܕܐ ܦܩܪܝܐ	Coluna vertebral
ܒܝܬ ܫܥܝܐ	Estádio
ܓܘܕ ܫܪܠܘܛ	Good Charlotte
ܒܪ ܨܘܪܐ	Gola
ܚܣܚܘܣܐ	Tecido cartilaginoso
ܡܪܝ ܩܘܪܝܩܘܣ ܣܗܕܐ ܘܕܝܘܠܝܛܐ ܝܡܗ	Santa Julita e São Ciro
ܐܝܣܛܢܒܘܠ (ܗܘܦܪܟܝܐ)	Istambul (província)
ܝܘܢܝܐ	Gregos
ܓܗܢܐ	Geena
ܐܓܢܛܝܘܣ ܝܘܣܦ ܬܠܝܬܝܐ ܝܘܢܢ	Inácio José III Younan
ܡܪܝ ܕܢܚܐ ܪܒܝܥܝܐ	Mar Dinkha IV
ܬܐܓܘܪܬܐ	Comércio
ܫܝܪܢܐܟ (ܗܘܦܪܟܝܐ)	Şırnak (província)
ܟܗܢܘܬܐ	Ordem (sacramento)
ܚܒܘܪ	Rio Khabur
ܗܕܡܐ ܓܘܝܐ	Órgão (anatomia)
ܚܡܬܐ (ܒܝܬܝܘܬܐ)	Sogra
ܡܥܠܘܠܐ	Maalula
ܐܘܪܘܦܐ	Europa (desambiguação)
ܐܣܝܪܝܣܩܐ	Assyriska Fotbollförening
ܥܕܬܐ ܣܘܪܝܝܬܐ ܩܬܘܠܝܩܝܬܐ	Igreja Católica Siríaca
ܥܨܘܒܐ	Cirurgião
ܐܘܣܛܪܠܝܐ	Austrália (desambiguação)
ܡܦܩܬܐ ܦܫܝܛܬܐ	Peshitta
ܐܪܚܘܬܐ	Hospitalidade
ܫܪܓܐ ܕܢܦܛܐ	Lâmpada a óleo
ܗܘܦܪܟܝܣ ܕܥܝܪܐܩ	Províncias do Iraque
ܩܛܠܥܡܐ ܐܬܘܪܝܐ	Genocídio assírio
ܒܝܬ ܟܬܒܐ ܕܐܫܘܪ ܒܢܐܦܠ	Biblioteca de Nínive
ܣܪܦܝܘܢ	Serapião de Tmuis
ܒܕܘܩܐ	Escotismo
ܥܘܕܪܢܐ:ܚܒܝܫܬ̈ܐ	Ajuda:Página principal
ܡܝܟܐܝܠ	Michael
ܣܢܐܓܪܘܬܐ ܕܩܕܝܫܐ	Intercessão
ܐܝܓܢܐܛܝܘܣ ܙܟܝ ܩܕܡܝܐ ܥܝܘܐܨ	Inácio Zakka I Iwas
ܐܣܛܘܡܟܐ	Estômago
ܟܢܘܢܬܐ ܕܪܓܠܐ	Tarso (pé)
ܓܢܬܐ	Jardim
ܒܪܐ (ܐܠܗܐ)	Deus, o Filho
ܐܘܪܗܝ	Edessa (Mesopotâmia)
ܘܝܩܝܦܕܝܐ:ܐܝܙܓܕܘܬܐ	Wikipédia:Embaixada
ܫܠܝܬܐ	Placenta
ܕܘܢܝ ܓܘܪܓ ܝܘܚܢܢ	Donny George Youkhanna
ܒܝܬ ܛܘܣܐ	Aeroporto
ܒܝܬ ܫܡܪܝܐ	Samaria
ܐܓܢܣ ܡܘ	Agnes Monica
ܣܕܪܐ:ܓܪܡܢ	Categoria:Alemanha
ܣܕܪܐ:ܐܝܛܠܝܐ	Categoria:Itália
ܣܕܪܐ:ܐܬܪܘܬܐ ܡܚܝܕܐ ܕܐܡܪܝܩܐ	Categoria:Estados Unidos
ܣܕܪܐ:ܪܘܣܝܐ	Categoria:Rússia
ܣܕܪܐ:ܩܢܕܐ	Categoria:Canadá
ܣܕܪܐ:ܐܝܣܪܐܝܠ	Categoria:Israel
ܣܕܪܐ:ܛܘܪܩܝܐ	Categoria:Turquia
ܣܕܪܐ:ܡܨܪܝܢ	Categoria:Egito
ܣܕܪܐ:ܐܝܪܐܢ	Categoria:Irão
ܥܐܕܐ	Feriado
ܣܕܪܐ:ܥܝܪܐܩ	Categoria:Iraque
ܣܕܪܐ:ܗܘܠܢܕܐ	Categoria:Países Baixos
ܣܕܪܐ:ܦܘܠܢܕ	Categoria:Polónia
ܣܕܪܐ:ܛܝܪܐ	Categoria:Aves
ܣܕܪܐ:ܝܥܝܬܐ	Categoria:Plantas
ܣܕܪܐ:ܬܘܕܝܬܐ	Categoria:Religião
ܣܕܪܐ:ܝܕܥܬܐ	Categoria:Ciência
ܩܘܠ ܬܘܪܗ	Kol Torá
ܦܪܡܬܐ ܕܣܡܠܐ	Massacre de Simele
ܨܘܒܐ	Nusaybin
ܕܪܥܐ (ܗܘܦܪܟܝܐ)	Daraa (distrito)
ܣܕܪܐ ܕܦܛܪܝܪܟܐ ܕܥܕܬܐ ܕܡܕܢܚܐ	Patriarca da Igreja do Oriente
ܩܠܒܐ:Box-footer	Predefinição:Box-footer
ܢܩܘܕ	Niqqud
ܡܪܝܡ (ܚܬܗ ܕܡܘܫܐ)	Miriã
ܣܕܪܐ:ܬܘܚܡܐ ܐܚܪܢܐ	Categoria:Desambiguação
ܣܕܪܐ:ܡܫܝܚܝܘܬܐ	Categoria:Cristianismo
ܣܕܪܐ:ܐܣܠܐܡ	Categoria:Islamismo
ܣܕܪܐ:ܝܗܘܕܝܘܬܐ	Categoria:Judaísmo
ܠܩܐ ܕܣܦܝܢܬܐ	Remo (navegação)
ܬܪܢܓܠܐ	Galo
ܙܚܘܪܝܬܐ (ܓܘܢܐ)	Escarlate
ܐܢܩܪܐ (ܗܘܦܪܟܝܐ)	Ancara (província)
ܐܢܕܪܐܘܣ	André
ܐܝܪܠܢܕ	Irlanda (desambiguação)
ܝܘܢܢ	Jonas (profeta)
ܫܡܐ ܕܝܠܝܕܘܬܐ	Nome de batismo
ܐܨܪܐ	Condimento
ܫܘܫܡܬܐ	Gergelim
ܣܕܪܐ:ܘܝܩܝܦܕܝܐ	Categoria:Categorias
ܣܕܪܐ:ܝܒܫܬܐ	Categoria:Continentes
ܝܙܦܬܐ	Débito
ܟܠܕܝܐ	Cristãos caldeus
ܦܨܝܕܐ	Lagoa
ܐܪܓܘܢܐ	Púrpura
ܢܘܪܢܝܐ	Pirâmide
ܘܝܩܝܦܕܝܐ:HotCat	Wikipédia:Scripts/HotCat
ܒܛܐ	Pato
ܗܝܟܠܐ ܕܫܠܝܡܘܢ	Templo de Jerusalém
ܩܠܒܐ:ܓܕܫܐ ܗܫܝܐ	Predefinição:Eventos atuais
ܣܕܪܐ:ܡܟܬܒܢܘܬܐ ܕܐܬܪܘܬܐ	Categoria:Países
ܘܝܩܝܦܕܝܐ:ܡܕܒܪܢܐ	Wikipédia:Administradores
ܣܕܪܐ:ܫܕܬܐ	Categoria:Ocupações
ܘܝܩܝܦܕܝܐ:ܒܘܬ̈ܐ	Wikipédia:Robôs
ܣܕܪܐ:ܙܒܢܐ	Categoria:Tempo
ܣܕܪܐ:ܙܘܙܐ	Categoria:Dinheiro
ܣܕܪܐ:ܝܘܠܦܢ ܨܪܘܝܘܬܐ	Categoria:Anatomia
ܣܕܪܐ:ܐܣܝܘܬܐ	Categoria:Medicina
ܡܨܪܝܢ	Egito
ܩܠܒܐ:Bot	Predefinição:Robô
ܩܢܕܐ	Canadá
ܣܕܪܐ:ܝܘܢ	Categoria:Grécia
ܣܕܪܐ:ܣܘܝܕ	Categoria:Suécia
ܩܠܒܐ:ܐܫܛܪܘܬܐ	Predefinição:Documentação
ܣܕܪܐ:User languages	Categoria:!Wikipedistas por idioma
ܦܘܠܚܢܐ	Negócio
ܩܠܒܐ:Softredirect	Predefinição:Pseudorredirecionamento
ܩܠܒܐ:Delete	Predefinição:ER
ܡܓܕܠܐ (ܩܪܝܬܐ)	Magdala
ܣܕܪܐ:ܛܟܢܘܠܘܓܝܐ	Categoria:Tecnologia
ܓܒܪܐܝܠ (ܫܡܐ)	Gabriel
ܣܕܪܐ:ܠܫܢܐ	Categoria:Línguas
ܣܕܪܐ:ܩܢܘܢܐ ܕܠܥܙܐ	Categoria:Gramática
ܘܝܩܝܦܕܝܐ:General disclaimer	Wikipédia:Aviso geral
ܣܕܪܐ:Noindexed pages	Categoria:!Páginas não indexadas
ܘܝܩܝܦܕܝܐ:ܕܘܒܪܐ	Wikipédia:Livro de estilo
ܩܠܒܐ:Navbox	Predefinição:Navbox
ܣܕܪܐ:ܩܠܒܐ ܐܬܘܬܐ ܕܐܝܣܘ	Categoria:!Predefinições sobre bandeiras
ܩܠܒܐ:ܡܦܐܬܐ ܩܠܒܐ	Predefinição:Tnavbar
ܩܠܒܐ:Clear	Predefinição:Limpar
ܘܝܩܝܦܕܝܐ:ܡܟܬܒܘܬܐ ܕܡܓܠܐ ܠܟܠ ܘܝܩܝܦܕܝܐ	Wikipédia:Artigos essenciais
ܣܕܪܐ:ܐܠܝܩܛܪܘܢܝܘܬܐ	Categoria:Eletrônica
ܣܕܪܐ:ܝܪܚܐ ܕܫܢܬܐ	Categoria:Meses
ܩܠܒܐ:Babel	Predefinição:Babel
ܩܠܒܐ:Commons	Predefinição:Commons
ܩܠܒܐ:Reflist	Predefinição:Referências
ܩܠܒܐ:User ar-1	Predefinição:User ar-1
ܩܠܒܐ:User az	Predefinição:User az
ܩܠܒܐ:See also	Predefinição:VT
ܩܠܒܐ:User de	Predefinição:User de
ܩܠܒܐ:User es	Predefinição:User es
ܩܠܒܐ:User en-3	Predefinição:User en-3
ܩܠܒܐ:User en-1	Predefinição:User en-1
ܩܠܒܐ:User en-2	Predefinição:User en-2
ܩܠܒܐ:User en-4	Predefinição:User en-4
ܩܠܒܐ:User en-0	Predefinição:User en-0
ܩܠܒܐ:User en	Predefinição:User en
ܩܠܒܐ:User fa	Predefinição:User fa
ܩܠܒܐ:User fr-1	Predefinição:User fr-1
ܩܠܒܐ:User he-2	Predefinição:User he-2
ܩܠܒܐ:User he-1	Predefinição:User he-1
ܩܠܒܐ:User sk	Predefinição:User sk
ܩܠܒܐ:User tr	Predefinição:User tr
ܩܠܒܐ:User ja	Predefinição:User ja
ܩܠܒܐ:User fr	Predefinição:User fr
ܩܠܒܐ:User he	Predefinição:User he
ܣܕܪܐ:ܐܣܝܐ	Categoria:Ásia
ܣܕܪܐ:ܕܪܐ ܕܥܣܪܝܢ ܘܚܕ	Categoria:Século XXI
ܩܠܒܐ:Mod	Predefinição:Mod
ܩܠܒܐ:User sv	Predefinição:User sv
ܩܠܒܐ:Infobox language/codelist	Predefinição:ISO639-3Documentação
ܩܠܒܐ:User it	Predefinição:User it
ܣܕܪܐ:ܝܘܡܐ ܕܫܒܘܥܐ	Categoria:Dias da semana
ܣܕܪܐ:ܐܨܪܐ	Categoria:Condimentos
ܩܠܒܐ:ܝܗܘܝܬܐ Peru	Predefinição:Country data Peru
ܩܠܒܐ:ܝܗܘܝܬܐ Paraguay	Predefinição:Country data Paraguai
ܩܠܒܐ:ܝܗܘܝܬܐ French Guiana	Predefinição:Country data Guiana
ܩܠܒܐ:ܝܗܘܝܬܐ Argentina	Predefinição:Country data Argentina
ܩܠܒܐ:Navbox suite	Predefinição:Navbox suite
ܩܠܒܐ:ܡܟܬܒܢܘܬܐ ܕܝܦܬܐ	Predefinição:Collapsible list
ܩܠܒܐ:Sidebar	Predefinição:Sidebar
ܩܠܒܐ:Ambox	Predefinição:Ambox
ܩܠܒܐ:Navigation templates	Predefinição:Modelo de navegação
ܩܠܒܐ:ܐܬܪܐ	Predefinição:Info/País
ܩܠܒܐ:ܝܬܝܪ	Predefinição:Catmore
ܩܠܒܐ:/box-header	Portal:Box-header
ܣܕܪܐ:User en	Categoria:Usuários en
ܣܕܪܐ:User zh	Categoria:Usuários zh
ܣܕܪܐ:User zh-N	Categoria:Usuário zh
ܩܠܒܐ:ܨܢܕܘܩ ܪܡܙܐ2	Predefinição:Info
ܩܠܒܐ:User zh	Predefinição:User zh
ܩܠܒܐ:Navbox/core	Predefinição:Navbox/core
ܩܠܒܐ:ܩܠܒܐ ܐܚܪܝܢܐ	Predefinição:Template other
ܩܠܒܐ:ܐܠܦܒܝܬ ܠܐܛܝܢܝܐ	Predefinição:A-Z
ܣܕܪܐ:ܦܐܦܐ	Categoria:Papas
ܩܠܒܐ:Pp-template	Predefinição:Pp-template
ܩܠܒܐ:User nl-1	Predefinição:User nl-1
ܩܠܒܐ:User nl-2	Predefinição:User nl-2
ܣܕܪܐ:ܪܝܫܝ ܩܘܛܢܝܘܬܐ	Categoria:Presidentes
ܩܠܒܐ:User ru	Predefinição:User ru
ܩܠܒܐ:IPA	Predefinição:AFI
ܣܕܪܐ:ܗܪܘܡܐ	Categoria:Especiarias
ܣܕܪܐ:ܦܠܫܬ	Categoria:Palestina
ܣܕܪܐ:ܡܠܐܟܐ	Categoria:Anjos
ܣܕܪܐ:ܢܒܝܐ	Categoria:Profetas
ܩܠܒܐ:Rellink	Predefinição:Rellink
ܩܠܒܐ:Category redirect	Predefinição:Redirecionamento de categoria
ܩܠܒܐ:ܝܗܘܝܬܐ Venezuela	Predefinição:Country data Venezuela
ܩܠܒܐ:ܨܢܕܘܩ ܡܕܒܪܢܐ	Predefinição:Info/Político
ܩܠܒܐ:Sortname	Predefinição:Sortname
ܩܠܒܐ:Border	Predefinição:Borda
ܩܠܒܐ:ܡܢܝܢܐ ܕܝܪܚܐ	Predefinição:MONTHNUMBER
ܩܠܒܐ:ܪܕ	Predefinição:Fmbox
ܩܠܒܐ:ܝܗܘܝܬܐ Chile	Predefinição:Country data Chile
ܩܠܒܐ:GUA	Predefinição:GTM
ܩܠܒܐ:User nl	Predefinição:User nl
ܩܠܒܐ:Navbox years	Predefinição:NavboxAnos
ܩܠܒܐ:ܡܣܦܩ ܩܐܫ	Predefinição:Purgar
ܩܠܒܐ:ܨܢܕܘܩ ܐܡܢܐ	Predefinição:Info/Artista
ܩܠܒܐ:ܡܦܠܚܢܐ	Predefinição:Usuário2
ܣܕܪܐ:ܬܘܢܣ	Categoria:Tunísia
ܩܠܒܐ:Sec link auto	Predefinição:Sec link auto
ܩܠܒܐ:Cmbox	Predefinição:Cmbox
ܩܠܒܐ:Mbox	Predefinição:Mbox
ܩܠܒܐ:Oppose	Predefinição:Discordo
ܩܠܒܐ:COL	Predefinição:COL
ܩܠܒܐ:PER	Predefinição:PER
ܩܠܒܐ:ܨܢܕܘܩ ܡܕܥܐ ܕܝܒܫܬܐ	Predefinição:Info/Território geográfico
ܩܠܒܐ:User ar-2	Predefinição:User ar-2
ܩܠܒܐ:User ar-3	Predefinição:User ar-3
ܩܠܒܐ:User ar	Predefinição:User ar
ܩܠܒܐ:ܝܘܡܐ ܕܫܒܘܥܐ	Predefinição:Dias da semana
ܣܕܪܐ:ܡܕܝܢܬܐ ܒܐܘܚܕܢܐ ܡܚܝܕܐ	Categoria:Cidades dos Estados Unidos
ܩܠܒܐ:ܬ.ܐ.	Predefinição:Desambiguação
ܩܠܒܐ:No	Predefinição:Negado
ܣܕܪܐ:ܩܠܒܐ ܨܢܕܘܩܐ	Categoria:!Predefinições de caixas de informação
ܩܠܒܐ:Partial	Predefinição:Partial
ܩܠܒܐ:ܩܘܕܝܟܘܣ ܕܣܕܪܐ	Predefinição:CategoriaTOC
ܩܠܒܐ:?	Predefinição:?
ܩܠܒܐ:ܝܗܘܝܬܐ Colombia	Predefinição:Country data Colômbia
ܩܠܒܐ:ܐܠܦܒܝܬ ܥܒܪܝܐ	Predefinição:Alfabeto hebraico
ܣܕܪܐ:User az	Categoria:Usuários az
ܣܕܪܐ:User sk	Categoria:Usuários sk
ܣܕܪܐ:User fr	Categoria:Usuários fr
ܣܕܪܐ:User ja	Categoria:Usuários ja
ܣܕܪܐ:User la	Categoria:Usuários la
ܣܕܪܐ:User pt	Categoria:Usuários pt
ܣܕܪܐ:User ro	Categoria:Usuários ro
ܣܕܪܐ:User sv	Categoria:Usuários sv
ܣܕܪܐ:User ko-N	Categoria:Usuário ko
ܣܕܪܐ:ܗܘܦܪܟܝܣ ܕܥܝܪܐܩ	Categoria:Províncias do Iraque
ܩܠܒܐ:Cat main	Predefinição:Cat principal
ܣܕܪܐ:User ar	Categoria:Usuários ar
ܣܕܪܐ:User da	Categoria:Usuários da
ܣܕܪܐ:User sk-N	Categoria:Usuário sk
ܣܕܪܐ:User de	Categoria:Usuários de
ܣܕܪܐ:User el	Categoria:Usuários el
ܣܕܪܐ:User en-N	Categoria:Usuário en
ܣܕܪܐ:User es	Categoria:Usuários es
ܣܕܪܐ:User fa	Categoria:Usuários fa
ܣܕܪܐ:User fi	Categoria:Usuários fi
ܣܕܪܐ:User he	Categoria:Usuários he
ܩܠܒܐ:N/a	Predefinição:N/a
ܣܕܪܐ:User hy	Categoria:Usuários hy
ܣܕܪܐ:ܠܫܢܐ ܥܒܪܝܐ	Categoria:Língua hebraica
ܣܕܪܐ:ܡܕܝܢܬܐ ܒܐܝܣܪܐܝܠ	Categoria:Cidades de Israel
ܣܕܪܐ:User it	Categoria:Usuários it
ܣܕܪܐ:User ko	Categoria:Usuários ko
ܣܕܪܐ:ܒܬܫܪܝܢ ܐܚܪܝ	Categoria:Novembro
ܣܕܪܐ:ܝܡܡܐ	Categoria:Mares
ܩܠܒܐ:ܐܠܦܒܝܬ ܝܘܢܝܐ	Predefinição:Letras gregas
ܩܠܒܐ:No2	Predefinição:Não2
ܩܠܒܐ:Languages	Predefinição:Babel línguas
ܩܠܒܐ:Rh	Predefinição:Rh
ܩܠܒܐ:ܡܢܝܢܐ ܕܡܡܪܐ ܦܪܝܫܐ	Predefinição:Número de artigos destacados
ܩܠܒܐ:ܣܡܘܩܐ	Predefinição:Vermelho
ܩܠܒܐ:ܝܗܘܝܬܐ Brazil	Predefinição:Country data Brasil
ܩܠܒܐ:Yes2	Predefinição:Sim2
ܩܠܒܐ:Yes-No	Predefinição:Sim-Não
ܬܪܥܐ:ܬܘܕܝܬܐ	Portal:Religião
ܣܕܪܐ:ܪܝܫܝ ܩܘܛܢܝܘܬܐ ܥܠ ܐܬܪܐ	Categoria:Presidentes por país
ܣܕܪܐ:User ru	Categoria:Usuários ru
ܣܕܪܐ:User ru-3	Categoria:Usuário ru-3
ܣܕܪܐ:User tl	Categoria:Usuários tl
ܣܕܪܐ:User tr	Categoria:Usuários tr
ܣܕܪܐ:ܙܡܪܐ	Categoria:Músicos
ܩܠܒܐ:Lang	Predefinição:Lang
ܣܕܪܐ:ܪܫܘܡܐ	Categoria:Pintores
ܩܠܒܐ:ܫܠܝܚܐ ܕܡܫܝܚܐ	Predefinição:Apóstolos
ܩܠܒܐ:ܟܬܒܐ ܩܕܝܫܐ	Predefinição:Bíblia
ܣܕܪܐ:ܐܡܢܐ ܥܠ ܐܕܫܐ	Categoria:Ocupações por tipo
ܩܠܒܐ:ܚܡܫܐ ܐܘܩܝܢܘ	Predefinição:Oceanos
ܩܠܒܐ:CHI	Predefinição:CHL
ܣܕܪܐ:ܡܕܝܢܬܐ ܒܐܢܓܠܢܕ	Categoria:Cidades da Inglaterra
ܣܕܪܐ:ܢܝܓܪ	Categoria:Níger
ܣܕܪܐ:ܦܛܪܝܪܟܘ ܕܥܕܬܐ ܕܡܕܢܚܐ	Categoria:Patriarcas da Igreja do Oriente
ܩܠܒܐ:Infobox language/family-color	Predefinição:Info/Língua/corfamília
ܣܕܪܐ:ܣܥܪܐ	Categoria:Penteados
ܣܕܪܐ:ܢܗܪܘܬܐ	Categoria:Rios
ܩܠܒܐ:User he-3	Predefinição:User he-3
ܩܠܒܐ:User ko	Predefinição:User ko
ܩܠܒܐ:User pt	Predefinição:User pt
ܣܕܪܐ:User nl	Categoria:Usuários nl
ܣܕܪܐ:User no	Categoria:Usuários no
ܣܕܪܐ:ܣܘܪܝܐ	Categoria:Síria
ܣܕܪܐ:ܕܪܐ ܩܕܡܝܐ	Categoria:Século I
ܣܕܪܐ:ܓܙܪܬܐ ܝܒܫܢܝܬܐ	Categoria:Penínsulas
ܣܕܪܐ:ܗܘܦܪܟܝܣ ܕܗܘܠܢܕܐ	Categoria:Províncias dos Países Baixos
ܣܕܪܐ:ܡܢܝܢܐ	Categoria:Inteiros
ܣܕܪܐ:ܡܕܝܢܬܐ ܕܥܝܪܐܩ	Categoria:Cidades do Iraque
ܣܕܪܐ:ܥܝܢܐ (ܨܪܘܝܘܬܐ)	Categoria:Olho
ܣܕܪܐ:ܓܘܪܓܝܐ	Categoria:Geórgia
ܣܕܪܐ:ܟܘܘܝܬ	Categoria:Kuwait
ܣܕܪܐ:ܠܒܢܢ	Categoria:Líbano
ܣܕܪܐ:ܪܝܫܝ ܩܘܛܢܝܘܬܐ ܕܐܬܪܘܬܐ ܡܚܝܕܐ ܕܐܡܪܝܩܐ	Categoria:Presidentes dos Estados Unidos
ܣܕܪܐ:ܝܘܪܕܢܢ	Categoria:Jordânia
ܣܕܪܐ:ܦܐܪܐ	Categoria:Frutos
ܣܕܪܐ:ܝܘܠܦܢ ܟܘܪܗܢܐ	Categoria:Patologia
ܣܕܪܐ:ܓܒܐ	Categoria:Partidos políticos
ܣܕܪܐ:ܕܝܬܝܩܝ ܚܕܬܐ	Categoria:Novo Testamento
ܣܕܪܐ:ܕܝܬܝܩܝ ܥܬܝܩܬܐ	Categoria:Antigo Testamento
ܣܕܪܐ:ܐܘܩܝܢܘ	Categoria:Oceanos
ܣܕܪܐ:ܓܪܡܐ	Categoria:Sistema esquelético
ܣܕܪܐ:ܗܘܦܪܟܝܣ ܘܐܘܚܕܢܐ ܕܩܢܕܐ	Categoria:Territórios do Canadá
ܣܕܪܐ:ܚܝܘܬܐ	Categoria:Animais
ܣܕܪܐ:ܛܘܪܐ	Categoria:Cordilheiras
ܣܕܪܐ:ܣܘܥܪܢܐ	Categoria:Eventos
ܣܕܪܐ:ܟܘܪܗܢܐ	Categoria:Doenças
ܣܕܪܐ:User pl	Categoria:Usuários pl
ܣܕܪܐ:ܩܣܪ	Categoria:Imperadores
ܣܕܪܐ:ܡܕܒܪܐ	Categoria:Desertos
ܣܕܪܐ:ܝܡܡܬܐ	Categoria:Lagos
ܩܠܒܐ:ܨܢܕܘܩ ܡܚܡܝܬܐ ܡܨܥܝܐ	Predefinição:Info/Mídia
ܩܠܒܐ:ܨܢܕܘܩ ܪܡܙܐ ܕܠܫܢܐ	Predefinição:Info/Língua
ܣܕܪܐ:ܩܛܠܥܡܐ	Categoria:Massacres
ܨܝܢ	China (desambiguação)
ܛܪܘܝܐܢܝ	Trojany
ܩܠܒܐ:Sister	Predefinição:Irmão
ܣܕܪܐ:ܦܛܪܝܪܟܘ ܕܥܕܬܐ ܕܡܕܢܚܐ ܕܐܬܘܪܝܐ	Categoria:Patriarcas da Igreja Assíria do Oriente
ܣܕܪܐ:ܦܛܪܝܪܟܘ ܕܥܕܬܐ ܟܠܕܝܬܐ ܩܬܘܠܝܩܝܬܐ	Categoria:Patriarcas da Igreja Católica Caldeia
ܩܠܒܐ:ܝܗܘܝܬܐ Falkland Islands	Predefinição:Country data Ilhas Malvinas
ܣܕܪܐ:ܦܛܪܝܪܟܘ	Categoria:Patriarcas
ܣܕܪܐ:ܒܝܬ ܟܬܒܐ	Categoria:Bibliotecas
ܣܕܪܐ:ܫܢܬܐ ܥܕܬܢܝܬܐ	Categoria:Ano litúrgico
ܣܕܪܐ:ܐܪܙܐ	Categoria:Sacramentos
ܣܕܪܐ:ܒܝܬ ܢܗܪܝܢ	Categoria:Mesopotâmia
ܣܕܪܐ:ܓܘܢܐ	Categoria:Cor
ܩܠܒܐ:ܝܗܘܝܬܐ South Georgia and the South Sandwich Islands	Predefinição:Country data Ilhas Geórgia do Sul e Sandwich do Sul
ܣܕܪܐ:ܦܣܩܐ ܕܝܘܡܐ	Categoria:Partes de um dia
ܣܕܪܐ:ܛܪܘܢܐ	Categoria:Ditadores
ܣܕܪܐ:ܦܛܪܝܪܟܘ ܕܥܕܬܐ ܣܘܪܝܝܬܐ ܐܪܬܘܕܟܣܝܬܐ	Categoria:Patriarcas ortodoxos siríacos de Antioquia
ܕܒܘܪܐ (ܪܚܫܐ)	Vespa
ܩܠܒܐ:ܣܘܪܓܕܐ ܚܘܫܒܢܐ	Predefinição:Outros calendários
ܣܕܪܐ:ܩܕܝܫܐ	Categoria:Santos
ܩܪܕܐ (ܪܚܫܐ)	Ixodida
ܩܠܒܐ:ܣܝܩܘܡ ܫܘܪܝܐ	Predefinição:Data de início
ܩܠܒܐ:User nl-3	Predefinição:User nl-3
ܩܠܒܐ:Tim	Predefinição:Tim
ܩܠܒܐ:P1	Predefinição:P1
ܢܘܓܗܐ	Madrugada
ܩܠܒܐ:Sec link/text	Predefinição:Sec link/text
ܘܝܩܝܦܕܝܐ:NavFrame	Wikipédia:NavFrame
ܩܠܒܐ:Infobox language/genetic	Predefinição:Info/Língua/genetic2
ܟܘܕܐ	Lóquio
ܕܝܠܢܝܐ:ܫܘܚܠܦ̈ܐ ܚܕ̈ܬܐ	Especial:Mudanças recentes
ܘܙܐ	Ganso
