Saot Amerika	América do Sul
Norway	Noruega
Ireland	República da Irlanda
Hungary	Hungria
Spain	Espanha
Yunaeted Stet blong Amerika	Estados Unidos
Belgium	Bélgica
Luxembourg	Luxemburgo
Finland	Finlândia
Sweden	Suécia
Denmark	Dinamarca
Poland	Polónia
Litwania	Lituânia
Itali	Itália
Switzerland	Suíça
Austria	Áustria
Greece	Grécia
Turkey	Turquia
Portugal	Portugal
Yurop	Europa
Esia	Ásia
Wikipedia	Wikipédia
Netherlands	Países Baixos
Berlin	Berlim
Barak Obama	Barack Obama
Uruguay	Uruguai
London	Londres
Paris	Paris
Mexico	México
Pasifik	Oceano Pacífico
Kalifornia	Califórnia
Boston, Massachusetts	Boston
Franis	França
Unaeted Kingdom	Reino Unido
China	República Popular da China
Brazil	Brasil
Rusia	Rússia
Alabama	Alabama
Germany	Alemanha
Belarus	Bielorrússia
Iceland	Islândia
Estonia	Estónia
David Cameron	David Cameron
Wan	Um
Tu	Dois
Tri	Três
Fo	Quatro
Faef	Cinco
Latvia	Letónia
Ukraine	Ucrânia
Czechia	República Checa
Slovakia	Eslováquia
Slovenia	Eslovénia
Vilnius	Vilnius
Moldova	Moldávia
Romania	Roménia
Bulgaria	Bulgária
Rome	Roma
Macedonia	República da Macedónia
Albania	Albânia
Croatia	Croácia
Bosnia and Herzegovina	Bósnia e Herzegovina
Azerbaijan	Azerbaijão
Andorra	Andorra
Cyprus	Chipre
Georgian Republic	Geórgia
Kazakhstan	Cazaquistão
Malta	Malta
Monaco	Mónaco
Montenegro	Montenegro
Vatican Siti	Vaticano
San Marino	San Marino
Indonesia	Indonésia
Warsaw	Varsóvia
Wota	Água
Chile	Chile
Jisas Kraes	Jesus
Nicolas Sarkozy	Nicolas Sarkozy
Singapore	Singapura
Saens	Ciência
Liechtenstein	Liechtenstein
Spot	Desporto
Wol Wo Tu	Segunda Guerra Mundial
Armenia	Arménia
Serbia	Sérvia
Ostrelia	Austrália
Argentina	Argentina
Peru	Peru
Baeoloji	Biologia
Islam	Islão
Boteni	Botânica
Flaoa	Flor
Wikimidia Commons	Wikimedia Commons
Moskow	Moscovo
San-Peterburg	São Petersburgo
Niu Zilan	Nova Zelândia
India	Índia
Aean	Ferro
Ripablik blong Vanuatu	Vanuatu
Papua New Guinea	Papua-Nova Guiné
Venezuela	Venezuela
Maine	Maine
Animol	Animalia
Paraguay	Paraguai
Colombia	Colômbia
Budisim	Budismo
Bolivia	Bolívia
Niu Hampshire	Nova Hampshire
Massachusetts	Massachusetts
Connecticut	Connecticut
Hawaii	Havaí
Alaska	Alasca
Florida	Flórida
Arizona	Arizona
Laos	Laos
Oregon	Oregon
Yuta	Utah
Burma	Myanmar
Vietnam	Vietname
Saot Koria	Coreia do Sul
Bangladesh	Bangladesh
Bhutan	Butão
Twitter	Twitter
Julius Caesar	Júlio César
Yunaeted Nesen	Organização das Nações Unidas
Jiografi	Geografia
Bren	Cérebro
Prague	Praga
Michigan	Michigan
Illinois	Illinois
Not Dakota	Dakota do Norte
Saut Dakota	Dakota do Sul
Montana	Montana
Wyoming	Wyoming
Giorgio Napolitano	Giorgio Napolitano
Idaho	Idaho
Washington (Bundesstaat)	Washington
Nevada	Nevada
Colorado	Colorado
Delhi	Deli
Virginia	Virgínia
West Virginia	Virgínia Ocidental
Niu York (Bundesstaat)	Nova Iorque (estado)
Rhode Island	Rhode Island
Maryland	Maryland
Delaware	Delaware
Ohio	Ohio
Pennsylvania	Pensilvânia
Uetersen	Uetersen
Augustus	Augusto
Niu Yersey	Nova Jérsia
Indiana	Indiana
Georgia	Geórgia (Estados Unidos)
Texas	Texas
Not Carolina	Carolina do Norte
Saut Carolina	Carolina do Sul
Barcelona	Barcelona
Mississippi	Mississippi
Tennessee	Tennessee
Niu Mexico	Novo México
Minnesota	Minnesota
Caracas	Caracas
Wisconsin	Wisconsin
Iowa	Iowa
Nebraska	Nebraska
Kansas	Kansas
Hindi	Língua hindi
Missouri	Missouri
Louisiana	Luisiana
Kentucky	Kentucky
Arkansas	Arkansas
Oklahoma	Oklahoma
Vienna	Viena
Stockholm	Estocolmo
Wrocław	Breslávia
Baebol	Bíblia
Ho Chi Minh City	Cidade de Ho Chi Minh
Tru Jisas Jioj	Verdadeira Igreja de Jesus
Andorra la Vella	Andorra-a-Velha
Dong Hoi	Dong Hoi
Concepción	Concepción (Chile)
Końskowola	Końskowola
Kurów	Kurów
Kemistri	Química
Madrid	Madrid
Sydney	Sydney
Delmenhorst	Delmenhorst
Osasco	Osasco
Curitiba	Curitiba
Confucius	Confúcio
Category:Matematikis	Categoria:Matemática
Faroe aelan	Ilhas Feroe
Kristaniti	Cristianismo
Céline Dion	Céline Dion
Kontinen	Continente
Kapitol	Capital
Monzón	Monzón
Almazán	Almazán
Huang Xianfan	Huang Xianfan
Nambawan Pej	Wikipédia:Página principal
Template:Gud atikel	Predefinição:Artigo bom
Category:Candidates for speedy deletion	Categoria:!Páginas para eliminação rápida
Kaontri	País
Indianapolis, Indiana	Indianápolis
Elmshorn	Elmshorn
Qin Shi Huang	Qin Shihuang
Ae	Olho
Kamel	Camelo
Obesin	Beringela
Dakdak	Anatidae
Toktok Rusia	Língua russa
Nelson Mandela	Nelson Mandela
Volkeno	Vulcão
Bigwin	Ciclone tropical
Category:Franis	Categoria:França
Kofi	Café
Seoul	Seul
Toktok Ukraine	Língua ucraniana
Dipsi	Oceano
Buddha	Sidarta Gautama
Muhammed	Maomé
Martin Luther	Martinho Lutero
Michael Schumacher	Michael Schumacher
Elisabet II	Isabel II do Reino Unido
Ronald Reagan	Ronald Reagan
Fernando Alonso	Fernando Alonso
Gordon Brown	Gordon Brown
Category:Venezuela	Categoria:Venezuela
Lugo	Lugo (Galiza)
Category:Brazil	Categoria:Brasil
Oktri	Carvalho
Kanal	Canal
Leji	Litchi chinensis
Kokonas	Coqueiro
Santiago de Compostela	Santiago de Compostela
Oviedo	Oviedo
Mérida	Mérida (Espanha)
Template:Link FA	Predefinição:Link FA
Busan	Busan
Vermont	Vermont
Denver, Colorado	Denver
Phoenix, Arizona	Phoenix (Arizona)
Austin, Texas	Austin
Columbus, Ohio	Columbus (Ohio)
Flaeg blong Rusia	Bandeira da Rússia
Sacramento, Kalifornia	Sacramento (Califórnia)
Honolulu, Hawaii	Honolulu
Providence, Rhode Island	Providence
Naen	Nove
Bien Hoa	Bien Hoa
Nha Trang	Nha Trang
Rafael Correa	Rafael Correa
Wikipedia:Gud atikel	Wikipédia:Artigos bons
Breinigerberg	Breinigerberg
Moai	Moai
Daejeon	Daejeon
Sejong	Cidade de Sejong
Incheon	Incheon
Nashville, Tennessee	Nashville (Tennessee)
Sol Lek Siti	Salt Lake City
Seven	Sete
Eit	Oito
Lord's Prayer	Pai Nosso
Galik	Alho
Kukamba	Pepino
Sikis	Seis
Moshchena	Mostchena
Paltoga	Paltoga
Santiago de los Caballeros de Mérida	Mérida (Venezuela)
Atlanta, Georgia	Atlanta
Ten	Dez
Albany, Niu York	Albany (Nova Iorque)
Ca Mau	Cà Mau (cidade)
Harrisburg, Pennsylvania	Harrisburg
Da Lat	Da Lat
Phan Thiet	Phan Thiet
Hoknaet	Coruja-das-torres
Antoni Gaudí	Antoni Gaudí
Trenton, Niu Yersey	Trenton (Nova Jersey)
Thai Nguyen	Thái Nguyên (cidade)
Jefferson City, Missouri	Jefferson City
Jackson, Mississippi	Jackson (Mississippi)
Augusta, Maine	Augusta (Maine)
Baton Rouge, Louisiana	Baton Rouge
Lansing, Michigan	Lansing
Concord, New Hampshire	Concord (Nova Hampshire)
Lincoln, Nebraska	Lincoln (Nebraska)
Annapolis, Maryland	Annapolis (Maryland)
Springfield, Illinois	Springfield (Illinois)
Frankfort, Kentucky	Frankfort (Kentucky)
Saint Paul, Minnesota	Saint Paul (Minnesota)
Montgomery, Alabama	Montgomery (Alabama)
Juneau, Alaska	Juneau
Zhengzhou	Zhengzhou
Avril Lavigne	Avril Lavigne
Little Rock, Arkansas	Little Rock
Buon Ma Thuot	Buon Ma Thuot
Hartford, Connecticut	Hartford
Dover, Delaware	Dover (Delaware)
Tok Pisin	Língua tok pisin
Anastacia	Anastacia
Yufreres	Rio Eufrates
Vinh Long	Vinh Long (cidade)
Tequixquiac	Tequixquiac
Oklahoma City, Oklahoma	Oklahoma City
Bislama	Língua bislamá
Boise, Idaho	Boise
Al Bayda	Al Bayda' (Líbia)
Bambu	Bambu
Port Moresby	Port Moresby
Ben Tre	Ben Tre (cidade)
Arancón	Arancón
Twelef	Doze
Tallahassee, Florida	Tallahassee
Bismarck, Not Dakota	Bismarck (Dacota do Norte)
Leven	Onze
Avoka	Persea americana
Cleveland, Ohio	Cleveland
John Calvin	João Calvino
Sint-Truiden	Sint-Truiden
Port Vila	Port Vila
Auckland Grammar School	Auckland Grammar School
Angers	Angers
Columbia, Saut Carolina	Colúmbia (Carolina do Sul)
Santa Fe, Niu Mexico	Santa Fé (Novo México)
Helena, Montana	Helena (Montana)
Des Moines, Iowa	Des Moines
Ágreda	Ágreda
Nawita	Polvo
Pierre, Saut Dakota	Pierre (Dakota do Sul)
Carson City, Nevada	Carson City
Topeka, Kansas	Topeka
Raleigh, Not Carolina	Raleigh (Carolina do Norte)
Ulsan	Ulsan
Gwangju	Gwangju
Grepfrut	Toranja
Julia Gillard	Julia Gillard
Hamlet	Hamlet
Sebastian Vettel	Sebastian Vettel
Kevin Rudd	Kevin Rudd
Montehermoso	Montehermoso
Salem, Oregon	Salem (Oregon)
Josef Smit	Joseph Smith Jr.
Oganaesesen blong ol Leba Raonwol	Organização Internacional do Trabalho
Namba	Numeral
Coronel Fabriciano	Coronel Fabriciano
Alla Pugacheva	Alla Pugacheva
Flaeg blong Azerbaijan	Bandeira do Azerbaijão
Sompiniong	Cogumelo
Dziecinów	Dziecinów (comuna de Otwock)
Gdov	Gdov
Blumak	Acanthurus lineatus
François Arago	François Arago
Memba Kaontri blong Unaeted Neisen	Estados-membros das Nações Unidas
Natanggura	Cycas revoluta
St Peter's College (Auckland)	St Peter's College, Auckland
Alan García	Alan García
John Wycliffe	John Wycliffe
Caltojar	Caltojar
God	Deidade
Flaeg blong Vanuatu	Bandeira de Vanuatu
Chang Myon	Chang Myon
Lou Reed	Lou Reed
Yun Chi-ho	Yun Chi-ho
Robert Gates	Robert Gates
William Tyndale	William Tyndale
Ana Paula Arósio	Ana Paula Arósio
Apaxco	Apaxco
Nagorno-Karabakh Republic	República do Nagorno-Karabakh
Efate	Éfaté
Yumi, Yumi, Yumi	Yumi, Yumi, Yumi
Kalkot Mataskelekele	Kalkot Mataskelekele
Michael Somare	Michael Somare
Lluís Domènech i Montaner	Lluís Domènech i Montaner
Bry-sur-Marne	Bry-sur-Marne
Almaluez	Almaluez
Jacint Verdaguer	Jacint Verdaguer
Ambae Aelan	Ambae
Buk Blong Momon	Livro de Mórmon
Coritiba Foot Ball Club	Coritiba Foot Ball Club
Aliud	Aliud
Baraona	Baraona
Blufis	Peixe-papagaio
Tornesch	Tornesch
Markdorf	Markdorf
Tafea	Tafea
Shefa	Shefa
Ivan Zaytsev	Ivan Zaytsev
Sanma	Sanma
Malampa	Malampa
Yonawa	Jonava
Grin pijin	Ptilinopus
Sigal	Gaivota-prata
Torba	Torba
Almarza	Almarza
Aldealices	Aldealices
Aldealafuente	Aldealafuente
Alentisque	Alentisque
Adradas	Adradas
Abejar	Abejar
Almajano	Almajano
Arenillas	Arenillas
Aldealpozo	Aldealpozo
Alcubilla de las Peñas	Alcubilla de las Peñas
Aldealseñor	Aldealseñor
Alcubilla de Avellaneda	Alcubilla de Avellaneda
Casarejos	Casarejos
Almazul	Almazul
Alpanseque	Alpanseque
Arcos de Jalón	Arcos de Jalón
Aldehuela de Periáñez	Aldehuela de Periáñez
Almenar de Soria	Almenar de Soria
Ausejo de la Sierra	Ausejo de la Sierra
Arévalo de la Sierra	Arévalo de la Sierra
Las Aldehuelas	Las Aldehuelas
Bliecos	Bliecos
Blacos	Blacos
Penama	Penama
Barca	Barca (Espanha)
Santiago Tequixquiac	Santiago Tequixquiac
Luganville	Luganville
Josias Moli	Josias Moli
Kakao	Cacau em pó
Isangel	Isangel
Smalfala grin pijin	Ptilinopus greyii
Bigfala grin pijin	Ptilinopus tannensis
Pornopedia	Pornopedia
Category:Germany	Categoria:Alemanha
Category:Itali	Categoria:Itália
Category:Yunaeted Stet blong Amerika	Categoria:Estados Unidos
Category:Rusia	Categoria:Rússia
Category:Kanada	Categoria:Canadá
Category:United Kingdom	Categoria:Reino Unido
Category:Spain	Categoria:Espanha
Category:China	Categoria:China
Category:India	Categoria:Índia
Category:Niu Zilan	Categoria:Nova Zelândia
Sola	Sola (Vanuatu)
Category:Bangladesh	Categoria:Bangladesh
Category:Poland	Categoria:Polónia
Category:Saot Koria	Categoria:Coreia do Sul
Category:Ukraine	Categoria:Ucrânia
Category:Vietnam	Categoria:Vietname
Category:Pijin	Categoria:Aves
Category:Baeoloji	Categoria:Biologia
Category:Histri	Categoria:História
Category:Jiografi	Categoria:Geografia
Category:Sosaeti	Categoria:Sociedade
Category:Rilijin	Categoria:Religião
Category:Saens	Categoria:Ciência
Category:Yunaeted Nesen	Categoria:Nações Unidas
Category:Budisim	Categoria:Budismo
Category:Kristaniti	Categoria:Cristianismo
Category:Islam	Categoria:Islamismo
Bochotnica	Bochotnica
Benedicta Boccoli	Benedicta Boccoli
Maria Ribeiro	Maria Ribeiro
Category:Wikipedia Manejmen	Categoria:!Administração da Wikipédia
Category:Kultur	Categoria:Cultura
Category:Kontinen	Categoria:Continentes
Fas Presidensi	Primeira Presidência
Bigfala Apostasi	Grande Apostasia
Helena Ranaldi	Helena Ranaldi
Leandra Leal	Leandra Leal
Annarita Del Piano	Anna Rita Del Piano
Category:Pipol blong Yunaeted Stet blong Amerika	Categoria:Estado-unidenses
Sergio Mattarella	Sergio Mattarella
Category:Kaontri	Categoria:Países
Category:Pipol	Categoria:Pessoas
Category:Intanet	Categoria:Internet
Template:Bot	Predefinição:Robô
Kanada	Canadá
Category:Hungary	Categoria:Hungria
Category:Czechia	Categoria:República Checa
Category:Litwania	Categoria:Lituânia
Category:Slovakia	Categoria:Eslováquia
Category:Yurop	Categoria:Europa
Template:Documentation	Predefinição:Documentação
Category:Wikipedians by language	Categoria:!Wikipedistas por idioma
Sung Jae-ki	Sung Jae-ki
Template:Softredirect	Predefinição:Pseudorredirecionamento
Template:Delete	Predefinição:ER
Category:Toktok	Categoria:Línguas
Category:Wikipedia	Categoria:Wikipédia
Category:Pages with broken file links	Categoria:!Páginas com ficheiros inexistentes
Wikipedia:Statistics	Wikipédia:Estatísticas
Category:Buk	Categoria:Livros
Template:Babel	Predefinição:Babel
Template:Commons	Predefinição:Commons
Template:Link GA	Predefinição:Bom interwiki
Template:User eo-1	Predefinição:User eo-1
Template:User en-2	Predefinição:User en-2
Template:User es-1	Predefinição:User es-1
Template:User sk	Predefinição:User sk
Template:User fr-2	Predefinição:User fr-2
Category:Azerbaijan	Categoria:Azerbaijão
Category:Esia	Categoria:Ásia
Template:Mod	Predefinição:Mod
Template:User it	Predefinição:User it
Template:States blog United States	Predefinição:Divisões Estados Unidos
Template:Quotation	Predefinição:Quotation
Category:User en	Categoria:Usuários en
Category:Croatia	Categoria:Croácia
Category:User en-2	Categoria:Usuário en-2
Template:Template other	Predefinição:Template other
Template:Pp-template	Predefinição:Pp-template
Category:Hed blong Stet	Categoria:Chefes de Estado
Template:Purge	Predefinição:Purgar
Template:Interwiki	Predefinição:InterWiki
Category:Galicia	Categoria:Galiza
Category:User sk	Categoria:Usuários sk
Category:User eo	Categoria:Usuários eo
Category:User fr	Categoria:Usuários fr
Category:User fr-2	Categoria:Usuário fr-2
Category:User it-N	Categoria:Usuário it
Category:User sk-N	Categoria:Usuário sk
Category:User de	Categoria:Usuários de
Category:User eo-1	Categoria:Usuário eo-1
Category:User es	Categoria:Usuários es
Category:User es-1	Categoria:Usuário es-1
Category:User it	Categoria:Usuários it
Category:Praem Minista	Categoria:Primeiros-ministros
Category:Saens blong Pipol	Categoria:Ciências sociais
Category:1969 births	Categoria:Nascidos em 1969
Category:Not Dakota	Categoria:Dakota do Norte
Category:Louisiana	Categoria:Luisiana
Category:Arizona	Categoria:Arizona
Category:Kentucky	Categoria:Kentucky
Category:Armenia	Categoria:Arménia
Category:Vanuatu	Categoria:Vanuatu
Category:Pipol blong Vanuatu	Categoria:Vanuatuanos
Category:Hed blong Stet blong Yunaeted Stet blong Amerika	Categoria:Presidentes dos Estados Unidos
Category:Paraguay	Categoria:Paraguai
Category:Papua Nui Guini	Categoria:Papua-Nova Guiné
Category:Andorra	Categoria:Andorra
Category:Peru	Categoria:Peru
Category:Albania	Categoria:Albânia
Category:Fis	Categoria:Peixes
Category:Dipsi	Categoria:Oceanos
Category:Animol	Categoria:Animais
Category:Asturias	Categoria:Astúrias
Category:Jos blong Jisas Kraes blong ol Lata-dei Sent	Categoria:A Igreja de Jesus Cristo dos Santos dos Últimos Dias
Category:Toktok long Vanuatu	Categoria:Línguas de Vanuatu
Category:Catalonia	Categoria:Catalunha
Trojany	Trojany
Dan Stulbach	Dan Stulbach
Category:Buk Blong Momon	Categoria:Livro de Mórmon
Category:Aragón	Categoria:Aragão
Wikipedia:Deletion log	Wikipédia:Deletion log
Yun Hyon-seok	Yun Hyon-seok
Special:RecentChanges	Especial:Mudanças recentes
