Hĭ-ciŭ	África
Nĭk-buōng	Japão
Nàng Mī-ciŭ	América do Sul
Nò̤-ŭi	Noruega
Ĭng-gáik-làng	Inglaterra
Sŭ-gáik-làng	Escócia
Ŭi-ī-sê̤ṳ	País de Gales
Báe̤k Ái-ī-làng	Irlanda do Norte
Ái-ī-làng	República da Irlanda
Hungary	Hungria
Să̤-băng-ngà	Espanha
Mī-guók	Estados Unidos
Bī-lé-sì	Bélgica
Luxembourg	Luxemburgo
Ṳ̄-dêu	Universo
Dê-giù	Terra
Sĕng-mêng	Vida
Sī	Morte
Nè̤ng	Homo sapiens
Huăng-hī	Felicidade
George Washington	George Washington
Wikidata	Wikidata
Hŭng-làng	Finlândia
Sôi-diēng	Suécia
Dăng-măk	Dinamarca
Pŏ̤-làng	Polónia
Lithuania	Lituânia
É-dâi-lé	Itália
Sô̤i-sê̤ṳ	Suíça
Ó̤-dê-lé	Áustria
Hĭ-lé-nà̤	Grécia
Tū-ī-gì	Turquia
Bì-ciū	Cerveja
Può-dò̤-ngà	Portugal
Ĕu-ciŭ	Europa
Ā-ciŭ	Ásia
Báe̤k Mī-ciŭ	América do Norte
Nàng-gĭk-ciŭ	Antártida
Wikipedia	Wikipédia
Hò̤-làng	Países Baixos
Ĭng-gĕng	Pênis
PHP	PHP
Niū-iók-chê	Nova Iorque
Washington, D.C.	Washington, D.C.
Gô-gĭng-săng	São Francisco (Califórnia)
Báik-lìng	Berlim
Los Angeles	Los Angeles
Diêng-nō̤	Computador
Sŭ-là̤-sié	Zurique
Barack Obama	Barack Obama
Uruguay	Uruguai
MediaWiki	MediaWiki
Lùng-dŭng	Londres
Bìng-guō	Maçã
Bă-là̤	Paris
Mĕ̤k-să̤-gŏ̤	México
Dâi-să̤-iòng	Oceano Atlântico
Tái-bìng-iòng	Oceano Pacífico
California	Califórnia
Boston	Boston
Lā̤-bái-ék	Segunda-feira
Huōi-sĭng	Marte (planeta)
Kenya	Quénia
Ethiopia	Etiópia
Gŭng-ciō (nguòng-siū)	Monarca
Ghana	Gana
Lā̤-bái-nê	Terça-feira
Lā̤-bái-săng	Quarta-feira
Lā̤-bái-sé	Quinta-feira
Lā̤-bái-ngô	Sexta-feira
Lā̤-bái-lĕ̤k	Sábado
Lā̤-bái-nĭk	Domingo
Săi (mà-kuŏ dông-ŭk)	Leão
Huák-guók	França
Kēng	Canis lupus familiaris
Ĭng-guók	Reino Unido
Mà	Gato
Dṳ̆ng-huà Ìng-mìng Gê̤ṳng-huò-guók	República Popular da China
Huák-ngṳ̄	Língua francesa
Wiktionary	Wikcionário
Ngṳ̀	Peixe
Ciū	Bebida alcoólica
Bă-să̤	Brasil
Ngò̤-lò̤-sṳ̆	Rússia
Hāi	Mar
Alabama	Alabama
Wikimedia	Wikimedia
Jimmy Wales	Jimmy Wales
Dáik-guók	Alemanha
Belarus	Bielorrússia
Dáik-ngṳ̄	Língua alemã
Bĭng-dō̤	Islândia
Estonia	Estónia
Tū-sĭng	Saturno (planeta)
Hĭ-gĭ	Avião
Ciéng-cĕng	Guerra
1	Um
2	Dois
3	Três
4	Quatro
5	Cinco
0	0 (número)
George W. Bush	George W. Bush
Latvia	Letónia
Ukraine	Ucrânia
Ciék-káik	República Checa
Slovakia	Eslováquia
Slovenia	Eslovénia
Moldova	Moldávia
Romania	Roménia
Bulgaria	Bulgária
Lò̤-mā	Roma
Macedonia Gê̤ṳng-huò-guók	República da Macedónia
Albania	Albânia
Croatia	Croácia
Bosnia gâe̤ng Herzegovina	Bósnia e Herzegovina
Azerbaijan	Azerbaijão
Andorra	Andorra
Cyprus	Chipre
Georgia (guók-gă)	Geórgia
Kazakhstan	Cazaquistão
Malta	Malta
Monaco	Mónaco
Montenegro	Montenegro
Vaticano	Vaticano
San Marino	San Marino
Gū-bă	Cuba
Belize	Belize
Barbados	Barbados
Java	Java (linguagem de programação)
Éng-dô-nà̤-să̤-ā	Indonésia
Tū-ī-gì-ngṳ̄	Língua turca
Nàng-hĭ	África do Sul
Algeria	Argélia
Wiki Dù-cṳ̆-guāng	Wikisource
Uzbekistan	Uzbequistão
Huà-să	Varsóvia
Può-dò̤-ciū	Vinho
Cūi	Água
Chà	Madeira
Diêng-sê	Televisão
Chile	Chile
Ià-sŭ	Jesus
Galileo Galilei	Galileu Galilei
Cūi-sĭng	Mercúrio (planeta)
Lĭk-sṳ̄	História
Gĭng-sĭng	Vénus (planeta)
Ngṳ̄-ngiòng	Linguagem
Ái	Amor
Mŭk-sĭng	Júpiter (planeta)
Ngṳ̀ng-ò̤	Via Láctea
Tiĕng-uòng-sĭng	Urano (planeta)
Hāi-uòng-sĭng	Netuno (planeta)
Tiĕng-ùng	Astronomia
Sĭng-gă-pŏ̤	Singapura
Kuŏ-hŏk	Ciência
Mìng-uòng-sĭng	Plutão
Ciŏng-lài	Futuro
Séng-mū Mā-lé-ā	Maria (mãe de Jesus)
Liechtenstein	Liechtenstein
Adolf Hitler	Adolf Hitler
Dâ̤-nê-ché̤ṳ Sié-gái Dâi-ciéng	Segunda Guerra Mundial
Wiki Gáu-kuŏ-cṳ̆	Wikilivros
Wiki Ngṳ̄-liŏh	Wikiquote
Wiki Dâi-hŏk	Wikiversidade
Cṳ̆ng	Relógio
Ubuntu	Ubuntu
Linux	Linux
Só-hŏk	Matemática
Lá-dĭng-ngṳ̄	Língua latina
Bahrain	Bahrein
Armenia	Arménia
Serbia	Sérvia
Nguŏk-giù	Lua
Istanbul	Istambul
Ó̤-ciŭ	Austrália
Ŭk-lī	Física
Argentina	Argentina
Peru	Peru
Dièu-siēng Mìng-ciō-ciō-ngiê Ìng-mìng Gê̤ṳng-huò-guók	Coreia do Norte
Gāng-puŏ-câi	Camboja
Gū-làng-gĭng	Alcorão
Kṳ̄ng-lṳ̀ng	Dinossauros
Ĭ-sṳ̆-làng-gáu	Islão
Lì	Pera
Lùng-lùng	Roda
Huò-bìng	Paz
Nṳ̄-gái	Mulher
Gū-chiŏng-kĕ̤ng	Ânus
Nìng-mùng	Limão
Bă-ciĕu	Banana
Huă	Flor
Napoléon Bonaparte	Napoleão Bonaparte
Sĕng-lī	Fisiologia
Hèng-sĭng	Estrela
Nĭk-tàu	Sol
Victor Hugo	Victor Hugo
Dâi-iòng-ciŭ	Oceania
Tái-iòng-hiê	Sistema Solar
Ngāi	Dente
Kĭng	Hidrogénio
Wiki Gê̤ṳng-hiōng	Wikimedia Commons
Cṳ̆	Livro
Nĭk	Dia
Dĕ̤ng Timor	Timor-Leste
Màng-buŏ	Noite
Nièng	Ano
Ó̤-sṳ̆-lṳ̆k	Oslo
Lī-sṳ̆-buōng	Lisboa
Táng	Carbono
Dâng	Azoto
Iōng	Oxigénio
Giàng-sĭng	Planeta
Kleopatra 7-sié	Cleópatra
Ĭng-ngŏk	Música
É-dâi-lé-ngṳ̄	Língua italiana
Séng Peterburg	São Petersburgo
Chad	Chade
Lé̤ṳ	Alumínio
Sĭng-să̤-làng	Nova Zelândia
Éng-dô	Índia
Tuvalu	Tuvalu
Tiék	Ferro
Tonga	Tonga
Samoa	Samoa
Solomon Gùng-dō̤	Ilhas Salomão
Vanuatu	Vanuatu
Papua New Guinea	Papua-Nova Guiné
William Shakespeare	William Shakespeare
Palau	Palau
Nauru	Nauru
Micronesia Lièng-băng	Estados Federados da Micronésia
Iòng (gĭng-sṳ̆k)	Chumbo
Marshall Gùng-dō̤	Ilhas Marshall
Kiribati	Kiribati
Mūng-gū	Mongólia
Fiji	Fiji
Venezuela	Venezuela
Guók-cié chiông-gì	Xadrez
Genghis Khan	Gengis Khan
Maine	Maine
Mā	Equus ferus caballus
Ū-ké	Arma
Dông-ŭk	Animalia
Suriname	Suriname
Paraguay	Paraguai
Guyana	Guiana
Ecuador	Equador
Colombia	Colômbia
Hŭk-gáu	Budismo
Bolivia	Bolívia
Dè̤ng	Cobre
Trinidad gâe̤ng Tobago	Trinidad e Tobago
Sĭk-ŭk	Plantae
Séng Vincent gâe̤ng Grenadines	São Vicente e Granadinas
New Hampshire	Nova Hampshire
Séng Lucia	Santa Lúcia
Séng Kitts gâe̤ng Nevis	São Cristóvão e Nevis
Cĭng-kṳ̄ng	Fungi
Jamaica	Jamaica
Grenada	Granada (país)
Massachusetts	Massachusetts
Guatemala	Guatemala
Bahamas	Bahamas
Connecticut	Connecticut
Giĕ	Gallus gallus domesticus
Antigua gâe̤ng Barbuda	Antígua e Barbuda
Hawaii	Havaí
Honduras	Honduras
Dominica	Dominica
Dominica Gê̤ṳng-huò-guók	República Dominicana
Dṳ̆	Sus domesticus
Báe̤k-bĭng-iòng	Oceano Ártico
Haiti	Haiti
El Salvador	El Salvador
Ĭ-lāng	Irão
Iraq	Iraque
Alaska	Alasca
Costa Rica	Costa Rica
Ī-sáik-liĕk	Israel
Panama	Panamá
Yemen	Iémen
Bâng-dŭk	Vírus
Pŏ̤-làng-ngṳ̄	Língua polaca
Jordan	Jordânia
Nicaragua	Nicarágua
Florida	Flórida
Kyrgyzstan	Quirguistão
Arizona	Arizona
Kuwait	Kuwait
Lō̤-kuŏ	Laos
Lebanon	Líbano
Oregon	Oregon
Maldives	Maldivas
Mī-ciŭ	América
Utah	Utah
Ngù	Bos taurus
Mā-lài-să̤-ā	Malásia
Miēng-diêng	Myanmar
Nepal	Nepal
Oman	Omã
Pakistan	Paquistão
Qatar	Catar
Saudi Ā-lá-báik	Arábia Saudita
Sri Lanka	Sri Lanka
Joseph Stalin	Josef Stalin
Syria	Síria
Platon	Platão
Tajikistan	Tajiquistão
Dṳ̆ng-huà Mìng-guók	República da China
Aristoteles	Aristóteles
Tái-guók	Tailândia
Huōi-chiă	Trem
Turkmenistan	Turquemenistão
Ā-lá-báik Lièng-hăk Dâi-gŭng-guók	Emirados Árabes Unidos
Băh-gĭng	Platina
Uŏk-nàng	Vietname
Dâi-hàng Mìng-guók	Coreia do Sul
Afghanistan	Afeganistão
Gĭng	Ouro
Suez Ông-ò̤	Canal de Suez
Bangladesh	Bangladesh
Mali	Mali
Sokrates	Sócrates
Angola	Angola
Bhutan	Butão
Ùng-lài	Brunei
Tanzania	Tanzânia
Cūi-ngṳ̀ng	Mercúrio (elemento químico)
Hĭ-lĭ-pĭng	Filipinas
Dṳ̆ng-hĭ Gê̤ṳng-huò-guók	República Centro-Africana
Isaac Newton	Isaac Newton
Albert Einstein	Albert Einstein
Uòng-sáik	Amarelo
Togo	Togo
Tunisia	Tunísia
Zambia	Zâmbia
Zimbabwe	Zimbabwe
Báe̤k-gĭng	Pequim
Nàng Sudan	Sudão do Sul
Benin	Benim
Botswana	Botswana
Wiki Sĭng-ùng	Wikinotícias
Burkina Faso	Burkina Faso
Burundi	Burundi
Comoros	Comores
Congo Gê̤ṳng-huò-guók	República do Congo
Congo Mìng-ciō Gê̤ṳng-huò-guók	República Democrática do Congo
Djibouti	Djibouti
Chiáh-dô̤ Guinea	Guiné Equatorial
Eritrea	Eritreia
Gabon	Gabão
Gambia	Gâmbia
Guinea	Guiné
Guinea-Bissau	Guiné-Bissau
Côte d'Ivoire	Costa do Marfim
Cameroon	Camarões
Cabo Verde	Cabo Verde
Lesotho	Lesoto
Liberia	Libéria
Libya	Líbia
Madagascar	Madagáscar
Malawi	Malawi
Mauritania	Mauritânia
Mauritius	Maurícia
Morocco	Marrocos
Mozambique	Moçambique
Namibia	Namíbia
Niger	Níger
Nigeria	Nigéria
Charles Darwin	Charles Darwin
Uganda	Uganda
Rwanda	Ruanda
Séng Tomé gâe̤ng Príncipe	São Tomé e Príncipe
Senegal	Senegal
Seychelles	Seicheles
Carl Linnaeus	Carolus Linnaeus
Sierra Leone	Serra Leoa
Somalia	Somália
Julius Caesar	Júlio César
Sudan	Sudão
Swaziland	Suazilândia
Kê̤ṳng	Arco-íris
Lièng-hăk-guók	Organização das Nações Unidas
Dê-cék	Geologia
Dê-lī	Geografia
Sĭng-câung	Coração
Puòi-hŭ	Pele
Ngàng-sáik	Cor
Làng-sáik	Azul
Ngṳ̀ng	Prata
Sék	Estanho
Michigan	Michigan
Illinois	Illinois
North Dakota	Dakota do Norte
South Dakota	Dakota do Sul
Montana	Montana
Wyoming	Wyoming
Idaho	Idaho
Washington	Washington
Nevada	Nevada
Éng-dô-iòng	Oceano Índico
Kosovo	Kosovo
Colorado	Colorado
分類:Hŭng-lôi	Categoria:Conteúdo
Chicago	Chicago
Dĕ̤ng-tiĕng	Inverno
Chŭng-tiĕng	Primavera
Hâ-tiĕng	Verão
Chiŭ-tiĕng	Outono
Saddam Hussein	Saddam Hussein
Osama bin Laden	Osama bin Laden
Să̤-băng-ngà-ngṳ̄	Língua castelhana
Philadelphia	Filadélfia
Tĭ-tṳ̆	Aranha
Guō-sĭk	Fruto
Gàu	Macaco
Cièng	Dinheiro
Virginia	Virgínia
West Virginia	Virgínia Ocidental
Huăng-ciĕu	Capsicum annuum
Niū-iók-ciŭ	Nova Iorque (estado)
Rhode Island	Rhode Island
Kŏng-tṳ̀ng	Insetos
Maryland	Maryland
Delaware	Delaware
Vladimir Lenin	Lenin
Ohio	Ohio
Pennsylvania	Pensilvânia
Augustus	Augusto
Microsoft Windows	Microsoft Windows
New Jersey	Nova Jérsia
Hŭng-làng-ngṳ̄	Língua finlandesa
Indiana	Indiana
Ké-chiă	Automóvel
Georgia	Geórgia (Estados Unidos)
Texas	Texas
North Carolina	Carolina do Norte
South Carolina	Carolina do Sul
Manila	Manila
Dĕ̤ng-gĭng	Tóquio
Uòng-lì	Ananás
Mississippi	Mississippi
Tennessee	Tennessee
New Mexico	Novo México
Ngà-diēng	Atenas
Minnesota	Minnesota
Baghdad	Bagdá
Wisconsin	Wisconsin
Iowa	Iowa
Nebraska	Nebraska
Kansas	Kansas
Hŏng-giāng	Cigarro
Missouri	Missouri
Louisiana	Luisiana
Kentucky	Kentucky
Arkansas	Arkansas
Oklahoma	Oklahoma
Madonna	Madonna
Aceh	Achém
Séng-gĭng	Bíblia
Phnom Penh	Phnom Penh
Hù Cé-mìng Chê	Cidade de Ho Chi Minh
Ò̤-nô̤i	Hanói
Cĭng Ià-sŭ Gáu-huôi	Verdadeira Igreja de Jesus
Ĭng-ngṳ̄	Língua inglesa
Màng-gók	Banguecoque
Kuala Lumpur	Kuala Lumpur
Bangka Belitung Gùng-dō̤	Bangka-Belitung
Dài-báe̤k	Taipé
Concepción	Concepción (Chile)
Bengkulu	Bengkulu
Końskowola	Końskowola
Nê-iōng-huá-táng	Dióxido de carbono
Jambi	Jambi
Siè	Serpente
Lampung	Lampung
Guŏng-sók	Velocidade da luz
Riau	Riau (província)
Riau Gùng-dō̤	Ilhas Riau
Nàng Sumatra	Sumatra Meridional
Lò̤-mā Dá̤-guók	Império Romano
Mì-niōng	Microsoft
Kó-lū-hŭ	Kurów
Huá-hŏk	Química
Sièng-sŏng	Ácido clorídrico
Ôi-sĭng	Satélite natural
Kă-giù	Futebol
Să̤ Sumatra	Sumatra Ocidental
Mā-dáik-lī	Madrid
Michael Jackson	Michael Jackson
Cê̤ṳ-iù	Liberdade
Cṳ̆-niòng-giāng	Menina
Sék-nà̤	Sydney
Liŏh-sáik	Verde
È̤ng-sáik	Vermelho
Huōi	Fogo
Sĭng Nàng Wales	Nova Gales do Sul
Nile Ò̤	Rio Nilo
Banten	Banten
Dṳ̆ng Jawa	Java Central
Chēng-chiū-sĭng	Cometa
Dĕ̤ng Jawa	Java Oriental
Jakarta	Jacarta
Ăng-kā-lá	Ancara
Să̤ Jawa	Java Ocidental
Yogyakarta	Yogyakarta
Dṳ̆ng Kalimantan	Kalimantan Central
Dĕ̤ng Kalimantan	Kalimantan Oriental
Báe̤k Kalimantan	Kalimantan Setentrional
Nàng Kalimantan	Kalimantan Meridional
Hŏk-hâu	Escola
Să̤ Kalimantan	Kalimantan Ocidental
Dâi-hŏk	Universidade
Wikipedia:Să-buàng	Wikipédia:Página de testes
Chió	Casa
Dê-dù	Mapa
Ò̤	Rio
Osasco	Osasco
Chiĕng-lī-giáng	Telescópio
分類:Dài-uăng lĭk-sṳ̄	Categoria:História de Taiwan
Curitiba	Curitiba
Sĕng-lìng	Floresta
分類:Uŏk-nàng lĭk-sṳ̄	Categoria:História do Vietnã
Iók-báik-cṳ̆	Livro de Jó
Cĭng-ngiòng	Livro dos Provérbios
Kūng-cṳ̄	Confúcio
Hà	Decapoda
分類:Só-hŏk	Categoria:Matemática
Bali	Bali
Ĕu-nguòng	Euro
Mī-gĭng	Dólar dos Estados Unidos
Dâi-lièu	Dinastia Liao
Hòng-ciŭ	Hangzhou
Gĭ-dók-gáu	Cristianismo
Dĕ̤ng Nusa Tenggara	Sonda Oriental
Să̤ Nusa Tenggara	Sonda Ocidental
Dṳ̆ng Sulawesi	Celebes Central
Gĭng-guók	Dinastia Jin (1115-1234)
Gorontalo	Gorontalo
Báe̤k Sulawesi	Celebes Setentrional
Dĕ̤ng-nàng Sulawesi	Celebes do Sudeste
Nàng Sulawesi	Celebes Meridional
Să̤ Sulawesi	Celebes Ocidental
Seattle	Seattle
Dêu	Arroz
Maluku	Molucas (província)
Báe̤k Maluku	Molucas Setentrionais
Papua	Papua (província indonésia)
Să̤ Papua	Papua Ocidental
Cēu	Aves
Siū-dŭ	Capital
Può-dò̤-ngà-ngṳ̄	Língua portuguesa
Nguŏk	Mês
Uòng Hiêng-huàng	Huang Xianfan
Cōng	Diamante
Nĭk-buōng-ngṳ̄	Língua japonesa
Báik-kuŏ-ciòng-cṳ̆	Enciclopédia
Tàu Hiĕk	Wikipédia:Página principal
模板:Ô-lī-kó̤	Predefinição:Artigo bom
Saratov	Saratov
Làng-giù	Basquetebol
Olympic Ông-dông-huôi	Jogos Olímpicos
Diòng-gĕ̤ng	Rio Yangtzé
Che Guevara	Che Guevara
Mò̤ Dĕk-dŭng	Mao Tsé-Tung
Să̤-ăng	Xian
Lá-sák	Lassa
Séng-gău	Relação sexual
Ĭng-dô̤	Vagina
Diék-hŏk	Filosofia
分類:Ché̤ṳk-káik chēng-dṳ̀	Categoria:!Páginas para eliminação rápida
Gáung-kìng	Piano
Dà	Chá
Marco Polo	Marco Polo
Hebe Camargo	Hebe Camargo
Gê̤ṳng-sāng-ciō-ngiê	Comunismo
Cṳ̆-buōng-ciō-ngiê	Capitalismo
Guók-gă	País
Mìng-cŭk	Nação
Carthago	Cartago
Uōng-hiĕk liù-lāng-ké	Navegador (informática)
Siù-cūi	Natação
分類:Tiĕng-ùng	Categoria:Astronomia
Hŭk	Buda
Lī Bĕk	Li Bai
Dù-cṳ̆-guāng	Biblioteca
Sĕng-tái	Ecologia
Céng-dê	Política
Mìng-ciō	Democracia
Cìng-dièu	Dinastia Chin
Nobel Ciōng	Prémio Nobel
Cìng Sṳ̄-huòng	Qin Shihuang
Dṳ̆ng-dĕ̤ng	Médio Oriente
Háng-dièu	Dinastia Han
Làu Băng	Imperador Gaozu de Han
Háng Ùng-dá̤	Imperador Wen de Han
Háng Gīng-dá̤	Imperador Jing de Han
Háng Ū-dá̤	Wu de Han
Sĕng-ŭk	Organismo
Rabindranath Tagore	Rabindranath Tagore
Háng Guŏng-ū-dá̤	Guang Wudi
Gŭng-ciō-cié-dô	Monarquia
Siâ-huôi-ciō-ngiê	Socialismo
Cṳ̆ng-chói	Beijo
Nguòng-dièu	Dinastia Yuan
Háng Hióng-dá̤	Xiandi
Nazi Dáik-guók	Alemanha Nazi
Christopher Columbus	Cristóvão Colombo
Dâng Huò	Zheng He
Panama Ông-ò̤	Canal do Panamá
Céng-dièu	Dinastia Jin (265-420)
Nàng-bĭng-iòng	Oceano Antártico
Uòng-ò̤	Rio Amarelo
Sṳ̆-mā Ièng	Sima Yan
Ngê	Orelha
Pé	Nariz
Mĕ̤k-ciŭ	Olho
Hŭng-muòng	Culicidae
Săi-ngṳ̀	Tubarão
Lŏk-dò̤	Camelo
Chiông	Elefante
Mā-ngiê	Formiga
Sùi-dièu	Dinastia Sui
Hò̤-làng-ngṳ̄	Língua neerlandesa
Sùi Ùng-dá̤	Yang Jian
Sùi Iòng-dá̤	Sui Yangdi
Să̤-hâ	Império Tangut
Sóng-dièu	Dinastia Sung
Diêu Kuŏng-êng	Song Taizu
Sóng Cĭng-cŭng	Zhenzong
Sóng Ìng-cŭng	Renzong
Sóng Sìng-cŭng	Shenzong
Sóng Hŭi-cŭng	Hongxian
Ögedei	Ögedei
Güyük	Güyük Khan
Möngke	Mongke Khan
Kublai	Kublai Khan
Huă-chái	Couve-flor
Giò (sĭk-ŭk)	Beringela
Siók	Neve
Niè-giāng	Criança
Cā-tàu	Manhã
Hŭng-cṳ̆ng	Minuto
Ngò̤-lò̤-sṳ̆-ngṳ̄	Língua russa
Huák-lŭk	Direito
Hièng-huák	Constituição
Háng-ngṳ̄	Língua chinesa
Sá̤-bàu	Célula
Háik	Sangue
Hié (ké-guăng)	Pulmão humano
Romania-ngṳ̄	Língua romena
Bulgaria-ngṳ̄	Língua búlgara
Ṳ̄	Chuva
Dê-cīng	Sismo
Cūi-căi	Inundação
Hāi-lâung	Tsunami
Hùng	Nuvem
Hŭng-tăi	Ciclone tropical
Hŭng	Vento
Georgia-ngṳ̄	Língua georgiana
Háng-cê	Caracteres chineses
Dièu-siēng-cê	Hangul
Lá-dĭng cê-mō̤	Alfabeto latino
Ùng-hŏk	Literatura
分類:Ĭng-ngŏk	Categoria:Música
分類:Ùng-hŏk	Categoria:Literatura
È̤ng-làu-máe̤ng	O Sonho da Câmara Vermelha
Hù-lì	Raposa
Harry Potter	Harry Potter
Chiū-ìng	Masturbação
Siâ-huôi	Sociedade
Gáu-ṳ̆k	Educação
Nàng-gái	Homem
Ìng-guòng	Direitos humanos
Gŭng-sê̤ṳ	Militar
Gă-pĭ	Café
Săng	Montanha
Sŏng Dṳ̆ng-săng	Sun Yat-sen
Hiŏng-gē̤ng	Hong Kong
Miami	Miami
Hàng Ciéng	Guerra da Coreia
Siū-ék	Seul
Siông-hāi	Xangai
Ùng-huá Dâi-gáik-mêng	Revolução Cultural Chinesa
Chĭng-dièu	Dinastia Qing
Uŏk-nàng Ciéng-cĕng	Guerra do Vietnã
Thomas Edison	Thomas Edison
Armenia-ngṳ̄	Língua arménia
Ukraine-ngṳ̄	Língua ucraniana
HTML	HTML
Steven Spielberg	Steven Spielberg
Mŏ̤h-ngiòng	Mo Yan
Sôi-diēng-ngṳ̄	Língua sueca
Dăng-măk-ngṳ̄	Língua dinamarquesa
Nò̤-ŭi-ngṳ̄	Língua norueguesa
Luxembourg-ngṳ̄	Língua luxemburguesa
Ciék-káik-ngṳ̄	Língua tcheca
Karl Marx	Karl Marx
Nĕng-nĕng	Mama
Guŏng	Luz
Hĭ-lé-nà̤-ngṳ̄	Língua grega
Ái-ī-làng-ngṳ̄	Língua irlandesa
Kié-ngò̤	Pinguim
Pŏ̤-sṳ̆-ngṳ̄	Língua persa
Cŭng-gáu	Religião
Hàng-guók-ngṳ̄	Língua coreana
Cháung-sié-gé	Gênesis
Chók-Ăi-gĭk-gé	Livro do Êxodo
Háng-ngṳ̄ Guăng-uâ	Língua mandarim
Uŏk-nàng-ngṳ̄	Língua vietnamita
Sigmund Freud	Sigmund Freud
Tái-guók-ngṳ̄	Língua tailandesa
Mā-lài-ngṳ̄	Língua malaia
Mūng-gū-ngṳ̄	Língua mongol
Bandar Seri Begawan	Bandar Seri Begawan
Hĭ-báik-lài-ngṳ̄	Língua hebraica
Ŭi-ī-sê̤ṳ-ngṳ̄	Língua galesa
Sŭ-gáik-làng-ngṳ̄	Língua gaélica escocesa
Vientiane	Vienciana
Lō̤-cṳ̄	Lao Zi
Găng-câung	Fígado
Sṳ̆-mā Chiĕng	Sima Qian
Tó	Coelho
Ciŏ Hĭ	Zhu Xi
Cìng-gāng	Emoção
Dâi-iòng	Oceano
Victoria Nṳ̄-uòng	Vitória do Reino Unido
Sék-giă-mèu-nà̤	Sidarta Gautama
Mŭk-hâng-mĕk-dáik	Maomé
Hŭ-ngék	Respiração
Ṳ̀-gă	Confucionismo
Bók-lō̤	Abdómen
Dô̤-gáu	Taoismo
Chói-siĕk	Língua
Dâiu-gáuk	Pescoço
Chói	Boca
Elizabeth 2-sié	Isabel II do Reino Unido
Dòng-dièu	Dinastia Tang
Dòng Gŏ̤-cū	Imperador Gaozu de Tang
Dòng Tái-cŭng	Imperador Taizong de Tang
Dòng Gŏ̤-cŭng	Imperador Gaozong de Tang
Ū Cáik-tiĕng	Wu Zetian
Cê-mō̤	Letra
Siēu-hŏk	Escola primária
Mìng-dièu	Dinastia Ming
Ciŏ Nguòng-ciŏng	Zhū Yuánzhāng
Ronald Reagan	Ronald Reagan
Īng-lŏk Huòng-dá̤	Yongle
Sŏng-dáik Huòng-dá̤	Xuande
Céng-dáik Huòng-dá̤	Imperador Zhengde
Gă-cêng Huòng-dá̤	Jiajing
Uâng-lĭk Huòng-dá̤	Imperador Wanli
Gĭng Céng-nĭk	Kim Jong-il
Nguòng-só ciŭ-gĭ-biēu	Tabela periódica
Chăng-màng	Cegueira
Sá̤-kṳ̄ng	Bactéria
Chéu	Árvore
Può-dò̤	Uva
Huăng-giāng-sṳ̀	Batata
Tòng	Açúcar
Uòng-dâu	Soja
Séng-sék	Informação
Bó̤-cāi	Jornal
Diêng-uâ	Telefone
Ùng-huá	Cultura
Huáng-ngṳ̄	Sânscrito
Dâi-diòng	Intestino grosso
Siēu-diòng	Intestino delgado
Ĭ-hŏk	Medicina
Sièng	Sal de cozinha
Huá-hŏk nguòng-só	Elemento (química)
Unix	Unix
Ùi-gì	Go
Káh-dièu-nó̤h	Brinquedo
Diêng-īng	Filme
Gĭng-sṳ̆k	Metal
Kă-dăk-chiă	Bicicleta
Mièng-huă	Algodão
Sók-dô	Velocidade
Sì-găng	Tempo
Cāi	Papel
Só-lâiu	Plástico
Miêng-cék	Área
Gŭng-chióh	Metro
Iù-diĕng-bău	Milho
Duâi-măk	Cevada
Dĕ̤ng-nàng-ā	Sudeste Asiático
Sīng-iòng	Shenyang
Tṳ̀ng-kéng	Chongqing
Tiĕng-cĭng	Tianjin
Ū-háng	Wuhan
Gū Ăi-gĭk	Antigo Egito
Gū Hĭ-lé-nà̤	Grécia Antiga
Hṳ̀ng	Ursidae
Britney Spears	Britney Spears
Ngàng	Cancro
Măk	Trigo
Cié-sē̤	Sorghum
Pó̤-sióng	Deficiência
Lĭk-huák	Calendário
Sìng-gĭng-bâng	Transtorno mental
Gregorius Lĭk-huák	Calendário gregoriano
Tutankhamun	Tutancâmon
Nguŏk-gĭng	Menstruação
Mà-chiók	Mahjong
Ông-ò̤	Canal
Detroit	Detroit
Diòng-siàng	Muralha da China
Gĭng-cê-ták	Pirâmide (arquitetura)
Osman Dá̤-guók	Império Otomano
Guók-nô̤i sĕng-sāng cūng-dĭk	Produto interno bruto
Diêng	Eletricidade
Ché̤ṳng	Arma de fogo
Lòng-gĭ-ché̤ṳng	Metralhadora
Sáung-buàng	Ábaco
Tāng-káik	Carro de combate
Chāu-muòi	Morango
Liĕk-chiĕ	Litchi chinensis
Ià-cī	Coqueiro
Tò̤	Pessegueiro
Cáung-ngṳ̄	Língua zhuang
Mì-ngù-ī-ngṳ̄	Língua uigur
Lâung-gŏ̤	Bolo
Wiki Ŭk-cṳ̄ng	Wikispecies
Nĕng-dáe̤k	Sutiã
Ā-lá-báik-ngṳ̄	Língua árabe
Cūng-lī	Primeiro-ministro
Lù Ū-hièng	Roh Moo-hyun
Páuk Céng-hĭ	Park Chung-hee
Siĕng-ìng-ciōng	Cactaceae
Siŏh-tàu-lâung	Seixo
Iòng-bék	Lápis
Gă-sĭ	Mobiliário
Dó̤h	Mesa
Ó̤-muòng	Macau
Iē-giāng	Cadeira
Hù Gīng-dò̤	Hu Jintao
Sĭk Gê̤ṳng-bìng	Xi Jinping
Dòng-gêng-lĕ̤k	Girafa
Chĭng-dáung	Shenzhen
Guōng-dĕ̤ng	Guangdong
Guōng-să̤	Guangxi
Sŭ-lièng	União Soviética
Kiák-sióng-gĭ	Câmera
Kagoshima-gâing	Kagoshima
C ngṳ̄-ngiòng	C (linguagem de programação)
Kă	Pé
Ciēng	Gekkonidae
Dô-dâing	Lagartos
Giĕng-tàu	Ombro
Wikipedia:Bō̤-ciéng hō̤ ùng	Wikipédia:Artigos destacados
模板:Link FA	Predefinição:Link FA
Sié-gái	Mundo
Wikipedia:Duâi chéu â	Wikipédia:Esplanada
Busan	Busan
Lèng-huă	Nelumbo nucifera
Vermont	Vermont
Denver	Denver
Guōng-ciŭ	Cantão (China)
Ciōng Gái-sĭk	Chiang Kai-shek
Gŏng Dĕk-mìng	Jiang Zemin
Ŭng Gă-bō̤	Wen Jiabao
Nàng-gĭng	Nanquim
Làu Dáik-huà	Andy Lau
Diŏng Hŏk-iū	Jacky Cheung
Báe̤k-gĭng Dâi-hŏk	Universidade de Pequim
Chĭng-huà Dâi-hŏk	Universidade Tsinghua
Ŭ-lū-mŭk-cà̤	Ürümqi
Gŏng-sŭ	Jiangsu
Ciék-gŏng	Zhejiang
Dâing Siēu-bìng	Deng Xiaoping
Lò̤-mā Gê̤ṳng-huò-guók	República Romana
Câung-kṳ̆	Tibete
Să̤-câung	Região Autônoma do Tibete
Ciŭ Ŏng-lài	Zhou Enlai
Dṳ̆ng-guók Gê̤ṳng-sāng-dōng	Partido Comunista da China
Chiū-gĭ	Telefone celular
Dò̤-nēu	Avestruz
Kŏng-hĭ Huòng-dá̤	Kangxi
Dièu-siēng	Coreia
Lī Káik-giòng	Li Keqiang
Gŏ̤ Hèng-giông	Gao Xingjian
Lī Bèng	Li Peng
Lòng	Lobo
Bìng-iōng	Pyongyang
Sĭng-iók Séng-gĭng	Novo Testamento
9	Nove
Kiék	Escorpião
Gièng-lè̤ng Huòng-dá̤	Qianlong
Dṳ̆ng-guók Dâi-lṳ̆k	China continental
Háik-lṳ̀ng-gĕ̤ng-sēng	Heilongjiang
Mā Ĭng-gāu	Ma Ying-jeou
Lè̤	Equus africanus asinus
Wikipedia:Cék-liông ô-lī-kó̤ gì ùng-ciŏng	Wikipédia:Artigos bons
Sé-chiŏng	Sichuan
Gô-iók Séng-gĭng	Antigo Testamento
Séng-dáng-cáik	Natal
Săng-gáe̤k-hìng	Triângulo
Muammar Gaddafi	Muammar al-Gaddafi
Lâu-hū	Tigre
Daejeon	Daejeon
Daegu	Daegu
Sié-cŭng Dĕk-biék Cê̤ṳ-dé-chê	Cidade de Sejong
Incheon	Incheon
Gyeonggi Dô̤	Gyeonggi
Bô-uăk-cáik	Páscoa
Ò̤-báe̤k	Hebei
Bŏk Hĭ-lài	Bo Xilai
GNU Cê̤ṳ-iù Ùng-dáung Hṳ̄-kō̤-céng	GNU Free Documentation License
Uŏng Cĭng-ôi	Wang Jingwei
Dìng Cūi-biēng	Chen Shui-bian
Dài-uăng	Ilha Formosa
À̤	Sapato
Ngṳ̀ng-hòng	Banco
Lū Séng	Lu Xun (escritor)
7	Sete
8	Oito
Lĕ̤k	Cervidae
Hù	Lago
Sáung-tàu	Alho
Chái-guă	Pepino
Dō̤	Ilha
Băh-sáik	Branco
Ŭ-sáik	Preto
6	Seis
Moshchena	Mostchena
Huăng-kê	Tomate
George H. W. Bush	George H. W. Bush
Paltoga	Paltoga
Quảng Bình	Quang Binh
Atlanta	Atlanta
Benito Mussolini	Benito Mussolini
Sṳ̀-diēng	Dicionário
Tàu	Cabeça
Hiê-lìng-dóng	Wellington
Dâi Bók-liĕk-diĕng Dō̤	Grã-Bretanha
Las Vegas	Las Vegas
10	Dez
Alfred Nobel	Alfred Nobel
Tàu-sĕ̤	Pente
Guòng-lĭk	Poder
Mà-hùng-cēu	Strigiformes
Dēng-cṳ̆ng	Hora
Ké-chiông	Meteorologia
Đà Nẵng	Da Nang
Káh-chiók	Pega-rabuda
Làng-huă	Orquídea
Gă-săk	Barata
Ngáuk-ngṳ̀	Crocodylia
Lā-lì	Pangolim
Nàng-muōi-sĭng	Vaga-lume
Holocene	Holoceno
Hāi-báu	Foca
Bà̤-bá-cēu	Carriça
Ciáh-giāng	Pardal-montês
Niccolò Cusano Dâi-hŏk	Università degli Studi Niccolò Cusano
Long An	Long An
Thái Nguyên	Thái Nguyên
Herodotus	Heródoto
Othello	Otelo, o Mouro de Veneza
Nĭk-buōng-hāi	Mar do Japão
Dĕ̤ng-ā	Ásia Oriental
Dĕ̤ng-ĕu	Leste Europeu
Vĩnh Phúc	Vinh Phuc
Liù-giù-guók	Reino de Ryukyu
Dièu-siēng uòng-dièu	Dinastia Joseon
Gŏ̤-là̤	Goryeo
Dâi-hàng Dá̤-guók	Império Coreano
Buŏk-hāi-guók	Balhae
Gŏ̤-gău-là̤	Koguryo
Bì-bà-dâu-giék	Morcego
Báik-cá̤	Baekje
Sĭng-lò̤	Silla (Coreia)
Tàu-huók	Pelo
Hàng Hĭ	Han Fei
Uòng-dá̤	Huangdi
Diéu-ngṳ̀-dài Liĕk-dō̤	Ilhas Senkaku
Gê̤ṳng-huò-dōng (Mī-guók)	Partido Republicano (Estados Unidos)
Dṳ̆ng-guók	China (civilização)
Mìng-ciō-dōng (Mī-guók)	Partido Democrata (Estados Unidos)
Cūi-tiák	Lontra-europeia
Sìng-dŭ	Chengdu
Buò-gŭng-ĭng	Taraxacum
Tá	Medusa (animal)
Dâng-ciŭ	Zhengzhou
Cūng-tūng	Presidente
Muāng-ciŭ-guók	Manchukuo
Gù-cŭi	Rola
Só̤h	Corda
Dṳ̆ng-guók Guók-mìng-dōng	Kuomintang
Ngâng	Ganso-africano
Ĕng-gŏ̤	Psittaciformes
Gă-huák	Adição
Dŏ̤	Faca
Băng-mā	Zebra
Guók-cié biĕu-cūng cṳ̆-hô̤	International Standard Book Number
Đồng Nai	Dong Nai
Sóc Trăng	Soc Trang
Quảng Ngãi	Quang Ngai
Hà Tĩnh	Ha Tinh
Cà Mau	Cà Mau
Quảng Nam	Quang Nam
Bến Tre	Ben Tre
Khánh Hòa	Khanh Hoa
Sơn La	Son La
Huŏng-ngiòng	Dialeto
Lev Trotsky	Leon Trótski
Quảng Ninh	Quang Ninh
Lạng Sơn	Lang Son
Bắc Ninh	Bac Ninh
Gáng-ngṳ̄	Chinês gan
Mà-hṳ̀ng	Ailuropoda melanoleuca
Muāng-ngṳ̄	Língua manchu
Chiū	Mão
Dô Hū	Du Fu
Gùng-dō̤	Arquipélago
Niŏh-niŏh	Folha
Bŭk-buó	Queda de água
Yasser Arafat	Yasser Arafat
Chṳ̆ng-sìng-ngṳ̄	Língua oquinauana
Câung-ngṳ̄	Língua tibetana
Ngù-ngṳ̄	Língua wu
Tasmania	Tasmânia
Ì-cô̤	Sabonete
Hŭk-săng	Foshan
Ciĕu-huò Tiĕng-huòng	Hirohito
Al-Qaeda	Al-Qaeda
Mò̤-táuk-chiă	Motocicleta
Ò̤-mā	Hipopótamo-comum
Anastacia	Anastacia
Sĕk Gái	Dez Mandamentos
Huă-báu	Leopardo
Să̤-ngiù	Rhinocerotidae
Lò̤-buàng	Bússola
Buáng-dō̤	Península
Sĭng-giŏng	Xinjiang
Mŭk-guă	Mamão
Mì-sĕng-só	Vitamina
Gái-làng-chái	Repolho
Giáng	Espelho
Ciŭ-dièu	Dinastia Zhou
Kāng-muòng-giāng	Janela
Băh Gṳ̆ng	Casa Branca
Gīng-chák	Polícia
Hók-ciŭ-uâ	Língua fuzhou
Báe̤k-hāi-dô̤	Hokkaido
Giŏng	Gengibre
Nobel Huò-bìng Ciōng	Nobel da Paz
Sáu	Tosse
Hák-chê	Espirro
Káung-mìng	Sono
Gèng-hāi	Mar de Aral
Dé̤ṳk	Bambu
Hù Cé-mìng	Ho Chi Minh
Hòa Bình	Hoa Binh
Queensland	Queensland
Tù	Solo
Ù-huă-guō	Figueira-comum
Hưng Yên	Hung Yen
Dòng-dô	Comprimento
Kon Tum	Kon Tum
Hậu Giang	Hau Giang
Máe̤ng	Sonho
Yên Bái	Yen Bai
Bắc Giang	Bac Giang
Thừa Thiên-Huế	Thua Thien-Hue
Bắc Kạn	Bac Kan
Lai Châu	Lai Chau
Hà Nam	Hà Nam
Lào Cai	Lao Cai
Mìng-dĕ̤ng-ngṳ̄	Língua min oriental
Hannibal	Aníbal
Mìng-nàng-ngṳ̄	Min Nan
Thanh Hóa	Thanh Hoa
Kiên Giang	Kien Giang
Quảng Trị	Quang Tri
Nghệ An	Nghe An
An Giang	An Giang
Tây Ninh	Tay Ninh
Phú Thọ	Phu Tho
Duâi-sĭng-sĭng	Gorila
Trà Vinh	Tra Vinh
Bạc Liêu	Bac Lieu
Gia Lai	Gia Lai
Tiền Giang	Tien Giang
Bình Phước	Binh Phuoc
Đồng Tháp	Dong Thap
Thái Bình	Thai Binh
Hà Giang	Ha Giang
Đắk Lắk	Dac Lac
Cáung-cŭk	Zhuang (etnia)
Bình Định	Binh Dinh
Lâm Đồng	Lam Dong
Đắk Nông	Dak Nong
Phú Yên	Phu Yen
Hải Dương	Hai Duong
Iók-hâng Hók Ĭng	Evangelho segundo João
Muòng	Porta
Chiēng-gák	Unha
Cao Bằng	Cao Bang
Bình Dương	Binh Duong
Bình Thuận	Binh Thuan
Bà Rịa-Vũng Tàu	Ba Ria-Vung Tau
Ninh Bình	Ninh Binh
Ninh Thuận	Ninh Thuan
Nam Định	Nam Dinh
Điện Biên	Dien Bien
Sìng-lṳ̀ng	Jackie Chan
Méng	Face
Gāng-lāng	Oliveira
Săng-ôi-ék-tā̤	Trindade (cristianismo)
Sŏng-cṳ̄	Sun Tzu
Sĭng-săng	Professor
Cleveland	Cleveland
Dăk-lâi Lā-mà	Dalai Lama
Huă-sĕng	Amendoim
100	Cem
Kă-kók-tàu	Joelho
Hâing	Damasqueiro
Ngāng-giáng	Óculos
Cê̤ṳ-lài-huōi	Palito de fósforo
Chê-diòng	Mercado
Nàng Dṳ̆ng-guók Hāi	Mar da China Meridional
Dièu-siēng Sié-cŭng	Rei Sejong
Hăk-gĭng	Liga metálica
Bĭng-siŏng	Frigorífico
Nobel Ùng-hŏk Ciōng	Nobel de Literatura
Huăng-sṳ̀	Batata-doce
Uòng-hāi	Mar Amarelo
Akihito	Akihito
Newton ông-dông-hŏk dêng-lŭk	Leis de Newton
Să̤-guă	Melancia
Biobío Dâi-hŏk	Universidade do Bío-Bío
Huòng-dá̤	Imperador
Ìng-mìng-bê	Renminbi
Tā̤-cék	Volume
Cèng-sáik	Laranja (cor)
Gă-sĭ-huă	Ferramenta
Ĭ-sĕng	Médico
Iéng (cēu)	Andorinha
Kó	Calça
Lô-gă Hók Ĭng	Evangelho segundo Lucas
Mìng-ciō-dōng	Partido Democrático
Ciŏng-tàu	Tijolo
Tiō-uòng	Elipse
Sìng-huák	Multiplicação
Sé̤ṳ-dù Hèng-diông	Atos dos Apóstolos
Uòng-dô̤ Sĕk-nê Sĭng-cô̤	Zodíaco
Huá-siŏh	Fóssil
Gēng-huák	Subtração
Cī-cī	Semente
Chiĕk	Caranguejo
Gă-dŏ̤	Tesoura
Niêu	Urina
Ăng-hŭi	Anhui
Ngiăh	Testa
Sĭ-piĕng	Livro de Salmos
Chungcheong Báe̤k-dô̤	Chungcheong do Norte
Chungcheong Nàng-dô̤	Chungcheong do Sul
Gangwon Dô̤ (Dâi-hàng Mìng-guók)	Gangwon
Nô̤i Mūng-gū	Mongólia Interior
Gĭng Nĭk-sìng	Kim Il-sung
Gyeongsang Nàng-dô̤	Gyeongsang do Sul
Gyeongsang Báe̤k-dô̤	Gyeongsang do Norte
Jeolla Báe̤k-dô̤	Jeolla do Norte
Jeolla Nàng-dô̤	Jeolla do Sul
Jeju Dĕk-biék Cê̤ṳ-dé-dô̤	Jeju
Huăng-cièng-giāng	Moeda (peça)
Bă-biĕk-ták	Torre de Babel
Ulsan	Ulsan
Gwangju	Gwangju
Chó	Vinagre
Kangwŏn Dô̤ (Dièu-siēng Mìng-ciō-ciō-ngiê Ìng-mìng Gê̤ṳng-huò-guók)	Kangwon
Michael Jordan	Michael Jordan
Lé-ê-gé	Levítico
Gṳ̆ng-gṳ̆ng	Raiz
Bì-bà (cūi-guō)	Nespereira (árvore)
Hamlet	Hamlet
Huà Guók-hŭng	Hua Guofeng
Sāng	Guarda-chuva
Làu Hiēu-pŏ̤	Liu Xiaobo
Hók-gióng	Fujian
Mūng-gū-cŭk	Mongóis
Mĕk-sê Liŏh	Apocalipse
Hièng-câung	Xuanzang
Gū-chiŏng	Nádegas
Mìng-chòng	Cama
Hāi-nàng	Hainan
Háng-ngṳ̄ Pĭng-ĭng	Pīnyīn
Uōng-dĕ̤ng	Extremo Oriente
Băh-gák	Columba livia
Găng-sé̤ṳk	Gansu
Taliban	Taliban
Huŏi-sáik	Cinza
Sĭng-mêng-gé	Deuteronômio
Sŭ-ciŭ	Suzhou
Ŭng-ciŭ	Wenzhou
Háng-cŭk	Han (etnia)
Nìng-pŏ̤	Ningbo
Chói-chiŭ	Barba
Cāi-iêu	Pipa (brinquedo)
Hăk-ī-bĭng	Harbin
Mā-kì	Sanguessuga
1000	Mil
Mìng-só-gé	Livro dos Números
Cáu-sèng	Cozinha
Hùng-nàng	Yunnan
Lō̤-uă	Corvo
Săng-dĕ̤ng	Shandong
È̤ng-ĕ̤ng	Quilópode
Ò̤-nàng	Henan
Mì-mò̤	Sobrancelha
Bók-sài	Umbigo
Lièu-nìng	Liaoning
Hióng-liông	Vetor (matemática)
Cretaceous	Cretáceo
Tochigi-gâing	Tochigi
Chói-mò̤-cēu	Guarda-rios
Dàu	Dado
Cūi-nà̤	Cimento
Gék-lìng	Jilin
Dĕ̤ng Dṳ̆ng-guók Hāi	Mar da China Oriental
Hāi-chĕk	Pirata
Gūi	Fantasma
Bóng-dó̤	Resíduo sólido
Hù-nàng	Hunan
Jurassic	Jurássico
Chĭng-hāi	Qinghai
Mì-ngù-ī-cŭk	Uigures
Ă-piéng	Ópio
Chiū-cī	Anel
Hù-báe̤k	Hubei
Săng-să̤	Shanxi
Cĕ̤ng-sáik	Marrom
Giòng-găng	Estupro
Gói-ciŭ	Guizhou
Triassic	Triássico
Sék-sáuk	Grilo
Cāi-piéu	Papel-moeda
SQL	SQL
Hù Sék	Hu Shi
Iók-cṳ̆-ā-gé	Livro de Josué
Cŏng-cṳ̄	Chuang-Tzu
Cṳ̀-hĭ Tái-hâiu	Tseu-Hi
Kan Naoto	Naoto Kan
Miyagi-gâing	Miyagi
模板:Commons category	Predefinição:Commonscat
Lò̤-mā Cṳ̆	Epístola aos Romanos
Pău-ŭk-siáng	Parábola
Dô̤-dáik	Moral
Iwate-gâing	Iwate
Ĭ-siòng-chiă	Máquina de costura
Dièu-siēng Lò̤-dông-dōng	Partido dos Trabalhadores da Coreia
Nàng-báe̤k-dièu	Dinastias do Norte e do Sul
Chái Ĭ-lìng	Jolin Tsai
Pì-lĭk-bī Cṳ̆	Epístola aos Filipenses
Ngā-gŏ-cṳ̆	Cântico dos Cânticos
Mā-lăk-gĭ-cṳ̆	Livro de Malaquias
模板:Taxobox	Predefinição:Info/Taxonomia
分類:Guók-uòng	Categoria:Reis
分類:Gŭng-ciō	Categoria:Monarcas
Diŏng Ngiê-mèu	Zhang Yimou
模板:Dṳ̆ng-guók lĭk-sṳ̄	Predefinição:História da China
Gĭng Céng-ŏng	Kim Jong-un
Liù-giù-ngṳ̄	Línguas ryukyuanas
Mìng-ngṳ̄	Línguas min
Buò-siĕng-ngṳ̄	Língua putian
Gŏng-să̤	Jiangxi
Nìng-hâ	Ningxia
Lùng-sùng	Barco Dragão
Noda Yoshihiko	Yoshihiko Noda
Yingluck Shinawatra	Yingluck Shinawatra
Siŏh-gă-cŏng	Shijiazhuang
Chṳ̄	Muroidea
Ciŏ-hāi	Zhuhai
Sáng-tàu	Shantou
Dâng-gŏng	Zhanjiang
Mùi-ciŭ	Meizhou
Dĕ̤ng-uāng	Dongguan
Dṳ̆ng-săng-chê	Zhongshan
Tàng-táik	Siluriformes
Gé̤ṳk-huă	Chrysanthemum
Sofie gì Sié-gái	O Mundo de Sofia
Ordovician	Ordoviciano
Silurian	Siluriano
Dāng-nòng	Vesícula biliar
Devonian	Devoniano
Hók-ciŭ	Fucheu
Nàng-bìng	Nanping
Buò-dièng	Putian
Săng-mìng	Sanming
Ciòng-ciŭ	Quanzhou
Â-muòng	Xiamen
Ciŏng-ciŭ	Zhangzhou
Lṳ̀ng-ngàng	Longyan
Să̤-nìng	Xining
Să̤-iù-gé	Jornada ao Oeste
Săng-guók Iēng-ngiê	Romance dos Três Reinos
Aomori-gâing	Aomori
Fukushima-gâing	Fukushima
Tái-nguòng	Taiyuan
Hải Phòng	Haiphong
Dâi-lièng	Dalian
Hĭ-Pŏ̤ Ciéng-cĕng	Guerras Médicas
Permian	Permiano
Cambrian	Cambriano
Iòng-ciók	Vela
Chiba-gâing	Chiba
Pău	Pomelo
Lô-dáik-gé	Livro de Rute
Mà-hù	Libélula
Dáng-ī-lī	Livro de Daniel
Páuk-káik	Pôquer
Mô̤	Chapéu
Gŏ̤-lìng-dŏ̤ Cièng Cṳ̆	Primeira Epístola aos Coríntios
Aichi-gâing	Aichi
Lī-ngṳ̀	Carpa-comum
Muāng-ciŭ	Manchúria
Sê̤ṳ-sṳ-gé	Livro dos Juízes
Pŏ̤-lìng-chái	Espinafre
Akita-gâing	Akita
Pièu-gĕng	Colher
Dê̤ṳ	Hashi
Mĕ̤k-lê	Jasmim
Gié-tiàng-chiă	Táxi
Â-hài	Queixo
Gŭ	Cogumelo
Ibaraki-gâing	Ibaraki
Lài-gŭng	Trovão
Siĕu-sŏng	Ácido nítrico
Ngù-giāng-kó	Jeans
Bō̤-siŏh	Gema (mineralogia)
Gáu-kuŏ-cṳ̆	Livro didático
Chāu-māng	Gafanhoto
Diòng-chŭng	Changchun
Milan Kundera	Milan Kundera
Lâung	Ovo (alimento)
Lĕ̤k-sé Sê̤ṳ-giông	Protesto na Praça da Paz Celestial em 1989
Diêu Ciē-iòng	Zhao Ziyang
Hù Iêu-băng	Hu Yaobang
Fukuda Yasuo	Yasuo Fukuda
Sṳ̀ng-chéu (Sṳ̀ng-báh)	Pinaceae
Gī-hò̤-chiă	Compasso (geometria)
Táng-sŏng	Ácido carbônico
Liòng-chióh	Régua
Chăng-màng-chṳ̄	Talpidae
Dṳ̆ng-hâ Iâ cĭ Máe̤ng	Sonho de uma Noite de Verão
Mā-kō̤ Hók Ĭng	Evangelho segundo Marcos
Diê (dông-ŭk)	Ostra
Kaesŏng	Kaesong
Hwanghae Báe̤k-dô̤	Hwanghae Norte
P'yŏng'an Báe̤k-dô̤	Pyongan Norte
Hamgyŏng Báe̤k-dô̤	Hamgyong Norte
Hamgyŏng Nàng-dô̤	Hamgyong Sul
P'yŏng'an Nàng-dô̤	Pyongan Sul
Namp'o	Nampo
Ryanggang Dô̤	Ryanggang
Sŭk-mī	Arroz glutinoso
Gĭng-dŭ	Quioto (província)
Ōsaka-hū	Osaka
Cék-ngṳ̀	Carassius auratus
Fukuoka-gâing	Fukuoka
Ehime-gâing	Ehime
Gŏ̤-lìng-dŏ̤, Hâiu Cṳ̆	Segunda Epístola aos Coríntios
Gàu-ūng	Minhoca
Sā̤-ĭ-gĭ	Máquina de lavar roupa
Gék	Tangerina
Gé̤ṳ	Serra (ferramenta)
Yamagata-gâing	Yamagata
Éu-dê-huòng	Jardim de infância
Dài-uăng Hāi-hiĕk	Estreito de Taiwan
Lù-guói	Aloe
Yamaguchi-gâing	Yamaguchi
Kanagawa-gâing	Kanagawa
Nagano-gâing	Nagano
Iĕng-huă	Fogos de artifício
Mì-pŏ̤-lù	Forno de micro-ondas
Saitama-gâing	Saitama
Mie-gâing	Mie
Hĭ-báik-lài Cṳ̆	Epístola aos Hebreus
Gă-lăk-tái Cṳ̆	Epístola aos Gálatas
Muàng-ngṳ̀	Anguilliformes
Siŏng-dièu	Dinastia Shang
Gunma-gâing	Gunma
Hyōgo-gâing	Hyōgo
Miyazaki-gâing	Miyazaki
Kumamoto-gâing	Kumamoto
Ă-cì	Cigarra
Koizumi Jun'ichirō	Junichiro Koizumi
Liĕk-uòng-gé-liŏk Siông	I Reis
Ī-sê̤ṳ-táik-cṳ̆	Livro de Ester
Diòng-dô-cṳ̆	Eclesiastes
Hatoyama Yukio	Yukio Hatoyama
Gŏ̤-lò̤-să̤ Cṳ̆	Epístola aos Colossenses
Ngā-gáuk Cṳ̆	Epístola de Tiago
Iók-hâng Ék Cṳ̆	Primeira Epístola de João
Pì-lé-muòng Cṳ̆	Epístola a Filémon
Táik-sák-lò̤-nà̤-giă, Hâiu Cṳ̆	Segunda Epístola aos Tessalonicenses
Táik-sák-lò̤-nà̤-giă Cièng Cṳ̆	Primeira Epístola aos Tessalonicenses
Bī-dáik Cièng Cṳ̆	Primeira Epístola de Pedro
Bī-dáik Hâiu Cṳ̆	Segunda Epístola de Pedro
Tì-mò̤-tái Cièng Cṳ̆	Primeira Epístola a Timóteo
Dòng-lòng	Louva-a-deus
Gifu-gâing	Gifu
Ishikawa-gâing	Ishikawa
Nara-gâing	Nara (Japão)
Wakayama-gâing	Wakayama
Shizuoka-gâing	Shizuoka
Shiga-gâing	Shiga
Iók-hâng Nê Cṳ̆	Segunda Epístola de João
Ī-suói-ā-cṳ̆	Livro de Isaías
Iók-hâng Săng Cṳ̆	Terceira Epístola de João
Iù-dâi Cṳ̆	Epístola de Judas
Tì-mò̤-tái Hâiu Cṳ̆	Segunda Epístola a Timóteo
Tì-dŏ̤ Cṳ̆	Epístola a Tito
Ià-lé-mī-cṳ̆	Livro de Jeremias
Ī-sê̤ṳ-lá-cṳ̆	Livro de Esdras
Nà̤-hĭ-mī-cṳ̆	Livro de Neemias
Iók-ngī-cṳ̆	Livro de Joel
Băh-lô	Egretta garzetta
Chŭng-cáik	Ano-novo chinês
Sō-siè	Chave
Abe Shinzō	Shinzō Abe
Asō Tarō	Tarō Asō
Niigata-gâing	Niigata
Yamanashi-gâing	Yamanashi
Shimane-gâing	Shimane
Toyama-gâing	Toyama
Okayama-gâing	Okayama
Kă-tōi	Perna
Piăng	Costas
Piĕ	Carta
Sáik-màng	Daltonismo
Carboniferous	Carbonífero
Fukui-gâing	Fukui
Ōita-gâing	Oita
Tottori-gâing	Tottori
Nùng-lĭk	Calendário chinês
Kōchi-gâing	Kōchi
Uâng-iū īng-lĭk dêng-lŭk	Lei da gravitação universal
Chèng-gēng	Bicho-da-seda
Páuk Gê̤ṳng-hiê	Park Geun-hye
Cĕng	Agulha
Muāng-cŭk	Manchu
Kìng-giāng	Alicate
Anna Karenina	Anna Karenina
Tài-nè̤ng	Homicídio
Gáung-gṳ̆ng	Vergalhão
Tiè-mà	Choro (fisiologia)
Swadesh hŏk-sĭng-sṳ̀ liĕk-biēu	Lista de Swadesh
Diāng	Panela
Kă-cāi	Artelho
Lāng	Saliva
Bĭng-lòng	Areca catechu
Dâi-céng Tiĕng-huòng	Imperador Taishō
Băng-sièng Lā-mà	Panchen Lama
Mŭk-gê̤ṳng	Hibisco-da-síria
Muòi-kṳ̄ng	Bolor
Sĕ̤ng-săng-giāng	Gêmeos
Mĕ̤k-tiák	Celha
Nguòng-cṳ̄-bék	Caneta esferográfica
Norodom Sihanouk	Norodom Sihanouk
Saga-gâing	Saga (província)
Tokushima-gâing	Tokushima
Lòng-dâung	Hyoscyamus niger
Lòi-sĭ-gā	Chave de fenda
Kēng-muōi-dăi	Setaria italica
Sĭk-sĭk	Asa
Kagawa-gâing	Kagawa
Thaksin Shinawatra	Thaksin Shinawatra
Kê	Diospyros
Săng-guók (Dièu-siēng)	Três Reinos da Coreia
Bék	Caneta
Ŭng-dìng	Poeira
Huăng-siŏh-liù	Goiabeira
Duâi-tàu-giáng	Lupa
Ĭ-gŭng	Avós
Puái-dáu	Meio-dia
Huōi-căi	Incêndio
Chiū-ló̤h	Luva
Nagasaki-gâing	Nagasaki (província)
Hâ-dièu	Dinastia Xia
Cá̤-nàng	Jinan
Dṳ̆ng-guók Káung-nĭk Ciéng-cĕng	Segunda Guerra Sino-Japonesa
Sarawak	Sarawak
Hŭng-cūi	Feng shui
Chiéu	Gargalhada
Ngô̤-mâng gâe̤ng Piĕng-giéng	Orgulho e Preconceito
Oda Nobunaga	Oda Nobunaga
Dăng-hù	Coral
Lī Sìng-uāng	Syngman Rhee
Iòng-bék-chó̤	Borracha escolar
Nàng-chiŏng	Nanchang
Tokugawa Ieyasu	Tokugawa Ieyasu
Bók-séu-gáung	Aço inoxidável
Sáu-chiū	Vassoura
Dŭk-cài	Autocracia
Kŭng-dièu	Condicionamento de ar
Diòng-să	Changsha
Pèng	Tinta
Mìng-dê Tiĕng-huòng	Imperador Meiji
Kă-âu-dăng	Calcanhar
Ā-mò̤-sê̤ṳ-cṳ̆	Livro de Amós
Ŏ̤-bă-dī-ā-cṳ̆	Livro de Obadias
Itō Hirobumi	Ito Hirobumi
Nguŏh	Jade
Só-gé̤ṳ-kó guāng-lī hiê-tūng	Sistema de gerenciamento de banco de dados
Dâu-hô	Tofu
Mì-hèu	Macaca
Mī-giă-cṳ̆	Livro de Miqueias
Bù-sák	Bodisatva
Hăk-gĭ-cṳ̆	Livro de Ageu
Ī-să̤-giék	Livro de Ezequiel
Chiū-biēu	Relógio de pulso
ASP.NET	ASP.NET
Iók-nā-cṳ̆	Livro de Jonas
Sabah	Sabá (Malásia)
Ià-lé-mī-ăi-gŏ̤	Livro das Lamentações
Tái-gáng	Eunuco
Nàng-nìng	Nanning
Ê-só	Glutamato monossódico
Nā-ŭng-cṳ̆	Livro de Naum
Hăk-bă-gók-cṳ̆	Livro de Habacuque
Sák-gā-lé-ă-cṳ̆	Livro de Zacarias
Guók-gê̤ṳng Nô̤i-ciéng	Guerra Civil Chinesa
Uŏk-nàng Gê̤ṳng-huò-guók	Vietname do Sul
Chiĕu-chê	Supermercado
Ciŏng Cṳ̄-ì	Zhang Ziyi
Lák-tàu	Calvície
Gulliver Lṳ̄-hèng-gé	As Viagens de Gulliver
Gŏ̤-hṳ̀ng	Kaohsiung
Naha-chê	Naha
Buŏk-hāi	Mar de Bohai
Báh-chói	Bocejo
Hâung Ṳ̄	Xiang Liang
Putrajaya	Putrajaya
Kŏng-mìng	Kunming
Nĭk-guŏng-dĕng	Lâmpada fluorescente
Jane Eyre	Jane Eyre
Johor	Johor
Ngâung	Retardo mental
Huòi-cŭk	Hui (povo)
Làng-ciŭ	Lanzhou
Hŏ̤-să̤-cṳ̆	Livro de Oseias
Tiék-cĭng	Ferrugem
Dĕ̤ng-kiĕ	Choco
Săng-guók	Três Reinos
Chŭng-chiŭ Sì-dâi	Período das Primaveras e Outonos
Ciéng-guók Sì-dâi	Período dos Reinos Combatentes
Puō-ngì	Imperador Pu Yi
Mā-lăk-gă	Malaca
Oracle	Oracle (banco de dados)
Hăk-bùi	Hefei
Huák-lùng-gŭng	Falun Gong
Kelantan	Kelantan
Lŏk-iòng	Luoyang
Toyotomi Hideyoshi	Toyotomi Hideyoshi
Kana	Kana (escrita)
Câung-cŭk	Tibetanos
Pulau Pinang	Penang
Hamasaki Ayumi	Ayumi Hamasaki
Să̤-huăng-ngā-cṳ̆	Sofonias
Dâi-nĭk-buōng Dá̤-guók	Império do Japão
Hṳ̆ng-nù	Xiongnu
Mâing-cṳ̄	Mêncio
Kedah	Quedá
Perak	Perak
Hŏk-ôi	Grau académico
Gié-lìng	Guilin
Terengganu	Terengganu
Selangor	Selangor
Iòng (dông-ŭk)	Caprinae
Hāi-kāu	Haikou
Chāu-buōng sĭk-ŭk	Erva
Pahang	Pahang
Bă-là̤ Séng-mū-iêng (Siēu-siók)	Notre-Dame de Paris (livro)
Chiông-gì	Xiangqi
Yun Chi-ho	Yun Chi-ho
Gói-iòng	Guiyang
Gáung-bék	Caneta-tinteiro
Ngù Dìng-iēng	Ngo Dinh Diem
Gô-dā̤	Passado
Dĭng-hiŏng-kó̤	Engraulidae
Hiêng-câi	Presente (tempo)
Lèng-gēng	Longan
Mì-lĕk-hŭk	Maitreya
Guăng-ĭng	Avalokiteshvara
Gēu-gī	Goji
Lĕ̤k-dèu-gáuk	Costela
Dâng Sìng-gŭng	Koxinga
Nguŏk-biāng	Bolo lunar
Ciŭ Īng-kŏng	Zhou Yongkang
Cṳ̆-gák Liông	Zhuge Liang
Ció-ĭng Hù-hô̤	Bopomofo
Tù-kēng	Gryllotalpidae
Dṳ̆ng-guók Ìng-mìng Gāi-huóng-gŭng	Exército de Libertação Popular
Sìng-ū Tiĕng-huòng	Imperador Jimmu
Kūng-chiók	Pavão
Ciē-chái	Nori
Dennis Rodman	Dennis Rodman
È̤ng-dà	Chá preto
Cò̤ Chó̤	Cao Cao
Tài-tàu	Decapitação
Cūi-ngù	Cerambycidae
Buŏi	Voo
Ŭi-nà̤-sṳ̆ Sĕng-lī-nè̤ng	The Merchant of Venice
Ū-ì-săng	Monte Wuyi
Ŭ-sŭ-lī-gĕ̤ng	Rio Ussuri
Dĕ̤ng-cé	Solstício de inverno
Tiĕng-huòng	Imperador do Japão
Kăi-hŭng	Kaifeng
Sĭng-dài-bê	Novo dólar taiwanês
Sák-mū-ngī-gé-hâiu-cṳ̆	II Samuel
Lăk-dâi-cé-liŏk Hâ	II Crônicas
Liĕk-uòng-gé-liŏk Hâ	II Reis
Nguòng Sié-kāi	Yuan Shikai
Gă-lṳ̀ng Huòng-dá̤	Gia Long
John Wesley	John Wesley
Siăh	Alimentação
Perlis	Perlis
Negeri Sembilan	Negeri Sembilan
Labuan	Labuan
Lṳ̀ng	Dragão chinês
Iòng-iù-gàu	Lâmpada de querosene
Cần Thơ	Can Tho
Gĭng-cŭk	Vietnamitas
Ciĕng-bò̤	Champa
Diòng-gáu-sê̤ṳ	Missão
Uōng-dâi Cièng-tiàng	Great Expectations
Niōng-bēng	Teto
Rasŏn	Rason
Guăng Ṳ̄	Guan Yu
Ŭ-gŭi	Testudinata
Tá̤	Gaveta
Gê̤ṳng-huò-dōng	Partido Republicano
Bō̤-dâi Huòng-dá̤	Bao Dai
Siê-iù	Molho de soja
Ŭ-lṳ̀ng-dà	Oolong (chá)
Huōi-lṳ̀ng-guō	Pitaia
Gê̤ṳng-sāng-dōng	Partido Comunista
Chái Ĭng-ùng	Tsai Ing-wen
Băh-cṳ̄ng-nè̤ng	Brancos
Ŏ̤-mì-tò̤-hŭk	Amitaba
Ciŭ Giĕk-lùng	Jay Chou
Orhan Pamuk	Orhan Pamuk
Carpineto Romano	Carpineto Romano
Ngū-dâi Sĕk-guók	Período das Cinco Dinastias e dos Dez Reinos
Cō̤	Jujuba
Tā̤-ṳ̆k	Educação física
Sĭng-báe̤k	Nova Taipé
Dài-dṳ̆ng	Taichung
Làu Bê	Liu Bei
Gĭng-muòng	Kinmen
Giĕ-lè̤ng	Keelung
Săi	Sai
Jun Ji-hyun	Wang Ji-hyun
Gáuk-gáuk	Osso
Amuro Namie	Namie Amuro
Diêng-tù	Bataria
Gê̤ṳ-gê̤ṳ	Muleta
Nakashima Mika	Mika Nakashima
Hù-lì-mà	Mustela sibirica
Gŏ̤-ák-guŏ	Panela de pressão
Chagang Dô̤	Chagang
Ké̤ṳk-siăh	Mendigo
Sŏng-ngù	Wu Oriental
Siông Cĭng	Shō Shin
Â-dáu	Tarde
Huòng Tái-gĭk	Huang-Taiji
Guŏng-sê̤ṳ Huòng-dá̤	Guangxu
Alan Dawa Dolma	Alan Dawa Dolma
Ngù-mō̤-ngù-giāng	Caracol
Takeshi Kaneshiro	Takeshi Kaneshiro
Sông-dê Huòng-dá̤	Shunzhi
Nū-ī-hăk-cà̤	Nurhachi
Sŏng Guòng	Sun Quan
Cò̤ Pī	Cao Pi
Ciōng Gĭng-guók	Chiang Ching-kuo
Uòng Mì	Wang Wei
Lī Dĕng-hŭi	Lee Teng-hui
Ṳ̆ng-céng Huòng-dá̤	Yongzheng
Dùng-dê Huòng-dá̤	Tongzhi
Dŭng-huòng	Dunhuang
Hiŏng-iòng-guă	Chuchu
Uòng Ăng-sĭk	Wang Anshi
Tokugawa Yoshimune	Tokugawa Yoshimune
Săng-ā	Sanya
Seo Jae-pil	Philip Jaisohn
Guók-ngṳ̄	Língua nacional
Sṳ̆k-háng	Shu Han
Cò̤-ngôi	Cao Wei
Hiŏng-gŭ	Shiitake
Sā̤-tŏng	Banho
Gă-kéng Huòng-dá̤	Jiaqing
Páuk Hièng-īng	Pak Hon-Yeong
Dièu-siēng Sié-cū	Sejo de Joseon
Dô̤-guŏng Huòng-dá̤	Daoguang
Hièng-hŭng Huòng-dá̤	Xianfeng
Hùng Séu-ciòng	Hong Xiuquan
Gĭng-kiŏk	Ópera de Pequim
Báik-guá	Ba gua
Sṳ̆-mā Hé	Sima Yi
Áng-pŭng	Ampulex compressa
Hŭng-sṳ̆k	Convenção (norma)
Ièu-cŭk	Yao (etnia)
Biék	Trionychidae
Dièu-siēng Tái-cū	Taejo de Joseon
Báik-nguŏk-cáik	Festival da Lua
Guŏng-Dṳ̆ng Huòng-dá̤	Nguyen Hue
Ngà̤ Táuk-sĭng	Watchman Nee
Liŏh-chiông-gĭ	Videocassete
Dâng-chái	Mytilidae
Gā-cō̤	Siphonaptera
Mā-tái Hók Ĭng	Evangelho segundo Mateus
Sĕk-cê-gá	Cruz cristã
Tè̤ng-chō̤	Ophiocordyceps sinensis
Ī-hók-sū Cṳ̆	Epístola aos Efésios
Sìng	Sing
Mā-cū (Sìng)	Mazu
Uŏk-nàng Gê̤ṳng-sāng-dōng	Partido Comunista do Vietnã
10000	Dez mil
Chék Gié-guŏng	Qi Jiguang
Dâing Lâ̤-gŭng	Teresa Teng
Mìng-sìng Huòng-hâiu	Myeongseong da Coreia
Cṳ̀-ciŏng	Ladrilho
Hĭng-sŏng Dâi-iêng-gŭng	Heungseon Daewongun
Gŏ̤ Dé-sêng	Gao Zhisheng
Huăng-giāng	Estrangeiro
Tiăng-dŏng	Sala de estar
Ók-dāu	Ferro de passar
Liŏh-dà	Chá verde
Liŏh-dâu	Vigna radiata
Dièu-siēng-cŭk	Coreanos
Yu Kil-chun	Yu Kil-chun
Páuk Hông-ciŏ	Pak Pong-ju
Kŭmgang-săng Guăng-guŏng Dê-kṳ̆	Região Turística de Kumgang-san
Páuk Dṳ̀ng-iòng	Park Jung-yang
Hòng-ciŭ Să̤-hù	Lago do Oeste
Gă-săk-giāng	Minicarro
Gái-chái	Mostarda-castanha
Bù-sìng	Muscidae
Ciū-ciòng	Jiuquan
Hŭ-huò-hô̤-dĕk	Hohhot
Ngù Chĭng-nguòng	Go Seigen
Hà-iù	Molho de peixe
Băh-ngiê	Isoptera
Ngièng Hók	Yan Fu
Páu-diông	Panchão
Hṳ̆ng-dòng	Tórax
Mā-cū (Dō̤)	Ilhas Matsu
Să̤-cŏng	Terno
Ìng-cṳ̄	Filho do Homem
Hiroshima-gâing	Província de Hiroshima
Chiēng-cāi	Dedos da mão
Hwanghae Nàng-dô̤	Hwanghae Sul
Dùng-cé	Camarada
Hŭng-tiŭ	Bomba de bicicleta
Guōng-guă	Abóbora-d'água
Káh-gă	Hacá
Bâng-ā	Mudez
Nàng-gĭng Dâi-hŏk	Universidade de Nanquim
Chék-nguŏk-buáng	Festival dos fantasmas
Uòng Sĭng-lìng	Cyndi Wang
Hù-siŭ	Dojô (ictiologia)
Ciŭ Ùng-uòng	Conde Wen
Lī Siòng-sêu	Witness Lee
Buò-gì	Livistona chinensis
Dièu-siēng Buáng-dō̤ lĭk-sṳ̄	História da Coreia
Sinŭiju Dĕk-biék Hèng-céng-kṳ̆	Região Administrativa Especial de Shinuiju
Guók-lĭk Dṳ̆ng-iŏng Dâi-hŏk	Universidade Nacional Central
Dìng Gīng-ê̤ṳng	Jingrun Chen
Huá-huá	Mainá-de-crista
Háng-cê Ùng-huá-kuŏng	Esfera cultural da Ásia Oriental
Hók-gióng tū-làu	Tulou de Fujian
Nê-hù	Erhu
Pū-tŭng-uâ	Mandarim padrão
Mē̤ng-giāng	Psychodidae
Mĭk-pŭng	Apidae
Okinawa-gâing	Okinawa
Nàng-ā	Ásia Meridional
Tŏng-diè-dáing	Banho público
Tì-kŭ	Scomber japonicus
Ŭ-cṳ̄ng-nè̤ng	Negros
Nàng-uŏk-guók	Nanyue
Chèng-chṳ̄	Arvicolinae
Chèng	Terra arável
Bànguâpedia	Wikipédia em min oriental
Bĭng-dê̤ṳ	Picolé
Wikipedia:Sū-iū ngṳ̄-ngiòng bēng-buōng gì Wikipedia	Wikipédia:Wikipédia em outras línguas
Ngṳ̆k-huòng-dâi-dá̤	O Imperador de Jade
Chiók	Beber
À̤-liák	Pantufa
Cé̤ṳk	Congee
Tĕng	Solenidae
Pàng-hù Gùng-dō̤	Ilhas Pescadores
Ôi	Estômago
Cṳ̆-dó̤h	Escrivaninha
Siông Hô̤	Sho Ko
Ĕ̤ng-ngiê	Tetramorium
Aragaki Yui	Yui Aragaki
Mā-lái-iè	Aranha-caranguejo
Gák-lì	Amêijoa
Gāi-gáik Kăi-huóng	Abertura econômica da China
Dṳ̀-huák	Divisão
Hù-lù	Cabaça
Tiék-guăng-ĭng	Tieguanyin
Siông Bă-cé	Sho Hashi
Siông Tái	Sho Tai
分類:Dáik-guók	Categoria:Alemanha
分類:É-dâi-lé	Categoria:Itália
分類:Mī-guók	Categoria:Estados Unidos
分類:Ngò̤-lò̤-sṳ̆	Categoria:Rússia
分類:Dṳ̆ng-guók	Categoria:China
分類:Nĭk-buōng	Categoria:Japão
分類:Ó̤-ciŭ	Categoria:Austrália
分類:Éng-nà̤	Categoria:Indonésia
分類:Hàng-guók	Categoria:Coreia do Sul
分類:Tái-guók	Categoria:Tailândia
分類:Uŏk-nàng	Categoria:Vietname
分類:Buô-ṳ̄ dông-ŭk	Categoria:Mamíferos
分類:Bà-hèng dông-ŭk	Categoria:Répteis
分類:Cēu	Categoria:Aves
分類:Cĭng-kṳ̄ng	Categoria:Fungos
分類:Sĭk-ŭk	Categoria:Plantas
分類:Ŭk-lī	Categoria:Física
分類:Huá-hŏk	Categoria:Química
分類:Lĭk-sṳ̄	Categoria:História
分類:Dê-lī	Categoria:Geografia
分類:Siâ-huôi	Categoria:Sociedade
分類:Mī-sŭk	Categoria:Artes visuais
分類:Cŭng-gáu	Categoria:Religião
分類:Tā̤-ṳ̆k	Categoria:Desportos
分類:Kuŏ-hŏk	Categoria:Ciência
分類:Gióng-dé̤ṳk-ŭk	Categoria:Construções
Gū Lò̤-mā	Roma Antiga
Regina Duarte	Regina Duarte
Cūi-kì	Lesma
分類:Sĕng-tái	Categoria:Ecologia
Sák-mū-ngī-gé-cièng-cṳ̆	I Samuel
Săng-sáiu	Horóscopo chinês
分類:Disambig	Categoria:Desambiguação
分類:Diék-hŏk	Categoria:Filosofia
分類:Sĭng-lī	Categoria:Psicologia
分類:Hŭk-gáu	Categoria:Budismo
分類:Gĭ-dók-gáu	Categoria:Cristianismo
分類:Ĭ-sṳ̆-làng-gáu	Categoria:Islamismo
分類:Iù-tái-gáu	Categoria:Judaísmo
Mā-cū	Matsu
Hô-dê̤ṳ	Yuba (comida)
Gùng	Saia
Cháe̤	Bucha (planta)
Tuyên Quang	Tuyen Quang
Iraq gâe̤ng Levant Ĭ-sṳ̆-làng-guók	Estado Islâmico do Iraque e do Levante
Dâu-mò̤-chái	Moyashi
Tău-dò̤-nó̤h	Furto
Ciĕ-muài	Gergelim
Abu Bakr al-Baghdadi	Abu Bakr al-Baghdadi
分類:Ùng-huá	Categoria:Cultura
分類:Dê-cék	Categoria:Geologia
Wikipedia:Dŏng-nièng gĭng-dáng	Wikipédia:Efemérides
模板:Tái-iòng-hiê	Predefinição:Sistema Solar
Holopedia	Wikipédia em min nan
Gì-chái	Tampala
Ciē-sáik	Púrpura
Bàng-uâ-cê	Fushaw romanizado
Luciano Huck	Luciano Huck
Gâng	Suor
Ià-huò-huà	Jeová
Sók-lŭk	Rapidez
Ák	Pato
Duâi-tàu-chái	Nabo
Huăng-siông	Mangifera indica
分類:Dáik-guók ìng-ŭk	Categoria:Alemães
分類:Mī-guók ìng-ŭk	Categoria:Estado-unidenses
分類:Iēng-uòng	Categoria:Atores
分類:Ĭng-guók ìng-ŭk	Categoria:Britânicos
分類:Huák-guók ìng-ŭk	Categoria:Franceses
模板:Chess diagram	Predefinição:Diagrama de xadrez
模板:Tl	Predefinição:Ligação para predefinição
分類:Guók-gă	Categoria:Países
Wikipedia:Hèng-céng Ìng-uòng	Wikipédia:Administradores
分類:Dṳ̆ng-guók mìng-cŭk	Categoria:Grupos étnicos da China
分類:Ìng-ŭk	Categoria:Pessoas
分類:Cék-ngiĕk	Categoria:Ocupações
Wikipedia:Gĭ-ké-nè̤ng	Wikipédia:Robôs
分類:Sì-găng	Categoria:Tempo
分類:Gĕ̤ng-tiàng	Categoria:Engenharia
分類:Cài-lâiu	Categoria:Materiais
分類:Ĭ-hŏk	Categoria:Medicina
分類:Céng-dê	Categoria:Política
分類:Gáu-ṳ̆k	Categoria:Educação
Ăi-gĭk	Egito
模板:Bot	Predefinição:Robô
Gă-nā-dâi	Canadá
分類:Iù-hié	Categoria:Jogos
分類:Ĕu-ciŭ guók-gă	Categoria:Países da Europa
分類:Ĕu-ciŭ	Categoria:Europa
模板:Documentation	Predefinição:Documentação
分類:Ê̤ṳng-hô	Categoria:!Wikipedistas por idioma
Sìng Câi-gĭ	Sung Jae-ki
模板:Softredirect	Predefinição:Pseudorredirecionamento
Wikipedia:維基數據	Wikipédia:Wikidata
模板:Chēng	Predefinição:ER
分類:Ngṳ̄-ngiòng	Categoria:Línguas
分類:Lĭk-huák	Categoria:Calendários
分類:Wikipedia	Categoria:Wikipédia
Wikipedia:Mò̤ hô-cáik sĭng-mìng	Wikipédia:Aviso geral
分類:未索引其頁面	Categoria:!Páginas não indexadas
Dâi-chṳ̄	Canguru
Adolpho Jansen Werneck de Capistrano	Adolfo Werneck
模板:!-	Predefinição:!-
模板:Smallcaps	Predefinição:Smallcaps
模板:Nowrap	Predefinição:Nowrap
Wikipedia:Ék-chiék Wikipedia dŭ găi-dŏng ô gì ùng	Wikipédia:Artigos essenciais
分類:Hĭ-ciŭ	Categoria:África
模板:Wikisource	Predefinição:Wikisource
模板:Babel	Predefinição:Babel
模板:Commons	Predefinição:Commons
模板:Reflist	Predefinição:Referências
Wikipedia:列明來源	Wikipédia:Livro de estilo/Cite as fontes
模板:Stub	Predefinição:Esboço
模板:User eo-1	Predefinição:User eo-1
模板:User eo-3	Predefinição:User eo-3
模板:User de	Predefinição:User de
模板:User de-1	Predefinição:User de-1
模板:User es	Predefinição:User es
模板:User de-3	Predefinição:User de-3
模板:User en-3	Predefinição:User en-3
模板:User en-1	Predefinição:User en-1
模板:User en-2	Predefinição:User en-2
模板:User eo-2	Predefinição:User eo-2
模板:User en-4	Predefinição:User en-4
模板:User en	Predefinição:User en
模板:User de-2	Predefinição:User de-2
模板:User es-1	Predefinição:User es-1
模板:User fr-1	Predefinição:User fr-1
模板:User it-3	Predefinição:User it-3
模板:User fr-2	Predefinição:User fr-2
模板:User ja	Predefinição:User ja
模板:User ja-1	Predefinição:User ja-1
模板:User it-1	Predefinição:User it-1
模板:User fr	Predefinição:User fr
分類:Ā-ciŭ	Categoria:Ásia
分類:Nàng Mī-ciŭ	Categoria:América do Sul
分類:Mā-lài-să̤-ā	Categoria:Malásia
模板:Mod	Predefinição:Mod
模板:SIL	Predefinição:ISO639-3Documentação
模板:User it	Predefinição:User it
模板:User es-2	Predefinição:User es-2
模板:Huăng-ngìng	Predefinição:Bem-vindo(a)
分類:Dièu-lâiu	Categoria:Condimentos
模板:Click	Predefinição:Click
分類:User fr-1	Categoria:Usuário fr-1
模板:Image label	Predefinição:Image label
模板:Category handler	Predefinição:Cat handler
模板:Wiki gĕ̤ng-tiàng	Predefinição:Wikimedia Foundation
模板:Steady	Predefinição:Estável
模板:Guók-gă	Predefinição:Info/País
模板:Documentation/docname	Predefinição:Documentação/nomedoc
模板:Cite journal	Predefinição:Citar periódico
模板:Infobox 公司	Predefinição:Info/Empresa
模板:Wikibooks	Predefinição:Wikilivros
模板:Dablink	Predefinição:Dablink
模板:Hō̤ gì ùng-ciŏng	Predefinição:Artigo destacado
分類:User en-4	Categoria:Utilizador en-4
分類:User en	Categoria:Usuários en
分類:User zh	Categoria:Usuários zh
分類:User zh-M	Categoria:Usuário zh
分類:User en-2	Categoria:Usuário en-2
模板:Infobox	Predefinição:Info
模板:User eo	Predefinição:User eo
模板:User zh	Predefinição:User zh
分類:Gáuk-guók gì lĭk-sṳ̄	Categoria:História dos países
Wikipedia:Dŏng-nièng gĭng-dáng/09 nguŏk 23 hô̤	Wikipédia:Efemérides/23 de setembro
Wikipedia:Dŏng-nièng gĭng-dáng/09 nguŏk 22 hô̤	Wikipédia:Efemérides/22 de setembro
模板:Legend	Predefinição:Legenda
Wikipedia:Dŏng-nièng gĭng-dáng/09 nguŏk 17 hô̤	Wikipédia:Efemérides/17 de setembro
Wikipedia:Dŏng-nièng gĭng-dáng/10 nguŏk 15 hô̤	Wikipédia:Efemérides/15 de outubro
模板:Cite web	Predefinição:Citar web
Wikipedia:Dŏng-nièng gĭng-dáng/09 nguŏk 28 hô̤	Wikipédia:Efemérides/28 de setembro
模板:Ombox	Predefinição:Ombox
Wikipedia:Dŏng-nièng gĭng-dáng/10 nguŏk 22 hô̤	Wikipédia:Efemérides/22 de outubro
Wikipedia:Dŏng-nièng gĭng-dáng/11 nguŏk 2 hô̤	Wikipédia:Efemérides/2 de novembro
Wikipedia:Dŏng-nièng gĭng-dáng/11 nguŏk 9 hô̤	Wikipédia:Efemérides/9 de novembro
模板:Country data	Predefinição:Dados de país
Wikipedia:Dŏng-nièng gĭng-dáng/10 nguŏk 1 hô̤	Wikipédia:Efemérides/1 de outubro
Wikipedia:Dŏng-nièng gĭng-dáng/10 nguŏk 5 hô̤	Wikipédia:Efemérides/5 de outubro
Wikipedia:Dŏng-nièng gĭng-dáng/10 nguŏk 8 hô̤	Wikipédia:Efemérides/8 de outubro
分類:Īng-sĭk	Categoria:Alimentação
模板:MongolUnicode	Predefinição:MongolUnicode
Wikipedia:Dŏng-nièng gĭng-dáng/10 nguŏk 6 hô̤	Wikipédia:Efemérides/6 de outubro
Wikipedia:Dŏng-nièng gĭng-dáng/10 nguŏk 17 hô̤	Wikipédia:Efemérides/17 de outubro
Wikipedia:Dŏng-nièng gĭng-dáng/10 nguŏk 2 hô̤	Wikipédia:Efemérides/2 de outubro
Wikipedia:Dŏng-nièng gĭng-dáng/09 nguŏk 16 hô̤	Wikipédia:Efemérides/16 de setembro
Wikipedia:Dŏng-nièng gĭng-dáng/09 nguŏk 19 hô̤	Wikipédia:Efemérides/19 de setembro
Wikipedia:Dŏng-nièng gĭng-dáng/10 nguŏk 25 hô̤	Wikipédia:Efemérides/25 de outubro
Wikipedia:Dŏng-nièng gĭng-dáng/11 nguŏk 10 hô̤	Wikipédia:Efemérides/10 de novembro
Wikipedia:Dŏng-nièng gĭng-dáng/10 nguŏk 21 hô̤	Wikipédia:Efemérides/21 de outubro
Wikipedia:Dŏng-nièng gĭng-dáng/09 nguŏk 15 hô̤	Wikipédia:Efemérides/15 de setembro
Wikipedia:Dŏng-nièng gĭng-dáng/09 nguŏk 4 hô̤	Wikipédia:Efemérides/4 de setembro
Wikipedia:Dŏng-nièng gĭng-dáng/09 nguŏk 8 hô̤	Wikipédia:Efemérides/8 de setembro
Wikipedia:Dŏng-nièng gĭng-dáng/10 nguŏk 4 hô̤	Wikipédia:Efemérides/4 de outubro
Wikipedia:Dŏng-nièng gĭng-dáng/09 nguŏk 1 hô̤	Wikipédia:Efemérides/1 de setembro
Wikipedia:Dŏng-nièng gĭng-dáng/09 nguŏk 6 hô̤	Wikipédia:Efemérides/6 de setembro
Wikipedia:Dŏng-nièng gĭng-dáng/09 nguŏk 25 hô̤	Wikipédia:Efemérides/25 de setembro
Wikipedia:Dŏng-nièng gĭng-dáng/09 nguŏk 10 hô̤	Wikipédia:Efemérides/10 de setembro
Wikipedia:Dŏng-nièng gĭng-dáng/09 nguŏk 26 hô̤	Wikipédia:Efemérides/26 de setembro
Wikipedia:Dŏng-nièng gĭng-dáng/09 nguŏk 20 hô̤	Wikipédia:Efemérides/20 de setembro
Wikipedia:Dŏng-nièng gĭng-dáng/11 nguŏk 4 hô̤	Wikipédia:Efemérides/4 de novembro
Wikipedia:Dŏng-nièng gĭng-dáng/09 nguŏk 30 hô̤	Wikipédia:Efemérides/30 de setembro
Wikipedia:Dŏng-nièng gĭng-dáng/10 nguŏk 7 hô̤	Wikipédia:Efemérides/7 de outubro
Wikipedia:Dŏng-nièng gĭng-dáng/10 nguŏk 19 hô̤	Wikipédia:Efemérides/19 de outubro
Wikipedia:Dŏng-nièng gĭng-dáng/09 nguŏk 27 hô̤	Wikipédia:Efemérides/27 de setembro
Wikipedia:Dŏng-nièng gĭng-dáng/09 nguŏk 11 hô̤	Wikipédia:Efemérides/11 de setembro
Wikipedia:Dŏng-nièng gĭng-dáng/11 nguŏk 8 hô̤	Wikipédia:Efemérides/8 de novembro
Wikipedia:Dŏng-nièng gĭng-dáng/11 nguŏk 1 hô̤	Wikipédia:Efemérides/1 de novembro
Wikipedia:Dŏng-nièng gĭng-dáng/11 nguŏk 7 hô̤	Wikipédia:Efemérides/7 de novembro
Wikipedia:Dŏng-nièng gĭng-dáng/10 nguŏk 11 hô̤	Wikipédia:Efemérides/11 de outubro
Wikipedia:Dŏng-nièng gĭng-dáng/11 nguŏk 3 hô̤	Wikipédia:Efemérides/3 de novembro
Wikipedia:Dŏng-nièng gĭng-dáng/10 nguŏk 20 hô̤	Wikipédia:Efemérides/20 de outubro
Wikipedia:Dŏng-nièng gĭng-dáng/10 nguŏk 16 hô̤	Wikipédia:Efemérides/16 de outubro
Wikipedia:Dŏng-nièng gĭng-dáng/10 nguŏk 14 hô̤	Wikipédia:Efemérides/14 de outubro
Wikipedia:Dŏng-nièng gĭng-dáng/10 nguŏk 18 hô̤	Wikipédia:Efemérides/18 de outubro
Wikipedia:Dŏng-nièng gĭng-dáng/10 nguŏk 24 hô̤	Wikipédia:Efemérides/24 de outubro
Wikipedia:Dŏng-nièng gĭng-dáng/10 nguŏk 3 hô̤	Wikipédia:Efemérides/3 de outubro
Wikipedia:Dŏng-nièng gĭng-dáng/09 nguŏk 7 hô̤	Wikipédia:Efemérides/7 de setembro
分類:Săng	Categoria:Montanhas
模板:IPA	Predefinição:AFI
分類:Céng-dê-gă	Categoria:Políticos
分類:Mī-ciŭ	Categoria:América
Tàng	Fleuma
分類:Gáuk-guók gì ìng-ŭk	Categoria:Pessoas por nacionalidade
模板:Wiki-huá	Predefinição:Wikificação
分類:Gŭng-sê̤ṳ	Categoria:Tópicos militares
模板:Increase	Predefinição:Aumento
模板:Ciŭ-gĭ-biēu	Predefinição:Tabela periódica compacta
模板:User nl	Predefinição:User nl
模板:Infobox 網站	Predefinição:Info/Sítio
Wikipedia:Dŏng-nièng gĭng-dáng/10 nguŏk 12 hô̤	Wikipédia:Efemérides/12 de outubro
模板:Decrease	Predefinição:Baixa
模板:User no-2	Predefinição:User no-2
模板:Image label end	Predefinição:Image label end
模板:Documentation subpage	Predefinição:Subpágina de documentação
Wikipedia:Dŏng-nièng gĭng-dáng/11 nguŏk 5 hô̤	Wikipédia:Efemérides/5 de novembro
Wikipedia:Dŏng-nièng gĭng-dáng/10 nguŏk 13 hô̤	Wikipédia:Efemérides/13 de outubro
Wikipedia:Dŏng-nièng gĭng-dáng/09 nguŏk 3 hô̤	Wikipédia:Efemérides/3 de setembro
Wikipedia:Dŏng-nièng gĭng-dáng/09 nguŏk 24 hô̤	Wikipédia:Efemérides/24 de setembro
模板:Purge	Predefinição:Purgar
模板:Lang-la	Predefinição:Lang-la
分類:Cìng-gāng	Categoria:Sentimentos
模板:Dṳ̆ng-huà Ìng-mìng Gê̤ṳng-huò-guók Hèng-céng-kṳ̆	Predefinição:Subdivisões da República Popular da China
模板:Userpage	Predefinição:Página de usuário
模板:User	Predefinição:Usuário2
Wikipedia:Dŏng-nièng gĭng-dáng/09 nguŏk 12 hô̤	Wikipédia:Efemérides/12 de setembro
Wikipedia:Dŏng-nièng gĭng-dáng/09 nguŏk 2 hô̤	Wikipédia:Efemérides/2 de setembro
Wikipedia:Dŏng-nièng gĭng-dáng/11 nguŏk 6 hô̤	Wikipédia:Efemérides/6 de novembro
Wikipedia:Dŏng-nièng gĭng-dáng/09 nguŏk 18 hô̤	Wikipédia:Efemérides/18 de setembro
Wikipedia:Dŏng-nièng gĭng-dáng/10 nguŏk 10 hô̤	Wikipédia:Efemérides/10 de outubro
Wikipedia:Dŏng-nièng gĭng-dáng/10 nguŏk 9 hô̤	Wikipédia:Efemérides/9 de outubro
Wikipedia:Dŏng-nièng gĭng-dáng/10 nguŏk 23 hô̤	Wikipédia:Efemérides/23 de outubro
模板:Image label small	Predefinição:Image label small
模板:Ĕu-ciŭ	Predefinição:Mapa detalhado da Europa
模板:User fr-3	Predefinição:User fr-3
模板:Allcaps	Predefinição:Allcaps
模板:Gô-dā̤ gì guók-gă	Predefinição:Info/Estado extinto
Hakkâpedia	Wikipédia em chinês hakka
分類:User ja-M	Categoria:Usuário ja
模板:Gì-ngiê	Predefinição:Desambiguação
分類:Dièu-siēng lĭk-sṳ̄	Categoria:História da Coreia
模板:User no-3	Predefinição:User no-3
模板:Lang-grc	Predefinição:Lang-grc
模板:User ksh	Predefinição:User ksh
模板:AUS	Predefinição:AUS
模板:Lifetime	Predefinição:NF
模板:Lang-en	Predefinição:Lang-en
分類:Sĕng-ŭk	Categoria:Organismos
模板:ISO 639 name conversion template doc	Predefinição:ISO 639 Predefinição de conversão de nome doc
Wikipedia:Dŏng-nièng gĭng-dáng/09 nguŏk 14 hô̤	Wikipédia:Efemérides/14 de setembro
Wikipedia:Dŏng-nièng gĭng-dáng/09 nguŏk 9 hô̤	Wikipédia:Efemérides/9 de setembro
Wikipedia:Dŏng-nièng gĭng-dáng/09 nguŏk 13 hô̤	Wikipédia:Efemérides/13 de setembro
分類:User vi-3	Categoria:Usuário vi-3
模板:User la-1	Predefinição:User la-1
分類:User fr	Categoria:Usuários fr
分類:User ja	Categoria:Usuários ja
分類:User la	Categoria:Usuários la
分類:User fr-3	Categoria:Usuário fr-3
分類:User it-3	Categoria:Usuário it-3
分類:User ja-3	Categoria:Usuário ja-3
分類:User fr-2	Categoria:Usuário fr-2
分類:User it-2	Categoria:Usuário it-2
分類:User ja-2	Categoria:Usuário ja-2
分類:User la-2	Categoria:Usuário la-2
分類:User ko-M	Categoria:Usuário ko
分類:User fr-M	Categoria:Usuário fr
分類:User it-M	Categoria:Usuário it
分類:User nl-M	Categoria:Usuário nl
分類:Ùng-cê	Categoria:Sistemas de escrita
分類:Dô̤-gáu	Categoria:Taoismo
分類:Dō̤	Categoria:Ilhas
分類:User de	Categoria:Usuários de
分類:User de-2	Categoria:Usuário de-2
分類:User de-3	Categoria:Usuário de-3
分類:User de-M	Categoria:Usuário de
分類:User en-3	Categoria:Usuário en-3
分類:User en-M	Categoria:Usuário en
分類:User es	Categoria:Usuários es
分類:User es-1	Categoria:Usuário es-1
分類:User es-2	Categoria:Usuário es-2
分類:User es-3	Categoria:Usuário es-3
分類:User es-M	Categoria:Usuário es
分類:Chió	Categoria:Casa
分類:User it	Categoria:Usuários it
分類:User it-1	Categoria:Usuário it-1
分類:User ja-1	Categoria:Usuário ja-1
分類:User ko	Categoria:Usuários ko
分類:Mī-guók gì ciŭ	Categoria:Estados dos Estados Unidos
分類:User ko-1	Categoria:Usuário ko-1
分類:User ko-2	Categoria:Usuário ko-2
分類:User ko-3	Categoria:Usuário ko-3
分類:User ksh	Categoria:Usuários ksh
分類:User ksh-M	Categoria:Usuário ksh
分類:User la-1	Categoria:Usuário la-1
Wikipedia:Dŏng-nièng gĭng-dáng/09 nguŏk 29 hô̤	Wikipédia:Efemérides/29 de setembro
分類:User la-3	Categoria:Usuário la-3
分類:User la-M	Categoria:Usuário la
Wikipedia:Dŏng-nièng gĭng-dáng/09 nguŏk 5 hô̤	Wikipédia:Efemérides/5 de setembro
模板:Distinguish	Predefinição:Não confundir com
模板:Information	Predefinição:Information
分類:Huâng-cô̤i	Categoria:Criminalidade
Sáik-mō̤	Piolho
分類:Séng-sék	Categoria:Ciência da informação
分類:Hāi	Categoria:Mares
Hŭng-siéng	Ventilador
分類:Guōng-dĕ̤ng	Categoria:Guangdong
分類:Hók-gióng	Categoria:Fujian
分類:Gĭng-cá̤	Categoria:Economias
分類:Ciék-ciĕ dông-ŭk	Categoria:Artrópodes
分類:Hĭ-ciŭ guók-gă	Categoria:Países de África
分類:Gáuk-guók gì gáu-ṳ̆k	Categoria:Educação por país
模板:User ja-2	Predefinição:User ja-2
模板:User ja-3	Predefinição:User ja-3
分類:User vi	Categoria:Usuários vi
分類:User vi-1	Categoria:Usuário vi-1
分類:User vi-2	Categoria:Usuário vi-2
分類:User vi-M	Categoria:Usuário vi
分類:Ciék-gŏng	Categoria:Zhejiang
分類:Ĭng-ngŏk-gă	Categoria:Músicos
模板:Lang	Predefinição:Lang
Wikipedia:Dŏng-nièng gĭng-dáng/09 nguŏk 21 hô̤	Wikipédia:Efemérides/21 de setembro
分類:Hŏk-sŭk	Categoria:Academia
Bì-bà (ngŏk-ké)	Pipa (instrumento musical)
分類:Wikimedia gĕ̤ng-tiàng	Categoria:Projetos Wikimedia
分類:Gì-lôi	Categoria:Jogos de estratégia abstratos
模板:Nocaps	Predefinição:Nocaps
分類:Hŭng-sṳ̆k	Categoria:Convenções culturais
模板:Infobox Language/family-color	Predefinição:Info/Língua/corfamília
分類:Ò̤	Categoria:Rios
模板:User la-2	Predefinição:User la-2
模板:User no-1	Predefinição:User no-1
模板:User zh-1	Predefinição:User zh-1
模板:User zh-2	Predefinição:User zh-2
模板:User zh-3	Predefinição:User zh-3
分類:Dâi-hàng Mìng-guók ìng-ŭk	Categoria:Sul-coreanos
分類:Sôi-diēng ìng-ŭk	Categoria:Suecos
分類:Nĭk-buōng ìng-ŭk	Categoria:Japoneses
分類:Dài-uăng ìng-ŭk	Categoria:Taiwaneses
分類:User nl	Categoria:Usuários nl
分類:User zh-1	Categoria:Usuário zh-1
分類:User zh-3	Categoria:Usuário zh-3
分類:User zh-2	Categoria:Usuário zh-2
分類:Cāi	Categoria:Papel
分類:Ông-ò̤	Categoria:Canais
分類:Uŏk-nàng ìng-ŭk	Categoria:Vietnamitas
分類:Sùi-dièu huòng-dá̤	Categoria:Imperadores da Dinastia Sui
分類:Dòng-dièu huòng-dá̤	Categoria:Imperadores da Dinastia Tang
分類:Mìng-dièu huòng-dá̤	Categoria:Imperadores da Dinastia Ming
分類:Ngò̤-lò̤-sṳ̆ ìng-ŭk	Categoria:Russos
分類:Hiŏng-gē̤ng ìng-ŭk	Categoria:Hongueconguenses
分類:Ciĕk-káik ìng-ŭk	Categoria:Checos
分類:Tái-guók ìng-ŭk	Categoria:Tailandeses
分類:Sáng	Categoria:Sobrenomes
分類:Dièu-siēng Mìng-ciō-ciō-ngiê Ìng-mìng Gê̤ṳng-huò-guók	Categoria:Coreia do Norte
分類:Dṳ̆ng-guók ìng-ŭk	Categoria:Chineses
分類:Dièu-siēng	Categoria:Coreia
分類:Dài-uăng	Categoria:Taiwan
分類:Dièu-siēng Mìng-ciō-ciō-ngiê Ìng-mìng Gê̤ṳng-huò-guók ìng-ŭk	Categoria:Norte-coreanos
分類:Dâi-iòng-ciŭ guók-gă	Categoria:Países da Oceania
分類:Báe̤k Mī-ciŭ guók-gă	Categoria:Países da América do Norte
分類:Ngṳ̀	Categoria:Peixes
分類:Cūi-guō	Categoria:Frutos
分類:Niōng-tā̤ dông-ŭk	Categoria:Moluscos
分類:Só-cê	Categoria:Sistemas de numeração
分類:Gióng-dé̤ṳk cài-lâiu	Categoria:Materiais de construção
分類:Dông-ŭk	Categoria:Animais
分類:Ciáh-tùi dông-ŭk	Categoria:Vertebrados
分類:Guòng-lé	Categoria:Direitos
分類:Ìng-guòng	Categoria:Direitos humanos
分類:Ū-ké	Categoria:Armas
分類:Nàng Mī-ciŭ guók-gă	Categoria:Países da América do Sul
分類:Gă-sĭ	Categoria:Mobiliário
分類:Ké-chiông	Categoria:Meteorologia
分類:Dṳ̆ng Mī-ciŭ	Categoria:América Central
分類:Hiŏng-gē̤ng	Categoria:Hong Kong
分類:Ĭ-siòng	Categoria:Vestuário
分類:Cáik-nĭk	Categoria:Festivais
分類:Kuàng-ciék dông-ŭk	Categoria:Anelídeos
分類:Bâng	Categoria:Doenças
分類:Kiŏng-diòng dông-ŭk	Categoria:Cnidários
分類:Gùng-dō̤	Categoria:Arquipélagos
分類:Káh-dièu-nó̤h	Categoria:Brinquedos
分類:Gă-dìng	Categoria:Família
分類:Dṳ̆ng-guók huòng-dá̤	Categoria:Imperadores da China
分類:Huòng-dá̤	Categoria:Imperadores
分類:Céng-dièu huòng-dá̤	Categoria:Imperadores da Dinastia Jin (265–420)
分類:Chĭng-dièu huòng-dá̤	Categoria:Imperadores da Dinastia Qing
分類:Háng-dièu huòng-dá̤	Categoria:Imperadores da Dinastia Han
分類:Báe̤k Mī-ciŭ	Categoria:América do Norte
分類:Gŏ̤-chiū	Categoria:Cantores
分類:Hù	Categoria:Lagos
分類:Só-hŏk-gă	Categoria:Matemáticos
模板:Infobox ngṳ̄-ngiòng	Predefinição:Info/Língua
分類:Dâi-iòng-ciŭ	Categoria:Oceania
分類:Tiĕng-căi	Categoria:Desastres naturais
分類:Gô-dā̤ gì guók-gă	Categoria:Estados extintos
Vĩnh Long	Vinh Long
分類:Dṳ̆ng-huà Ìng-mìng Gê̤ṳng-huò-guók	Categoria:República Popular da China
分類:Giông-kŏng	Categoria:Saúde
分類:Sĕng-lī	Categoria:Fisiologia
Trojany	Trojany
模板:Infobox color	Predefinição:Info/Cor
分類:Ā-ciŭ guók-gă	Categoria:Países da Ásia
分類:Mī-ciŭ guók-gă	Categoria:Países da América
模板:User la	Predefinição:User la
模板:ISO 639 name en	Predefinição:ISO 639 nome en
分類:Ŭng-ciŭ	Categoria:Wenzhou
分類:Huák-lŭk	Categoria:Legislação
分類:Káh-gă	Categoria:Hacá
分類:Dṳ̆ng Mī-ciŭ guók-gă	Categoria:Países da América Central
分類:Bēng-guòng	Categoria:Direitos autorais
分類:Biēu-cìng	Categoria:Expressão facial
分類:Ôi-sĕng	Categoria:Higiene
分類:Dṳ̆ng-huà Mìng-guók	Categoria:República da China
模板:Image label begin	Predefinição:Image label begin
模板:Dṳ̆ng-huà Mìng-guók Hèng-céng-kṳ̆	Predefinição:Divisões administrativas da República da China
分類:Sĕng-uăk	Categoria:Vida pessoal
Uòng-pŭng	Vespa
模板:User vi	Predefinição:User vi
分類:User en-1	Categoria:Usuário en-1
分類:User de-1	Categoria:Usuário de-1
分類:Gă-sĭ-huă	Categoria:Ferramentas
Lăk-dâi-cé-liŏk Siông	I Crônicas
分類:Mìng-cŭk	Categoria:Etnicidade
Wikipedia:失效鏈接	Wikipédia:Ligação inativa
Guă-cī	Egusi
Liù-giù	Ryūkyū
模板:Sèng nièng	Predefinição:AC
模組:Citation/CS1/Whitelist	Módulo:Citation/CS1/Whitelist
Hù-diĕk	Borboleta
Chái-tàu	Rabanete
模板:Infobox Language/genetic	Predefinição:Info/Língua/genetic2
模板:Ping	Predefinição:Responder a
Yun Hyon-seok	Yun Hyon-seok
模組:Arguments	Módulo:Arguments
特殊:最近其改變	Especial:Mudanças recentes
模組:Citation/CS1	Módulo:Citation/CS1
模組:Citation/CS1/Configuration	Módulo:Citation/CS1/Configuration
模組:TableTools	Módulo:TableTools
模組:HtmlBuilder	Módulo:HtmlBuilder
模組:Math	Módulo:Math
模組:Infobox	Módulo:Infobox
Ciá	Saccharum
