非洲	África
日本	Japão
南美洲	América do Sul
Nò-vî	Noruega
Sû-kak-làn	Escócia
Vî-ngì-sṳ̂	País de Gales
Pet Oi-ngì-làn	Irlanda do Norte
Hiûng-ngà-li	Hungria
Sî-pân-ngà	Espanha
Mî-koet	Estados Unidos
Pí-li-sṳ̀	Bélgica
Lù-sêm-pó	Luxemburgo
Yî-chhiu	Universo
Thi-khiù	Terra
Sâng-miang	Vida
Ngìn-lui	Homo sapiens
George Washington	George Washington
Fûn-làn	Finlândia
Shuì-tién	Suécia
Tan-ma̍k	Dinamarca
Pô-làn	Polónia
Li̍p-thâu-vón	Lituânia
Yi-thai-li	Itália
Shuì-sṳ	Suíça
O-thi-li	Áustria
Hî-lia̍p	Grécia
Thú-ngí-khì	Turquia
Phù-thò-ngà	Portugal
歐洲	Europa
亞洲	Ásia
北美洲	América do Norte
南極洲	Antártida
Vì-kî Pak-khô	Wikipédia
Hò-làn	Países Baixos
Néu-yok-sṳ	Nova Iorque
Fà-sṳ̀n-tun Kô-lùn-pí-â Thi̍t-khî	Washington, D.C.
Khiu-kîm-sân	São Francisco (Califórnia)
Pak-lìm	Berlim
Lo̍k-chhám-kî	Los Angeles
Thien-nó	Computador
Mióng-chi-mióng-lu	Internet
Barack Obama	Barack Obama
Vû-lâ-kûi	Uruguai
Lùn-tûn	Londres
Phìn-kó	Maçã
Pâ-lì-sṳ	Paris
Â-pak-lâ-hón Lìm-khén	Abraham Lincoln
Google	Google
Me̍t-sî-kô	México
Thai-sî-yòng	Oceano Atlântico
Thai-phìn-yòng	Oceano Pacífico
Kâ-li-fuk-nì-â	Califórnia
Pô-sṳ-tun	Boston
Fó-sên	Marte (planeta)
Âi-set-ngò-pí-â	Etiópia
Sṳ̂-é	Leão
Fap-koet	França
Sṳ-kie-ngî	Esperanto
Kiéu-è	Canis lupus familiaris
Yîn-koet	Reino Unido
Meu-é	Gato
中華人民共和國	República Popular da China
Fap-ngî	Língua francesa
Ǹg-è	Peixe
Pâ-sî	Brasil
François Hollande	François Hollande
Ngò-lò-sṳ̂	Rússia
Kîn-ǹg	Cetáceos
Chang-fông-hìn	Quadrado
Mong-kó	Manga (fruta)
Tô-lùn-tô	Toronto
Â-lâ-pâ-mâ	Alabama
Québec-sén	Quebec
Boeing 747	Boeing 747
Jimmy Wales	Jimmy Wales
Tet-koet	Alemanha
Pha̍k-ngò-lò-sṳ̂	Bielorrússia
Tet-ngî	Língua alemã
Pên-tó	Islândia
Song-ti	Deus
Oi-sâ-nì-â	Estónia
David Cameron	David Cameron
Thú-sên	Saturno (planeta)
Ku-thin-yi̍t Fî-kî	Avião
1	Um
2	Dois
3	Três
4	Quatro
5	Cinco
George W. Bush	George W. Bush
Lâ-thot-vì-â	Letónia
Vû-khiet-làn	Ucrânia
Tshia̍p-khiet	República Checa
Sṳ̂-lo̍k-vì-nì-â	Eslovénia
Lò-mâ-nì-â	Roménia
Pó-kâ-li-â	Bulgária
Lò-mâ	Roma
Mâ-khì-tun	República da Macedónia
Â-ngì-pâ-nì-â	Albânia
Khiet-lò-âi-sî-â	Croácia
Pô-sṳ-nì-â lâu Het-set-kô-vì-ná	Bósnia e Herzegovina
Â-set-pai-kiông	Azerbaijão
Set-phû-lu-sṳ̂	Chipre
Kak-lû-kit-â	Geórgia
Hâ-sat-khiet-sṳ̂-thán	Cazaquistão
Mí-li-thai	Malta
Mô-na̍p-kô	Mónaco
Mùng-thi̍t-nui-kô-lò	Montenegro
Sṳn Mâ-li-nok	San Marino
Kú-pâ	Cuba
Eiffel Thiet-thap	Torre Eiffel
Yin-thu-nì-sî-â	Indonésia
Wolfgang Amadeus Mozart	Wolfgang Amadeus Mozart
Pi-tô-fûn	Ludwig van Beethoven
Thú-ngí-khì-ngî	Língua turca
Nàm-fî	África do Sul
Vû-tsṳ̂-phe̍t-khiet-sṳ̂-thán	Uzbequistão
Pô-tsṳ-nàm	Poznań
Fà-sâ	Varsóvia
Súi	Água
Thien-sṳ	Televisão
Chṳ-li	Chile
Yâ-sû	Jesus
Súi-sên	Mercúrio (planeta)
Li̍t-sṳ́	História
Phìn-kó Kûng-sṳ̂	Apple
Kîm-sên	Vénus (planeta)
Ngî-ngièn	Linguagem
Muk-sên	Júpiter (planeta)
Thiên-vòng-sên	Urano (planeta)
Pu-lie̍t-thap-nì	Bretanha
Hói-vòng-sên	Netuno (planeta)
Thiên-vùn-ho̍k	Astronomia
Sîn-kâ-po	Singapura
Khô-ho̍k	Ciência
Montréal	Montreal
Lie̍t-kî-tûn-sṳ-tên	Liechtenstein
Kiam-khiâu	Cambridge
Thi-ngi-chhṳ Sṳ-kie Thai-chan	Segunda Guerra Mundial
Cologne	Colônia (Alemanha)
Kak-tên-nì-â	Gdynia
Sṳ̍p-chhiet-chhiâng	Estetino
Sṳ-ho̍k	Matemática
Lâ-tên-ngî	Língua latina
Pâ-lìm	Bahrein
Â-mî-nì-â	Arménia
Set-ngì-vì-â	Sérvia
Ngie̍t-khiù	Lua
Àu-thai-li-â	Austrália
Vu̍t-lî-ho̍k	Física
Â-kîn-thìn	Argentina
Pi-lû	Peru
Sâng-vu̍t-ho̍k	Biologia
Tsêu-siên Mìn-tsú Tsú-ngi Ngìn-mìn Khiung-fò-koet	Coreia do Norte
Kán-pu-chhài	Camboja
Khiúng-liùng	Dinossauros
Yî-sṳ̂-làn-kau	Islão
Lech Wałęsa	Lech Wałęsa
Lin-é	Roda
Lyon	Lyon
Êu-chû Lièn-mèn	União Europeia
Rhône-Alpes	Ródano-Alpes
Chhiòn-khiù Chṳ̂-sín Mióng	World Wide Web
Ńg-ngìn	Mulher
Khiûng-tsiâu	Banana
Fâ	Flor
Mâ-lî-â-na̍p-hói	Fossa das Marianas
Chû-mu̍k-lòng-mâ-fûng	Monte Everest
Sàng-sṳ	Cidade
Nâ-pho-lùn yit-sṳ	Napoleão Bonaparte
Ngit-tèu	Sol
Pâ-sṳ-tet	Louis Pasteur
大洋洲	Oceania
Thai-yòng Hì	Sistema Solar
Pô-lò-tit-hói	Mar Báltico
Ngâ-chhṳ	Dente
Khîn	Hidrogénio
Hoi (氦)	Hélio
Angela Merkel	Angela Merkel
Lî	Lítio
Phì	Berílio
Si	Livro
Ngit	Dia
Ngièn	Ano
Sṳ-ki	Século
Lò-tsṳ (Pô-làn)	Łódź
Khà-thok-vì-chṳ	Katowice
Ngie̍t-sû-fû	Rzeszów
Phìn	Boro
Thàn	Carbono
Tham	Azoto
Yòng	Oxigénio
Hàng-sên	Planeta
Yîm-ngo̍k	Música
Rennes	Rennes
Mo̍k-sṳ̂-khô	Moscovo
Fuk	Flúor
Yi-thai-li-ngî	Língua italiana
Nái	Néon
Sṳn Pí-tet-páu	São Petersburgo
Na̍p	Sódio
北	Norte
Mî	Magnésio
Lî (鋁)	Alumínio
Néu Sî-làn	Nova Zelândia
南	Sul
Yin-thu	Índia
Si̍t	Silício
Fap	Frâncio
Lìn	Fósforo
Thiet	Ferro
Tûng-kâ	Tonga
西	Oeste
Liù-vòng	Enxofre
東	Leste
Liu̍k	Cloro
Pâ-pu-â Néu-kí-nui-â	Papua-Nova Guiné
Vî-lièn Sâ-sṳ-pí-â	William Shakespeare
Â (氬)	Árgon
Kap	Potássio
Koi	Cálcio
Yèn	Chumbo
Mùng-kú-koet	Mongólia
Khong (鈧)	Escândio
Thai	Titânio
Genghis Khan	Gengis Khan
Fàm	Vanádio
Mien-yîn	Maine
Kok	Crômio
Mâ	Equus ferus caballus
Thûng-vu̍t	Animalia
Sû-li-nàm	Suriname
Màng	Manganês
Pâ-lâ-kûi	Paraguai
Koi-â-nâ	Guiana
Ngi-su̍t	Arte
Lòi	Rênio
Kô-lùn-pí-â	Colômbia
Kû	Cobalto
Vû	Tungstênio
Ngiap (鎳)	Níquel
Fu̍t-kau	Budismo
Pô-li-vì-â	Bolívia
Tshṳ̀-nì-tha̍t lâu Tô-pâ-kô	Trinidad e Tobago
Chhṳ̍t-vu̍t	Plantae
Sîn	Zinco
Néu Hàn-pu-ha	Nova Hampshire
Pí-â-vùi-sṳ̂-thok-khiet	Białystok
Ngà-mâi-kâ	Jamaica
Mà-sat-chû-set	Massachusetts
Drenthe-sén	Drente
Overijssel-sén	Overissel
Kûa-thi-mâ-là	Guatemala
Gelderland-sén	Guéldria
Pâ-hâ-mâ	Bahamas
Không-nái-tí-khiet-chû	Connecticut
Kiê-é	Gallus gallus domesticus
Ha-vî-yî	Havaí
Fùng-tû-lâ-sṳ̂	Honduras
Tô-mí-nì-kâ	Dominica
Tô-mí-nì-kâ Khiung-fò-koet	República Dominicana
Kâ-chû (Thung-vu̍t)	Sus domesticus
Hói-thi	Haiti
Sat-ngì-ngá-tô	El Salvador
Yî-lóng	Irão
Yî-là-khiet	Iraque
Â-lâ-sṳ̂-kâ	Alasca
Kô-sṳ̂-tha̍t Lì-kâ	Costa Rica
Yî-set-lie̍t	Israel
Pâ-nâ-mâ	Panamá
Ya̍p-mùn	Iémen
Phiang-thu̍k	Vírus
Pô-làn-ngî	Língua polaca
Yok-tan	Jordânia
Nì-kâ-lâ-kûa	Nicarágua
Fu-lò-lî-tha̍t	Flórida
Kit-ngí-kit-sṳ̂-thán	Quirguistão
Â-li-sông-ná	Arizona
Khô-vî-thi̍t	Kuwait
Liàu-koet	Laos
Lì-pâ-nun	Líbano
O-le̍t-kông	Oregon
Gi-tuk-gaau zung geh sin	Deus no cristianismo
Mâ-ngì-thoi-fû	Maldivas
Yù-thâ	Utah
Mâ-lòi-sî-â	Malásia
Mién-thien	Myanmar
Nì-pok	Nepal
Â-man	Omã
Pâ-kî-sṳ̂-thán	Paquistão
Khà-tha̍t	Catar
Mióng-khiù	Ténis
Sâ-vû-thi Â-lâ-pak	Arábia Saudita
Sṳ̂-lî-làn-khà	Sri Lanka
Si-li-â	Síria
Kâ	Gálio
Thap-kit-khiet-sṳ̂-thán	Tajiquistão
中華民國	República da China
YouTube	YouTube
Châ	Germânio
Thai-koet	Tailândia
Sṳ̂n	Arsênio
Thú-khû-man-sṳ̂-thán	Turquemenistão
Abakan	Abakan
Sî	Selênio
Yî	Irídio
Â-lâ-pak Lièn-ha̍p Thai-kûng-koet	Emirados Árabes Unidos
Tshiù (溴)	Bromo
Pha̍k (鉑)	Platina
Ye̍t-nàm	Vietname
Thai-hòn Mìn-koet	Coreia do Sul
Khiet	Crípton
Â-fu-hon	Afeganistão
J. R. R. Tolkien	J. R. R. Tolkien
Lù	Rubídio
Kîm	Ouro
Men-kâ-lâ-koet	Bangladesh
Ufa	Ufa
Ôn-kô-lâ	Angola
Vùn-lòi	Brunei
Kúng	Mercúrio (elemento químico)
Fî-li̍t-pîn	Filipinas
Thò	Tálio
Ngie-sat-khiet Ngiù-tun	Isaac Newton
Albert Einstein	Albert Einstein
Sṳ̂	Estrôncio
Yet	Ítrio
Pit	Bismuto
Vòng-set	Amarelo
Tsan-pí-â	Zâmbia
Sîn-pâ-pu-vî	Zimbabwe
北京	Pequim
Tuva Khiung-fò-koet	Tuva
Pok-tshṳ-ngá-na̍p	Botswana
Pho (釙)	Polônio
Bayern	Baviera
Baden-Württemberg	Baden-Württemberg
Ngo (砈)	Ástato
Lòi-sò-thok	Lesoto
Mâ-tha̍t-kâ-sṳ̂-kâ	Madagáscar
Mâ-là-vî	Malawi
Stuttgart	Estugarda
Màu-li-thap-nì-â	Mauritânia
Pô-làn-ngìn	Polacos
Mo̍k-sông-pí-khiet	Moçambique
Na̍p-mí-pí-â	Namíbia
Nai-khi̍p-li-â	Nigéria
Ko	Zircônio
Nì	Nióbio
Yû-li-vû-sṳ̂ Khái-sat	Júlio César
Sṳ̂-vî-sṳ-làn	Suazilândia
Muk	Molibdênio
Thap	Tecnécio
Hamburg	Hamburgo
Thoi-chhia	Metabolismo
Miên-yi̍t Hì-thúng	Sistema imunitário
Lièn-ha̍p-koet	Organização das Nações Unidas
Sîm-chhong	Coração
Thèu-nó	Cérebro
Phì-fû	Pele
Ló	Ródio
Làm-set	Azul
Pâ	Paládio
Ngiùn	Prata
Kak	Cádmio
Yîn	Índio (elemento químico)
Siak	Estanho
Yu	Urânio
Thi (銻)	Antimônio
Ti	Telúrio
Pu	Plutónio
Tièn	Iodo
Nai	Neptúnio
Set	Césio
Phù	Protactínio
Pi	Bário
Thú	Tório
Kap (鉿)	Háfnio
Than (鉭)	Tântalo (elemento químico)
Luì	Rádio (elemento químico)
Tûng	Rádon
Alsace	Alsácia
Auvergne	Auvérnia
Ôn-tet-là-pâng	Andra Pradexe
Me̍t-hiet-kîn	Michigan
Burgundy	Borgonha
Aquitaine	Aquitânia
Schleswig-Holstein	Schleswig-Holstein
Hâ Saxony	Baixa Saxônia
Pet Rhine-Westphalia	Renânia do Norte-Vestfália
Saxony	Saxônia
Yî-li-nò	Illinois
Thuringia	Turíngia
Saxony-Anhalt	Saxônia-Anhalt
Pet Tha̍t-khô-thâ	Dakota do Norte
Brandenburg	Brandemburgo
Bremen-chû	Bremen (estado)
Nàm Tha̍t-khô-thâ	Dakota do Sul
Mùng-thai-nâ	Montana
Fài-ngò-mìn	Wyoming
Yâ-lu-sat-lâng	Jerusalém
Oi-tha̍t-hòt	Idaho
Fà-sṳn-tun	Washington
Lù (鑪)	Rutherfórdio
Nui-fà-tha̍t	Nevada
Hàn (𨧀)	Dúbnio
Hí (𨭎)	Seabórgio
Yin-thu-yòng	Oceano Índico
Khô-sò-vok	Kosovo
Kâ-le̍t-pí-hói	Mar do Caribe
Pô (𨨏)	Bóhrio
Het (𨭆)	Hássio
Phan Kî-vùn	Ban Ki-moon
Ma̍k (䥑)	Meitnério
Khô-lò-là-tô	Colorado
Tha̍t	Darmstácio
Siau-pâng	Frédéric Chopin
Lùn	Roentgênio
Kô (鎶)	Copernício
分類:Chú-yeu fûn-lui	Categoria:Conteúdo
Chi-kâ-kô	Chicago
Arnhem	Arnhem
Tûng-kui	Inverno
Sî-pân-ngà-ngî	Língua castelhana
Fî-là-thiet-fî	Filadélfia
Tî-tû	Aranha
Hèu-è	Macaco
Kîm-tshièn	Dinheiro
Vì-kit-nì-â	Virgínia
Sî Vì-kit-nì-â	Virgínia Ocidental
Tshiâng-tséu	Capsicum annuum
Néu-yok-chû	Nova Iorque (estado)
Sṳ (鈰)	Cério
Phú	Praseodímio
Lò-tet-tó	Rhode Island
Ńg	Neodímio
Khûn-chhùng	Insetos
Mâ-lî-làn	Maryland
Thi̍t-lâ-ngá	Delaware
Yû (銪)	Európio
Ngò-hài-ngò	Ohio
Vì-kit-ngì	Virgílio
Machiavelli	Nicolau Maquiavel
Pîn-sé-fap-nì-â	Pensilvânia
Uetersen	Uetersen
O-kú-sṳ̂-tû	Augusto
Néu Chhe̍t-sî-chû	Nova Jérsia
Fûn-làn-ngî	Língua finlandesa
Yin-thi-ôn-na̍p	Indiana
Vì-sṳ̂-pha-siên	Vespasiano
Thù-là-chṳ̂n	Trajano
Hâ-tet-liòng	Adriano
Khièu-tshṳ-â	Geórgia (Estados Unidos)
Mâ-khù-sṳ̂ O-lie̍t-lî-vû-sṳ̂	Marco Aurélio
Zagreb	Zagreb
Tet-khiet-sat-sṳ̂	Texas
Thai-mí-ngì-na̍p-tet-pâng	Tamil Nadu
Pet Khà-lò-lòi-na̍p	Carolina do Norte
Nàm Khà-lò-lòi-na̍p	Carolina do Sul
Loire-sén	Rio Loire
Pâ-set-lò-nâ	Barcelona
Vòng-lî	Ananás
Me̍t-sî-sî-pí	Mississippi
Thièn-na̍p-sî	Tennessee
Néu Me̍t-sî-kô	Novo México
Mìn-nì-sû-tha̍t	Minnesota
Vî-sṳ̂-không-sîn	Wisconsin
Oi-hò-fà	Iowa
Nui-pu-lâ-sṳ̂-kâ	Nebraska
Khâm-sat-sṳ̂	Kansas
Yin-thi-ngî	Língua hindi
Me̍t-sû-lî	Missouri
Lu-yi-sṳ̂-ôn-ná	Luisiana
Khén-thap-kî	Kentucky
Â-khén-set	Arkansas
Neil Armstrong	Neil Armstrong
O-khiet-lâ-hò-mâ	Oklahoma
Pet-hói	Mar do Norte
Mo̍k-sṳ̂-khô-chû	Oblast de Moscou
Kiel	Kiel
Schwerin	Schwerin
Potsdam	Potsdam
Hanover	Hanôver
Düsseldorf	Düsseldorf
Mainz	Mainz
Wiesbaden	Wiesbaden
Saarbrücken	Saarbrücken
Mu-nì-het	Munique
Erfurt	Erfurt
Dresden	Dresden
Kaliningrad-chû	Oblast de Kaliningrado
Murmansk-chû	Oblast de Murmansk
Kak-than-sṳ̂-khiet	Gdańsk
Fap-làn-khiet-fuk	Frankfurt am Main
Fut-lò-tshṳ-ngá-fû	Breslávia
Làn	Lantânio
Ki (鉕)	Promécio
Sân	Samário
Â-chhè Thi̍t-phe̍t Hàng-chṳn-khî	Achém
Nga̍t (釓)	Gadolínio
Thi̍t (鋱)	Térbio
Tit (鏑)	Disprósio
Sṳn-kîn	Bíblia
Fó	Hólmio
Ngí (鉺)	Érbio
Tiû	Túlio
Yi	Itérbio
Liu	Lutécio
Hò-nui-sṳ	Hanói
Chṳ̂n Yâ-sû Kau-fi	Verdadeira Igreja de Jesus
Yîn-ngî	Língua inglesa
Màn-kuk	Banguecoque
Kit-lùng-po	Kuala Lumpur
Pâng-kâ Vú-lî-thung-sén	Bangka-Belitung
Thòi-pet-sṳ	Taipé
Mî (鋂)	Amerício
Arkhangelsk-chû	Oblast de Arkhangelsk
Khiu̍k	Cúrio
Thùng-hói-sṳ	Dong Hoi
Concepción	Concepción (Chile)
Pet (鉳)	Berquélio
Khà (鉲)	Califórnio
Mìn-kú-lû-sén	Bengkulu
Oi	Einstênio
Fi	Férmio
Mùn	Mendelévio
Na	Nobélio
Ontario-sén	Ontário
Lò	Laurêncio
Karelia Khiung-fò-koet	República da Carélia
Końskowola	Końskowola
2002-ngièn	2002
2008-ngièn	2008
Charles de Gaulle	Charles de Gaulle
Cham-pî-sén	Jambi
Komi Khiung-fò-koet	República de Komi
Nâm-póng-sén	Lampung
Pet Sû-mùn-tap-lia̍p-sén	Sumatra Setentrional
Syktyvkar	Syktyvkar
Québec-sṳ	Quebec (cidade)
Nenets Chhṳ-chhṳ-khî	Nenétsia
Liàu-nui-sén	Riau (província)
Leningrad-chû	Oblast de Leningrado
Pskov-chû	Oblast de Pskov
Liàu-nui Khiùn-tó-sén	Ilhas Riau
Nizhny Novgorod-chû	Oblast de Níjni Novgorod
Nàm Sû-mùn-tap-lia̍p-sén	Sumatra Meridional
Lò-mâ Ti-koet	Império Romano
Mì-ngiôn Kûng-sṳ̂	Microsoft
Tver-chû	Oblast de Tver
Khù-lû-fû	Kurów
Fa-ho̍k	Química
Smolensk-chû	Oblast de Smolensk
Yaroslavl-chû	Oblast de Iaroslavl
Kostroma-chû	Oblast de Kostroma
Ivanovo-chû	Oblast de Ivanovo
Arnold Schwarzenegger	Arnold Schwarzenegger
Chiuk-khiù	Futebol
Ryazan-chû	Oblast de Riazan
IPhone	IPhone
Sî Sû-mùn-tap-lia̍p-sén	Sumatra Ocidental
Tula-chû	Oblast de Tula
IPad	IPad
Mâ-tet-lî	Madrid
Bryansk-chû	Oblast de Briansk
Michael Jackson	Michael Jackson
Kaluga-chû	Oblast de Kaluga
Loire-Atlantique-sén	Loire-Atlantique
Ain-sén	Ain
Allier-sén	Allier (departamento)
Khâm-phì-là	Camberra
Sông Alpes-sén	Altos Alpes
Oryol-chû	Oblast de Oriol
Sit-nì	Sydney
Alpes-de-Haute-Provence-sén	Alpes da Alta Provença
Liu̍k-set	Verde
Alpes-Maritimes-sén	Alpes Marítimos
Hâ-tet-sùn-hò	Rio Hudson
Me̍t-ngì-pún	Melbourne
Fùng-set	Vermelho
Ardèche-sén	Ardèche
Jena	Jena
Kursk-chû	Oblast de Kursk
Ariège-sén	Ariège
Aude-sén	Aude
Aveyron-sén	Aveyron
Sîn Nàm Vî-ngì-sṳ̂-chû	Nova Gales do Sul
Bouches-du-Rhône-sén	Bocas do Ródano
Àu-thai-li-â Sú-tû Liâng-thi	Território da Capital Australiana
Cantal-sén	Cantal
Belgorod-chû	Oblast de Belgorod
Côte-d'Or-sén	Côte-d'Or
Côtes-d'Armor-sén	Côtes-d'Armor
Drôme-sén	Drôme
Finistère-sén	Finistère
Voronezh-chû	Oblast de Voronej
Sû-mùn-tap-lia̍p	Sumatra
Lipetsk-chû	Oblast de Lipetsk
Van-tan-sén	Banten
Chûng Cháu-ôa-sén	Java Central
Fùi-sên	Cometa
Rostov-chû	Oblast de Rostov
Tûng Cháu-ôa-sén	Java Oriental
Ngâ-kâ-tha̍t Sú-tû Thi̍t-khî	Jacarta
Sî Cháu-ôa-sén	Java Ocidental
Adygea Khiung-fò-koet	Adiguésia
Ngit-ngiâ Thi-fông Thi̍t-khî	Yogyakarta
Gera	Gera
Maykop	Maikop
Cháu-ôa-tó	Java
Kâ-lî-man-tân-chû	Kalimantan
Séu Sùn-thâ Khiùn-tó	Pequenas Ilhas da Sonda
Sû-lâ-vî-sî-tó	Celebes
Mô-lu̍k-kâ Khiùn-tó	Ilhas Molucas
Chûng Kâ-lî-man-tân-sén	Kalimantan Central
Tûng Kâ-lî-man-tân-sén	Kalimantan Oriental
Nàm Kâ-lî-man-tân-sén	Kalimantan Meridional
Kâ-li-sî-â	Galiza
Sî Kâ-lî-man-tân-sén	Kalimantan Ocidental
Thai-ho̍k	Universidade
Pretoria	Pretória
Chok-khiù	Tênis de mesa
Â-sṳ̂-thù-lî-â-sṳ̂	Astúrias
Wikipedia:Sandbox	Wikipédia:Página de testes
Astrakhan-chû	Oblast de Astracã
Kham-thap-pu-lî-â	Cantábria
Kalmykia Khiung-fò-koet	Calmúquia
Weimar	Weimar
Osasco	Osasco
Â-là-kung	Aragão
Kak-là-sṳ̂-kô	Glasgow
Thùng-hói Kî-chhòng	Aeroporto de Dong Hoi
Vú-lîn-ngièn Fûng-kín Miàng-sṳn-khî	Wulingyuan
分類:Thòi-vân li̍t-sṳ́	Categoria:História de Taiwan
Curitiba	Curitiba
Chloë Grace Moretz	Chloë Grace Moretz
Khûng-chṳ́	Confúcio
Corbin Bleu	Corbin Bleu
分類:Sṳ-ho̍k	Categoria:Matemática
分類:Ngìn-kûng ngî-ngièn	Categoria:Línguas artificiais
Pâ-lî-sén	Bali
Mî-kîm	Dólar dos Estados Unidos
Thi-chûng-hói	Mar Mediterrâneo
Hông-chû-sṳ	Hangzhou
Kî-tuk-kau	Cristianismo
Tûng Nú-sâ Tên-kâ-là-sén	Sonda Oriental
Sî Nú-sâ Tên-kâ-là-sén	Sonda Ocidental
Chûng Sû-lâ-vî-sî-sén	Celebes Central
Kô-lùn-tá-lo̍k-sén	Gorontalo
Pet Sû-lâ-vî-sî-sén	Celebes Setentrional
Tûng-nàm Sû-lâ-vî-sî-sén	Celebes do Sudeste
Nàm Sû-lâ-vî-sî-sén	Celebes Meridional
Sî Sû-lâ-vî-sî-sén	Celebes Ocidental
Vò-é	Arroz
Mâ-lû-kú-sén	Molucas (província)
Pet Mâ-lû-kú-sén	Molucas Setentrionais
Pâ-pu-â-sén	Papua (província indonésia)
Sî Pâ-pu-â-sén	Papua Ocidental
Dagestan Khiung-fò-koet	Daguestão
Sú-tû	Capital
Monzón	Monzón
Phù-thò-ngà-ngî	Língua portuguesa
Ngie̍t	Mês
Mustafa Kemal Atatürk	Mustafa Kemal Atatürk
Makhachkala	Mahackala
Chechnya Khiung-fò-koet	Chechênia
Grozny	Grózni
Almazán	Almazán
Vòng Hien-fàm	Huang Xianfan
Ingushetia Khiung-fò-koet	Inguchétia
Magas	Magas
Pet Ossetia–Alania Khiung-fò-koet	Ossétia do Norte-Alânia
Kabardino-Balkaria Khiung-fò-koet	Cabárdia-Balcária
Tson-sa̍k	Diamante
Bill Gates	Bill Gates
Ngi̍t-ngî	Língua japonesa
Pak-khô-chhiòn-sû	Enciclopédia
頭頁	Wikipédia:Página principal
Karachay-Cherkessia Khiung-fò-koet	Carachai-Circássia
Saratov	Saratov
Saratov-chû	Oblast de Saratov
Orenburg-chû	Oblast de Oremburgo
Mordovia Khiung-fò-koet	Mordóvia
Saransk	Saransk
Yâ-khiù	Basebol
Làm-khiù	Basquetebol
Kirov-chû	Oblast de Kirov
Udmurtia Khiung-fò-koet	Udmúrtia
Sî-pak-li-â	Sibéria
Mari El Khiung-fò-koet	Mari El
Yoshkar-Ola	Iochkar-Ola
Stellenbosch	Stellenbosch
Sverdlovsk-chû	Oblast de Sverdlovsk
Cape Town	Cidade do Cabo
Chuvash Khiung-fò-koet	Chuváchia
Durban	Durban
Cheboksary	Cheboksary
Tat-tat-sṳ̂-thán Khiung-fò-koet	Tartaristão
Penza-chû	Oblast de Penza
Là-fî-ngì	Rafael Sanzio
Pí-tet Lû-pún-sṳ̂	Peter Paul Rubens
Ulyanovsk-chû	Oblast de Ulianovsk
Gung-gung-hi-tsaa	Ônibus
Kâ-thai-lò-nì-â	Catalunha
Bashkortostan Khiung-fò-koet	Bascortostão
Chelyabinsk-chû	Oblast de Cheliabinsk
Pâ-lùn-sî-â Chhṳ-chhṳ-khî	Comunidade Valenciana
Khà-sṳ̂-tì-li-â lâu Lòi-ngong	Castela e Leão
Kurgan-chû	Oblast de Kurgan
Mô Chhe̍t-tûng	Mao Tsé-Tung
Tyumen-chû	Oblast de Tiumen
Omsk-chû	Oblast de Omsk
Thai-mí-ngì-ngî	Língua tâmil
Chet-ho̍k	Filosofia
分類:Candidates for speedy deletion	Categoria:!Páginas para eliminação rápida
Altai Khiung-fò-koet	Altai (república)
Kòng-khìm	Piano
Gorno-Altaysk	Gorno-Altaisk
Kemerovo-chû	Oblast de Kemerovo
Hebe Camargo	Hebe Camargo
Chṳ̂-pún chú-ngi	Capitalismo
Koet-kâ	País
Mìn-chhu̍k	Nação
Khanty-Mansi Chhṳ-chhṳ-khî	Khantia-Mansia
Yamalo-Nenets Chhṳ-chhṳ-khî	Iamália
Montpellier	Montpellier
分類:Thiên-vùn-ho̍k	Categoria:Astronomia
Khakassia Khiung-fò-koet	Cacássia
Irkutsk-chû	Oblast de Irkutsk
Sakha Khiung-fò-koet	Iacútia
Khiet-lò-âi-sî-â-ngî	Língua croata
Hon-pó	Hambúrguer
Buryatia Khiung-fò-koet	Buriácia
Vû-làn Vû-tet	Ulan-Ude
Amur-chû	Oblast de Amur
Ngi-sṳ̍p Sṳ-ki	Século XX
Gotha	Gota (cidade)
Dijon	Dijon
Kâ-thai-lò-nì-â-ngî	Língua catalã
Nordhausen	Nordhausen
Kit-lò-na̍p-sén	Girona
Eisenach	Eisenach
Se-pâu Sâng-vu̍t-ho̍k	Biologia celular
Sṳ-kie Ngiùn-hòng Si̍p-thòn	Banco Mundial
A-la-pak Liên-mên	Liga Árabe
Mìn-tsú Tsú-ngi	Democracia
Chhîn-chhèu (秦朝)	Dinastia Chin
Pet Thai-sî-yòng Kûng-yok Chû-chṳt	Organização do Tratado do Atlântico Norte
Chhìn Sṳ Fòng	Qin Shihuang
Hon-chhèu	Dinastia Han
Hon Vú-ti Liù Chha̍t	Wu de Han
Sâng-vu̍t	Organismo
Kiûn-chú-chṳ	Monarquia
Khiung-fò-koet	República
Yí-mô-khiù	Badminton
Ngièn-chhèu	Dinastia Yuan
Nazi Tet-koet	Alemanha Nazi
Yù-thai-ngìn	Judeu
Chang Fò	Zheng He
Chìn-chhèu	Dinastia Jin (265-420)
Ngí	Orelha
Phi	Nariz
Ngién	Olho
Mûn-é	Culicidae
Mièn-yòng	Ovis aries
Lo̍k-thò	Camelo
Phú-nen thung-vu̍t	Mamíferos
Siong	Elefante
Ngie-kûng	Formiga
Phûng-é	Anthophila
Hò-làn-ngî	Língua neerlandesa
Fà-thi̍t Thit-sṳ-nì Kûng-sṳ̂	The Walt Disney Company
Thot-yong Fu̍t-thông Fu̍t-son	Ácido desoxirribonucleico
Khiô	Beringela
Siet	Neve
Â-pâ	Pai
Fûn	Minuto
Yù-thai Chhṳ-chhṳ-chû	Oblast Autônomo Judaico
Ngò-lò-sṳ̂-ngî	Língua russa
Tûng-nàm-â Koet-kâ Lièn-mèn	Associação de Nações do Sudeste Asiático
Sakhalin-chû	Oblast de Sacalina
Mien-pâu	Pão
Sṳ-kie Mo-yi Chû-chṳt	Organização Mundial do Comércio
漢語	Língua chinesa
Se-pâu	Célula
Hiet-yi̍t	Sangue
Hi	Pulmão humano
Lò-mâ-nì-â-ngî	Língua romena
Pó-kâ-li-â-ngî	Língua búlgara
Magadan-chû	Oblast de Magadan
Chhṳ-yèn Khô-ho̍k	Ciências naturais
Het-chhe̍t Mìn	Akira Kurosawa
Franklin D. Roosevelt	Franklin Delano Roosevelt
Thi-khiù Khô-ho̍k	Ciências da terra
Sa̍k-thèu	Rocha
Yùn	Nuvem
Kí-hò-ho̍k	Geometria
Tet-lu-kú-ngî	Língua telugu
Thai-hì-chhèn	Atmosfera
Kak-lû-kit-â-ngî	Língua georgiana
Kîn-chi-ho̍k	Economia
Pîn-kóng	Pangkal Pinang
漢字	Caracteres chineses
Sî-lî-ngì Sṳ-mû	Alfabeto cirílico
Lâ-tên sṳ-mû	Alfabeto latino
Vùn-ho̍k	Literatura
分類:Fap-koet	Categoria:França
分類:Yîm-ngo̍k	Categoria:Música
分類:Vùn-ho̍k	Categoria:Literatura
Fù-lì	Raposa
La̍p-pá	Trompete
Â-li̍t-sân-thai sâm-sṳ	Alexandre, o Grande
Kiûn-sṳ-thán-tên Yit-sṳ	Constantino
Set-lû-sṳ thai-ti	Ciro II
Vùn-mìn	Civilização
Kau-yuk	Educação
Kâ-thìn	Família
Nàm-ngìn	Homem
Fûn-yîn	Casamento
Kiûn-sṳ	Militar
Kâ-pî	Café
Ngiù-nen	Leite
Sûn Chûng-sân	Sun Yat-sen
Â-yuk-vòng	Asoka
香港	Hong Kong
Thai-yîn Ti-koet	Império Britânico
Sú-ngì	Seul
Kâm-nái-thit Koet-chi Kî-chhòng	Aeroporto Internacional John F. Kennedy
上海	Xangai
Lùn-tûn Hî-sṳ̂-lu Kî-chhòng	Aeroporto de Londres Heathrow
Lùn-tûn Kak-vet Kî-chhòng	Aeroporto de Londres Gatwick
Set-vì-li-â	Sevilha
Chhîn-chhèu	Dinastia Qing
Â-ngì-pâ-nì-â-ngî	Língua albanesa
Pâ-sṳ̂-khiet-ngî	Língua basca
Â-lâ-kung-ngî	Língua aragonesa
Yîn-koet Hòng-khûng	British Airways
Â-mî-nì-â-ngî	Língua arménia
Vû-khiet-làn-ngî	Língua ucraniana
Pâ-lùn-sî-â	Valência (Espanha)
Shuì-tién-ngî	Língua sueca
Tan-ma̍k-ngî	Língua dinamarquesa
Nò-vî-ngî	Língua norueguesa
Kô-thi̍t-fu̍t-lòi-tet Vî-liâm Lòi-pu-nì-tsṳ	Gottfried Wilhelm Leibniz
Tshia̍p-khiet-ngî	Língua tcheca
Sṳ̂-lo̍k-phat-khiet-ngî	Língua eslovaca
Sṳ̂-lo̍k-vì-nì-â-ngî	Língua eslovena
Hiûng-ngà-li-ngî	Língua húngara
Oi-sâ-nì-â-ngî	Língua estónia
Là-thot-vì-â-ngî	Língua letã
Li̍p-thâu-vón-ngî	Língua lituana
Pha̍k-ngò-lò-sṳ̂-ngî	Língua bielorrussa
Kui-mí-thi̍t-lî Mùn-tet-lie̍t-fû	Dmitri Mendeleiev
Ngièn-chṳ́	Átomo
Lâ-set-fuk	Ernest Rutherford
Hî-lia̍p-ngî	Língua grega
Oi-ngì-làn-ngî	Língua irlandesa
Pô-sṳ̂-ngî	Língua persa
Chûng-kau	Religião
Chêu-sién-ngî	Língua coreana
Chhóng-sṳ-ki	Gênesis
Kóng-tûng-fa	Cantonês
Chhut-âi-khi̍p-ki	Livro do Êxodo
Ye̍t-nàm-ngî	Língua vietnamita
Pó-lò	Paulo de Tarso
Kô-mièn-ngî	Língua khmer
Thai-ngî	Língua tailandesa
Mâ-lòi-ngî	Língua malaia
Yin-nì-ngî	Língua indonésia
Mùng-kú-ngî	Língua mongol
Hâ-sat-khiet-ngî	Língua cazaque
Vû-tsṳ̂-phe̍t-khiet-ngî	Língua uzbeque
Thú-khù-màn-ngî	Língua turcomena
Yù-thai-kau	Judaísmo
Hî-pak-lói-ngî	Língua hebraica
Â-set-pai-kiông-ngî	Língua azeri
Mâ-khì-tun-ngî	Língua macedônia
Set-ngì-vì-â-ngî	Língua sérvia
Set-ngì-vì-â Khiet-lò-thi-â-ngî	Língua servo-croata
Pô-sṳ-nì-â-ngî	Língua bósnia
Kâ-lî-sî-â-ngî	Língua galega
Vî-ngì-sṳ̂-ngî	Língua galesa
Sû-kak-làn Koi-ngì-ngî	Língua gaélica escocesa
Siak-khiet-kau	Sikhismo
John Maynard Keynes	John Maynard Keynes
Lufthansa Hòng-khûng	Lufthansa
Ló-chṳ́	Lao Zi
Kôn-chhóng	Fígado
Shìn	Rim
Thu-é	Coelho
Sṳ̀n-kîn Ne-thúng	Sistema nervoso
Sîm-lî-ho̍k	Psicologia
Sṳt-kâ-mèu-nì	Sidarta Gautama
Mâ-tên Lu-tet	Martinho Lutero
Yî-kâ	Confucionismo
Thiên-chú-kau	Igreja Católica
Tho-kau	Taoismo
Chit-siói	Medula espinhal
Sa̍t	Língua
Yî-tshóng	Pâncreas
Hèu-thèu	Laringe
Fuk-khiet-làn khiùn-tó	Ilhas Malvinas
Vàng-kak-mo̍k	Músculo diafragma
Lân-mî	Apêndice cecal
Elizabeth Ngi-sṳ	Isabel II do Reino Unido
Thòng-chhèu	Dinastia Tang
John F. Kennedy	John F. Kennedy
Mìn-chhèu	Dinastia Ming
Dwight D. Eisenhower	Dwight D. Eisenhower
Ronald Reagan	Ronald Reagan
Sat-là-kô-sat	Saragoça
Kîm Tsang-ngit	Kim Jong-il
Ngièn-su Chû-khì-péu	Tabela periódica
Chû-su̍k	Sus
Mariano Rajoy	Mariano Rajoy
Se-khiûn	Bactéria
Phù-thò	Uva
Phûng-thòng	Mel
Thông	Açúcar
Vòng-theu	Soja
Kûng-chhàng-ho̍k	Engenharia
Vùn-fa	Cultura
Fan-vun	Sânscrito
Sùn-fàn Hì-thúng	Sistema circulatório
Sôn	Ácido
Yî-ho̍k	Medicina
Néu-Yok Sṳ-kie Mo-yi Chûng-sîm	World Trade Center
Hâ Màn-hâ-tun	Lower Manhattan
Yàm	Sal de cozinha
分類:Pâ-sî	Categoria:Brasil
Màn-hâ-tun	Manhattan
Ngièn-su	Elemento (química)
Kâ-suk-thu	Aceleração
Li̍t	Força
Kú	Tambor
Tsṳt-liông	Massa
Thien-yáng	Filme
Kîm-su̍k	Metal
Nùng-ngia̍p	Agricultura
Sâng-yîm	Som
Sṳ̀-kiên	Tempo
Mien-chit	Área
Kûng-kîn	Quilograma
Kûng-tshak	Metro
Miéu	Segundo
Pâu-siuk	Milho
Kûng-sṳ̂n	Litro
Fà-ngì-kiê	Wall Street
Tûng-nàm-â	Sudeste Asiático
Tshùng-khin	Chongqing
Thiên-tsîn	Tianjin
Vú-hon-sṳ	Wuhan
Kú Hî-lia̍p	Grécia Antiga
Thomas Jefferson	Thomas Jefferson
Vùi-sṳ̂-khà	Huesca
Tychy	Tychy
El Masnou	El Masnou
Pu-lie̍t-thap-nì-ngî	Língua bretã
Lóng	Surdez
Chhi̍t-phiang	Doença
Khien-không	Saúde
Sok-lî-â	Sória
Màn-tó-ngî	Língua manesa
Chhiâng-môi-su	Penicilina
Nantes	Nantes
Pot-thâm-fó	Tuberculose
Mà-chiông	Mahjong
模板:Location map Taiwan	Predefinição:Mapa de localização/Taiwan
Detroit	Detroit
Van-lî Tshòng-sàng	Muralha da China
Gard-sén	Gard
Gers-sén	Gers
Sông Garonne-sén	Alto Garona
Sṳ̀n-sṳn Lò-mâ Ti-koet	Sacro Império Romano-Germânico
Ille-et-Vilaine-sén	Ille-et-Vilaine
Isère-sén	Isère
Chûng-kau Kói-kiet	Reforma Protestante
Sông Loire-sén	Haute-Loire
Lot-sén	Lot (departamento)
Lozère-sén	Lozère
Maine-et-Loire-sén	Maine-et-Loire
Nì-pu-kap-nì-sat ngi-sṳ	Nabucodonosor II
Mayenne-sén	Mayenne (departamento)
Morbihan-sén	Morbihan
Nièvre-sén	Nièvre
Nord-sén	Norte (departamento)
Calais Hói-hia̍p-sén	Passo de Calais (departamento)
Puy-de-Dôme-sén	Puy-de-Dôme
Sông Pyrénées-sén	Altos Pirineus
Pyrénées-Orientales-sén	Pirineus Orientais
Hâ Rhin-sén	Baixo Reno
Sông Rhin-sén	Alto Reno
Saône-et-Loire-sén	Saône-et-Loire
Sarthe-sén	Sarthe
Sông Savoie-sén	Alta Saboia
Tarn-sén	Tarn
Tarn-et-Garonne-sén	Tarn-et-Garonne
Var-sén	Var (departamento)
Vaucluse-sén	Vaucluse
Vendée-sén	Vendeia
Yonne-sén	Yonne
Yî-pí-li-â Pan-tó	Península Ibérica
Lai-kî	Litchi chinensis
Yâ-è	Coqueiro
Sa̍k-liù	Romã
Chong-fa	Língua zhuang
Sông-sok-pu-ngî	Alto sorábio
Na̍p-ngá-thi̍t-ngî	Língua náuatle
Mí-nàm-kâ-pó-ngî	Língua minangkabau
Mirandés-ngî	Língua mirandesa
Harvard Thai-ho̍k	Universidade Harvard
Néu-yok Chṳn-khèn Kâu-yi-só	New York Stock Exchange
Lie̍t-yî-tha̍t-sén	Lérida (província)
Â-lâ-pak-ngî	Língua árabe
Kiú-chiu	Kyushu
Si-koet	Shikoku
O-khiet-ngî	Língua occitana
Nàm-fî Hò-làn-ngî	Língua africâner
Lí Mìn-pok	Lee Myung-bak
Lû Vú-hién	Roh Moo-hyun
Kâ Mà-chiok	Pardal-doméstico
澳門	Macau
Suhl	Suhl
Mühlhausen	Mühlhausen (Turíngia)
Sâ-thièn-khî	Sha Tin (distrito)
Fù Kím-Thàu	Hu Jintao
Si̍p Khiûn-phìn	Xi Jinping
Chhòng-kiáng-lu̍k	Girafa
Phì-âi-mùng-thi̍t-ngî	Língua piemontesa
Thap-là-kô-na̍p	Tarragona
Provence-Alpes-Côte d'Azur	Provença-Alpes-Costa Azul
Chhṳ̂m-chun-sṳ	Shenzhen
Kóng-tûng	Guangdong
Kóng-sî Chong-chhu̍k Chhṳ-chhṳ-khî	Guangxi
Mô-kài	O Senhor dos Anéis
Borredà	Borredà
Castellar de n'Hug	Castellar de n'Hug
Hiông-kóng Thai-ho̍k	Universidade de Hong Kong
Badajoz	Badajoz
Lu̍k-yì-tó-yen	Kagoshima
Kiok	Pé
Sit-thit	Lagartos
Altenburg	Altemburgo
Kiên	Ombro
Midi-Pyrénées	Midi-Pirinéus
模板:Link FA	Predefinição:Link FA
Wikipedia:Chhâm-siòng	Wikipédia:Esplanada
Fu-mùng-thi̍t	Vermont
Hiû-sṳ̂-tûn	Houston
Kóng-chiu-sṳ	Cantão (China)
Chiông Kie-sa̍k	Chiang Kai-shek
Vûn Kâ-pó	Wen Jiabao
Nàm-kîn-sṳ	Nanquim
Phiang-yèn	Hospital
Kông-sû	Jiangsu
Chet-kông-sén	Zhejiang
Thèn Séu-phìn	Deng Xiaoping
Pet-phu Calais Hói-hia̍p	Norte-Passo de Calais
Pays de la Loire	País do Loire
Languedoc-Roussillon	Languedoque-Rossilhão
Thiap-sat-lò-nì-kâ	Salonica
西藏自治區	Região Autônoma do Tibete
Hàng-thung Thien-fa	Telefone celular
Thò-niâu	Avestruz
Manchester	Manchester
Pu-lû-khiet-lìm	Brooklyn
Fòng-heu-khî	Queens
Liùng-yìn-sṳ	Yongin
Lòng	Lobo
Mâ-lòi Pan-tó	Península da Malásia
Sîn-yok Sṳn-kîn	Novo Testamento
9	Nove
Zung-gok Thaai-liuk	China continental
Het-liùng-kông	Heilongjiang
Mâ Yîn-kiú	Ma Ying-jeou
Piên-fò-sṳ	Bien Hoa
Hiông-kóng-tó	Ilha de Hong Kong
Ngà-tsông-sṳ	Nha Trang
Podolsk	Podolsk
Pô-tô Lì-kok Thu̍k-li̍p-tóng	Partido Independentista Portorriquenho
Lì-è	Equus africanus asinus
Si-chhôn-sén	Sichuan
Khiu-yok Sṳn-kîn	Antigo Testamento
Sṳn-tan-chiet	Natal
Lò-màn Ngî-chhu̍k	Línguas românicas
Sâm-kok-hìn	Triângulo
Steve Jobs	Steve Jobs
Yin-Êu Ngî-ne	Línguas indo-europeias
Breinigerberg	Breinigerberg
Lo-fú	Tigre
Fù-ôn Khà-lo̍k-sṳ̂ Yit-sṳ	Juan Carlos da Espanha
Súi-ngièn-sṳ	Suwon
Sâm-sên Si̍p-thòn	Samsung
Louis Couturat	Louis Couturat
Thai-thièn Kóng-vet-sṳ	Daejeon
Kîn-ki-tho	Gyeonggi
Sṳ̂-khâm-tit-nâ-vì-â	Escandinávia
Fu̍k-fa̍t-chiet	Páscoa
Thien-nó Khô-ho̍k	Ciência da computação
Koet-chi Yîm-phiêu	Alfabeto fonético internacional
Hò-pet	Hebei
Phú-lìm-sṳ̂-tun Thai-ho̍k	Universidade de Princeton
Fôn-hìn-muk	Ciconiiformes
Chhṳ̀n Súi-pién	Chen Shui-bian
台灣	Ilha Formosa
Chṳ-fi-hîn Sú-kî	Smartphone
Sa̍k-yù	Petróleo
Hài-è	Sapato
Ngiùn-hòng	Banco
Ngièn-lun Chhṳ-yù	Liberdade de expressão
Oi-ngì-làn	Irlanda (ilha)
Cheshire	Cheshire
Cumbria	Cúmbria
Lancashire	Lancashire
Northumberland	Northumberland
Tyne and Wear	Tyne and Wear
County Durham	Condado de Durham
Pet Yorkshire	North Yorkshire
Lincolnshire	Lincolnshire
Nottinghamshire	Nottinghamshire
Derbyshire	Derbyshire
Merseyside	Merseyside
Leicestershire	Leicestershire
Rutland	Rutland
Lû-sùn	Lu Xun (escritor)
Northamptonshire	Northamptonshire
Devon	Devon
Oxfordshire	Oxfordshire
Wiltshire	Wiltshire
Hampshire	Hampshire
Buckinghamshire	Buckinghamshire
Surrey	Surrey
West Sussex	West Sussex
East Sussex	East Sussex
Kent	Kent
Thai Lùn-tûn	Grande Londres
7	Sete
8	Oito
Lu̍k-é	Cervidae
Pên	Gelo
Chú ke Khì-tó-vùn	Pai Nosso
Ngìn-lui-ho̍k	Antropologia
Fùng-hói	Mar Vermelho
Oi-tên-páu	Edimburgo
Pha̍k-set	Branco
Marseille	Marselha
Thai-chhûng-thèu	Cebola
6	Seis
Kôn-fông ngî-ngièn	Língua oficial
Kháu-kú-ho̍k	Arqueologia
George H. W. Bush	George H. W. Bush
Pâ-ngì-kòn pan-tó	Bálcãs
Dmitry Medvedev	Dmitri Medvedev
Entrena	Entrena
Sîn-kau	Protestantismo
Selena	Selena
Mî-koet Thai-khûng Chúng-shu	NASA
Thai Put-lie̍t-tiên-tó	Grã-Bretanha
Pâ-le̍t-sṳ̂-thán	Palestina
10	Dez
Lila Downs	Lila Downs
Lia̍p-pau	Acinonyx jubatus
Liverpool	Liverpool
Bremen	Bremen
Sîn Nò-vî-ngî	Língua nova norueguesa
Meu-thèu-tiâu	Strigiformes
Sṳ̀	Hora
Fap-lò-ngî	Língua feroesa
Kîm-eu-sṳ	Cà Mau (cidade)
Meu-khô	Felidae
Koet-chi Thai-khûng Chhàm	Estação Espacial Internacional
Tà-la-sṳ	Da Lat
Tat-tat-ngî	Língua tártara
Tshûng-liông	Peso
Tsûng-su	Tamareira
Fan-tshiet-sṳ	Phan Thiet
Sî Fut-lî-sî-ngî	Língua frísia
Séu Vòng-chṳ́	Le Petit Prince
Phiàng-fông kûng-tshak	Metro quadrado
Fó-yam-chhùng	Vaga-lume
Li̍p-fông kûng-tshak	Metro cúbico
Fàn-chiet-thûng-vu̍t-mùn	Anelídeo
Chhú-khô	Muridae
Lû-sêm-nì-â-ngî	Língua rusyn
Ede (Hò-làn)	Ede
Fú-kîn	Orca
Liû-khiù-koet	Reino de Ryukyu
Â-mê-ha̍p-lâ-ngî	Língua amárica
蝠婆	Morcego
Tarnobrzeg	Tarnobrzeg
Vòng Ti	Huangdi
Tiau-ǹg-thòi Lie̍t-yí	Ilhas Senkaku
Khiung-fò-tóng (Mî-koet)	Partido Republicano (Estados Unidos)
Â-sṳ̂-thù-lî-â-sṳ̂-ngî	Língua asturiana
中國	China (civilização)
O-thi-li Pâ-vî-li-â-ngî	Língua bávara
Mìn-chú-tóng (Mî-koet)	Partido Democrata (Estados Unidos)
Sàng-tû-sṳ	Chengdu
Âi-sṳ̂-thi̍t-lùi-mâ-thu-lâ-ngî	Estremenho
Séu-su mìn-chhu̍k	Minoria
Pô-lòi-kú	Pleiku
Â-ha̍p-sṳ̂-vòng	Acaz
Yî-liàu Ví-sâng	Assistência médica
Khiet-là-khô-fû	Cracóvia
Pet-kîn Sú-tû Koet-chi Kî-chhòng	Aeroporto Internacional de Pequim
Sîn-kâ-po Hòng-khûng Kûng-sṳ̂	Singapore Airlines
Thien-nó Thôn-chhèn Só-mèu	Tomografia computadorizada
Vî-nî-sṳ̂-ngî	Língua vêneta
Vì-phú-sêm-ngî	Língua vepes
Fu̍t-lò-ngî	Língua võro
Pân-mâ	Zebra
Valery Leontiev	Valery Leontiev
Khô-sî-kâ-ngî	Língua corsa
Sùn-tho-chûng	Igreja Metodista
Suk-vú-ngî	Língua cebuana
Chavacano-ngî	Língua chavacana
Tha̍t-lò-phî-thû Ngî-hì	Línguas dravídicas
Pet-nèn-sṳ	Bac Ninh (cidade)
Liùng-chhôn-sṳ	Long Xuyen
Fut-liù-li-ngî	Língua friulana
Pâng-mî-tsuk	Buon Ma Thuot
Kàm-ngî	Chinês gan
Pok-vu̍t-kón	Museu
Yin-thu Yî-lóng Ngî-chhu̍k	Línguas indo-iranianas
Thai-yùng-meu	Ailuropoda melanoleuca
Kalmyk-ngî	Língua calmuca
Mân-ngî	Língua manchu
Kû-li̍p ngî-ngièn	Língua isolada
Kit-là-kî-ngî	Língua gilaki
Khà-sû-pí-ngî	Língua cassúbia
Karachay-Balkar-ngî	Língua carachaio-bálcara
Lùn-pâ-tí-ngî	Língua lombarda
Sú	Mão
Thu fú	Du Fu
Maranao-ngî	Língua maranao
O-lî-â-ngî	Língua oriá
Ngìn-khiéu	População
Nò-man-thi-ngî	Língua normanda
Pâng-â-sî-nâm-ngî	Língua pangasinesa
Pet-sat-mí-ngî	Língua sami setentrional
O-set-thôi-ngî	Língua osseta
Sî-sî-lî-ngî	Língua siciliana
Sat-tên-nî-â-ngî	Língua sarda
Nì-ngá-ngì-ngî	Língua neuari
Valparaíso	Valparaíso (Chile)
Yên-yèn	Ator
Thap-kâ-lo̍k-ngî	Língua tagalo
Thùng	Bronze
Tausūg-ngî	Língua tausug
Vlaams-ngî	Língua flamenga
Fà-liùng-ngî	Língua valona
Sú-ngî	Língua de sinais
Międzyrzec Podlaski	Międzyrzec Podlaski
Phiêu-chún Chhông-ngî	Língua tibetana
Ngá-shuì-ngá-shuì-ngî	Língua waray-waray
N̂g-ngî	Língua wu
Woodrow Wilson	Woodrow Wilson
Fu̍t-sân-sṳ	Foshan
Ngiù-chîn Thai-ho̍k	Universidade de Oxford
Sú-tsṳ́	Dedo
Sṳ̍p-thiàu Kie-min	Dez Mandamentos
Yok-hon-nì-sṳ̂-páu	Joanesburgo
Kî-tuk Kau-fi	Igreja
Pau-é	Leopardo
Sîn-kiông	Xinjiang
Muk-kôa	Mamão
Pu-lî-sṳ̂-pân	Brisbane
Â-mî-ngî	Língua amis
Vî-liâm Lùn-khìm	Wilhelm Conrad Röntgen
Chû-chhèu	Dinastia Zhou
Ido-ngî	Língua ido
Brad Pitt	Brad Pitt
Pa̍k-kiûng	Casa Branca
Tha̍t-mâ-thai-ngî	Língua dálmata
Tat-tat-chhu̍k	Tártaros
Thai-fán-sṳ	Osaka (cidade)
Kiam-khiâu Thai-ho̍k	Universidade de Cambridge
Kûng-khín	Hectare
Sé-lî	Batismo
Pông-hâ	Asma
Chuk	Bambu
Fù Tsṳ-mìn	Ho Chi Minh
Thièn-piên-fú	Dien Bien Phu
Khûn-sṳ-làn-chû	Queensland
Mìn-nì-â-pô-li-sṳ̂	Minneapolis
Li-kú-lî-â-ngî	Língua lígure
Phô-lò-chû	Bornéu
Khà-phién-phién-kâm-ngî	Língua kapampangan
Vù-fâ-kó	Figueira-comum
Sun-fa-sṳ	Huế
Tshòng-thu	Comprimento
Sṳ̂-chhù-chṳ̂-lu	Rota da Seda
Mô-li-ngî	Língua maori
Mên-tûng-ngî	Língua min oriental
Tô-se-pâu sâng-vu̍t	Organismo multicelular
Mên-nàm-ngî	Min Nan
Tshiên-ngièn	Milênio
Ho̍k-miàng	Nomenclatura binomial
Vì-tô-li-â-chû	Vitória (Austrália)
Chong-chhu̍k	Zhuang (etnia)
Sông-hói-fa	Dialeto xangainês
Pet-kông	Bac Giang (cidade)
Aung San Suu Kyi翁山蘇姬	Aung San Suu Kyi
Yok-hon-fuk-yîm	Evangelho segundo João
William Vòng-chṳ́	Guilherme, Duque de Cambridge
Kâm-tsà	Cana-de-açúcar
Chhṳ̀n Kóng-sâng	Jackie Chan
12	Doze
Vok-là-phú-khiet-ngî	Língua volapuque
Toshiro Mifune	Toshiro Mifune
Kám-lám-su	Oliveira
Só-lò-mùn-vòng	Salomão
O-khiet-làn	Auckland
Chhṳ̍t-sien	Reta
11	Onze
13	Treze
Sûn-chṳ́	Sun Tzu
Sṳn-lìn	Espírito Santo
Lû-pu-lìm	Lublin
Thì-thèu	Amendoim
100	Cem
Tshit-thèu	Joelho
Tô-piên-hìn	Polígono
Nàm Chûng-koet Hói	Mar da China Meridional
Campora San Giovanni	Campora San Giovanni
Pien-set-liùng	Camaleão
Bloemfontein	Bloemfontein
Ngiam-set-thí	Cromossomo
O-khiet-làn Vùn-fap Ho̍k-káu	Auckland Grammar School
Ngióng-kông	Rangum
Ma̍k-tông-lò Kûng-sṳ̂	McDonald's
1000000	Milhão
Meu-miàng-sṳ	Chaozhou
Liú-chiu-sṳ	Liuzhou
Pet-pan-khiù	Hemisfério norte
Ló-chhú	Mus
Thí-tsit	Volume
Het-tsṳ̂	Hertz
Pak-pân-khiet	Burbank (Califórnia)
Sien-lia̍p-thí	Mitocôndria
Yî-sên	Médico
Ki-sa̍k-chhṳn	Stonehenge
Chúng-thí Kîn-chi-ho̍k	Macroeconomia
Ágreda	Ágreda
Lu-kâ-fuk-yîm	Evangelho segundo Lucas
Sîn Kí-nui-â	Nova Guiné
Sṳ́-thù-hàng-chhon	Atos dos Apóstolos
Mô-hái	Caranguejo
PH	PH
Khì-tó	Oração
Ôn-fui-sén	Anhui
Chûng-chhîn Pet-tho	Chungcheong do Norte
Chûng-chhîn Nàm-tho	Chungcheong do Sul
Kông-ngièn-tho (Hôn-koet)	Gangwon
Nui Mùng-kú	Mongólia Interior
Kîm Ngit-sṳ̀n	Kim Il-sung
Pí-tet-kô-sṳ̍p	Bydgoszcz
Nottingham	Nottingham
Thai-ví-vòng	David
Li-vi-ki	Levítico
Sṳ̂-thán-fuk Thai-ho̍k	Universidade Stanford
Fuk-kian	Fujian
Kûng-khiet	Grama
Mùng-kú-tshu̍k	Mongóis
Khí-sṳ-liu̍k	Apocalipse
Kô-yòng-sṳ	Goyang
Kóng-chû-sṳ (Hôn-koet)	Gwangju (Gyeonggi)
Kiú-lî-sṳ	Guri
Fu-chhôn-sṳ	Bucheon
Sàng-nàm-sṳ	Seongnam
Ôn-sân-sṳ	Ansan (Coreia do Sul)
Ôn-yông-sṳ	Anyang (Coreia do Sul)
Thiên-ôn-sṳ	Cheonan
Chhîn-chû-sṳ	Cheongju
Chhûn-chhôn-sṳ	Chuncheon
Thai-pha̍k-sṳ	Taebaek
Po-chû-sṳ	Paju
Buckingham Kiûng	Palácio de Buckingham
Hói-nàm	Hainan
Yén-tûng	Extremo Oriente
Ngiên-kiu	Pesquisa
Kâm-suk	Gansu
Pha̍k Se-pâu	Leucócito
York	Iorque
Tsiú	Cotovelo
Sṳ̂n-min-ki	Deuteronômio
Sû-chû-sṳ	Suzhou
Vûn-chû-sṳ	Wenzhou
Windsor Sàng-páu	Castelo de Windsor
Hòn-chhu̍k	Han (etnia)
Nèn-pô-sṳ	Ningbo
Tet-koet-ngìn	Alemães
Ko-men	Alergia
Fù-khì	Sanguessuga
Kîm-yùng	Finanças
1000	Mil
Mìn-su-ki	Livro dos Números
Liu̍k Khiet-vùn	Kevin Rudd
Ngo̍k-ǹg	Crocodilo
Yùn-nàm	Yunnan
Vû-â	Corvo
Plymouth	Plymouth (Devon)
Sân-tûng	Shandong
Pí	Braço
Derby-sṳ	Derby (Derbyshire)
Thàn-khîn Fa-ha̍p-vu̍t	Hidrocarboneto
Hò-nàm	Henan
Montehermoso	Montehermoso
Liâu-nèn	Liaoning
El Cid	O Cid
Jim Morrison	Jim Morrison
Kóng-khiéu	Porto (transporte)
Thòi-vân Thò-yèn Koet-chi Kî-chhòng	Aeroporto Internacional Chiang Kai-shek
Kit-lìm	Jilin
Fù-nàm	Hunan
Chhiâng-hói	Qinghai
Vì-ngâ-ngì-tshu̍k	Uigures
Rhône-sén	Ródano (departamento)
Koet-kâ Kûng-yèn	Parque nacional
Pâ-lì Charles-de-Gaulle Koet-chi Kî-chhòng	Aeroporto de Paris-Charles de Gaulle
Chṳ̂-sán	Ativo
O-le̍t-liòng	Aureliano
Fù-pet	Hubei
Sân-sî	Shanxi
Hòng-khûng Kûng-sṳ̂	Linha aérea
Hò-khiéu-vân	Estuário
Chûng-set	Marrom
Kui-chû	Guizhou
Chûng-khi Sṳ̀n-kîn Ne-thúng	Sistema nervoso central
Yî-fut-só	Éfeso
Ôn-tha̍t-màn Hói	Mar de Andamão
Yok-sû-â-ki	Livro de Josué
Sî-pet Yîn-kak-làn	Noroeste da Inglaterra
Shám-sî-sén	Shaanxi
Tûng-pet Yîn-kak-làn	Nordeste da Inglaterra
Tûng Midlands	Midlands Orientais
Tûng Yîn-kak-làn	Leste da Inglaterra
Tûng-nàm Yîn-kak-làn	Sudeste da Inglaterra
Sî-nàm Yîn-kak-làn	Sudoeste da Inglaterra
模板:Commonscat	Predefinição:Commonscat
Sî Midlands	Midlands Ocidentais
Yorkshire lâu Humber	Yorkshire e Humber
Kòn Se-pâu	Célula-tronco
Lò-mâ-sû	Epístola aos Romanos
Mâ-liuk-kap Hói-hia̍p	Estreito de Malaca
Yù-thai Vòng-koet	Reino de Judá
Mî-koet Pha̍k-ngìn	Americanos brancos
Fî-yí Mî-koet Het-ngìn	Afro-americano
Mà-sat-chû-set Lî-kûng Ho̍k-yen	Instituto de Tecnologia de Massachusetts
Pô-sṳ-tun Thai-ho̍k	Universidade de Boston
Yâ-lû Thai-ho̍k	Universidade Yale
Nàm-pet-chêu	Dinastias do Norte e do Sul
Fûn-lî	Boda
Pan Chúng-thúng-chṳ	Semipresidencialismo
Siong-yòng-khiùn	Yangyang
Vàng-sàng-khiùn	Hoengseong
Ên-phìn-sṳ	Eunpyeong-gu
Fî-li̍p-pí-sû	Epístola aos Filipenses
Thiên-koet Pat-fuk	Bem-aventuranças
Mî-koet Lièn-pâng Chún-phi Ne-thúng	Sistema de Reserva Federal dos Estados Unidos
Kúai-é	Anura
Hâ Sî-lî-sî-â-sén	Voivodia da Baixa Silésia
Khù-â-vì - Pô-mî-là-nì-â-sén	Voivodia da Cujávia-Pomerânia
Lû-pu-lìm-sén	Voivodia de Lublin
Lû-pu-sṳ̂-khà-sén	Voivodia da Lubúsquia
Lò-tsṳ-sén	Voivodia de Łódź
Séu Pô-làn-sén	Voivodia da Pequena Polónia
Mâ-tsó-fû-sá-sén	Voivodia da Mazóvia
O-pô-lòi-sén	Voivodia de Opole
Khak-ngì-pâ-yèn-sân-sén	Voivodia da Subcarpácia
Pô-tet-là-chhia-sén	Voivodia da Podláquia
Pô-mî-là-nì-â-sén	Voivodia da Pomerânia
Sî-lî-sî-â-sén	Voivodia da Silésia
Sṳn-sṳ̍p-sṳ-sén	Voivodia de Santa Cruz
Sî Pô-mî-là-nì-â-sén	Voivodia da Pomerânia Ocidental
Pâ-lùn-sî-â-sén	Valência (província)
Sat-là-kô-sat-sén	Saragoça (província)
Vùi-sṳ̂-khà-sén	Huesca (província)
Sok-lî-â-sén	Sória (província)
Hien-thoi Khì-chhâ	Hyundai Motor Company
Kîm Tsang-ên	Kim Jong-un
Phû-sien-ngî	Língua putian
Kông-sî	Jiangxi
Wernher von Braun	Wernher von Braun
Nèn-ha	Ningxia
Lí Hién-liùng	Lee Hsien Loong
Phòng-châ-phú-ngî	Língua panjabi
Phú-sṳ̍p-thok-ngî	Língua pachto
Yâ-chû	Javali
Chû-hói-sṳ	Zhuhai
Sân-thèu-sṳ	Shantou
Shâu-kûan-sṳ	Shaoguan
Kông-mùn-sṳ	Jiangmen
Chhám-kông-sṳ	Zhanjiang
Shàu-khin-sṳ	Zhaoqing
Fi-chiu-sṳ	Huizhou
Mòi-chiu-sṳ	Meizhou
San-mî-sṳ	Shanwei
Tûng-kôn-sṳ	Dongguan
Chûng-sân-sṳ	Zhongshan
Thiên-tén-yen	Condado de Tiandeng
Liùng-chiu-yen	Condado de Longzhou
Nèn-mìn-yen	Condado de Ningming
Thai-sîn-yen	Condado de Daxin
Mâ-liuk-kap-sṳ	Malaca (cidade)
Khiâu-chhṳ-sṳ	George Town (Penang)
IPhone 5	IPhone 5
Sṳn-chhôn-lî	Eucaristia
Fuk-chiu-sṳ	Fucheu
Nàm-phìn-sṳ	Nanping
Phû-thièn-sṳ	Putian
Sâm-mìn-sṳ	Sanming
Tshièn-chiu-sṳ	Quanzhou
Hà-mûn-sṳ	Xiamen
Chông-chiu-sṳ	Zhangzhou
Liùng-ngâm-sṳ	Longyan
Sî-pak-li-â Fú	Tigre-siberiano
Thiên-ngô-yen	Condado de Tian'e
Nàm-tan-yen	Condado de Nandan
Fung-sân-yen	Condado de Fengshan
Tûng-làn-yen	Condado de Donglan
Pat-tet-sṳ	Bade
Nó	Encéfalo
Thông Ngiâ-mong	Johann Adam Schall von Bell
Yáng-chhiong Chín-thôn-ho̍k	Radiologia
Rumia	Rumia
Kluczbork	Kluczbork
La̍p-tsuk	Vela
Hiet-chiong	Plasma (sangue)
Southampton	Southampton
Lu-tet-ki	Livro de Rute
Hâ-sat-khiet-chhu̍k	Cazaques
Yòng-mî	Libélula
Chit-fûn-ho̍k	Integral
Kô-lìm-tô-chhièn-sû	Primeira Epístola aos Coríntios
Sî-pân-ngà Ti-koet	Império Espanhol
Sṳ-sṳ̂-ki	Livro dos Juízes
Po-lîn-chhòi	Espinafre
Pâ-set-lò-nâ-sén	Barcelona (província)
Liuk-piên-hìn	Hexágono
Thòi-pet 101	Taipei 101
Lùn-tûn Thap-khiâu	Tower Bridge
Luì-kûng	Trovão
Siù-li Yún-kòn-sien-chhùng	Caenorhabditis elegans
O-pô-lòi	Opole
Sopot	Sopot
Â-sṳ̂-thù-lî-â-sṳ̂-sén Chhṳ̍t-hot-sṳ	Lista de municípios das Astúrias
Kám-lám-yù	Azeite
Chim-sin-fi	Igreja Batista
Lie̍t-yî-tha̍t-sén Chhṳ̍t-hot-sṳ	Lista de municípios de Lérida
Set-vì-li-â-sén	Sevilha (província)
Thap-là-kô-na̍p-sén	Tarragona (província)
Provence-sén	Provença
Kî-hài Kûng-chhàng	Engenharia mecânica
Apeldoorn	Apeldoorn
Lìm-pó-ngî	Língua limburguesa
Khái-ngì-chhái	Kielce
Bytom	Bytom
Ôn-sit-ngit	Shabat
Khìm-sṳ̂-thok-khok-ngá	Częstochowa
Zabrze	Zabrze
Ôn-sit-ngit-fi	Igreja Adventista do Sétimo Dia
Jean Michel Jarre	Jean Michel Jarre
Thai Pô-làn Thi-khî Kô-yî-fû	Gorzów Wielkopolski
Là-tô-mê	Radom
Lo̍k-chham-ki-yen	Condado de Los Angeles
Słupsk	Słupsk
Sosnowiec	Sosnowiec
Gliwice	Gliwice
Yo̍k-sṳ̂	Farmacêutico
Hi-kôn Yì-chhṳ̍t	Transplantação de órgãos
Pâ-lùn-sî-â-sén Chhṳ̍t-hot-sṳ	Lista de municípios de Valência
Bielsko-Biała	Bielsko-Biała
Rybnik	Rybnik
Tân-fu̍t Se-pâu	Monócito
Mâ-khó-fuk-yîm	Evangelho segundo Marcos
Ruda Śląska	Ruda Śląska
Yok-thán-vòng	Jotão de Judá
Nò-mí	Arroz glutinoso
Kîn-tû-fú	Quioto (província)
Thai-fán-fú	Osaka
Fuk-kông-yen	Fukuoka
Oi-yèn-yen	Ehime
Kô-lìm-tô-heu-sû	Segunda Epístola aos Coríntios
Khien-mî	Fisiculturismo
Chhùng-hièn	Minhoca
Port Elizabeth	Porto Elizabeth
Kimberley (Nàm-fî)	Kimberley (Cabo Setentrional)
Yok-sâ-fap-vòng	Josafat
Thòi-vân Hói-hia̍p	Estreito de Taiwan
Sî Khôi-phú-sén	Cabo Ocidental
Yamaguchi-yen	Yamaguchi
Khiâu-chhṳ Sâm-sṳ	Jorge III do Reino Unido
Chûng-koet Thi-fông	Região de Chugoku
Mî-koet Thu̍k-li̍p Siên-ngièn	Declaração da Independência dos Estados Unidos
Sâm-tshûng-yen	Mie
Yù-mu̍k mìn-chhu̍k	Nomadismo
Hiông-pak-su	Cedrus
Hî-pak-lòi-sû	Epístola aos Hebreus
Kâ-lâ-thai-sû	Epístola aos Gálatas
Màn-é	Anguilliformes
Sông-chhèu	Dinastia Shang
Thai-thúi	Coxa
Pîn-khù-yen	Hyōgo
Kiûng-khì-yen	Miyazaki
Yùng-pún-yen	Kumamoto
Stamford Raffles	Thomas Stamford Raffles
Sha̍m-é	Cigarra
Tûng Khôi-phú-sén	Cabo Oriental
Fap-koet Hòng-khûng	Air France
Lie̍t-vòng-ki-song	I Reis
Kô-lò-sî-sû	Epístola aos Colossenses
Ngâ-kok-sû	Epístola de Tiago
Yok-hon-yit-sû	Primeira Epístola de João
Fî-li-mùn-sû	Epístola a Filémon
Thiap-sat-lò-nì-kâ-heu-sû	Segunda Epístola aos Tessalonicenses
Thiap-sat-lò-nì-kâ-chhièn-sû	Primeira Epístola aos Tessalonicenses
Pí-tet-chhièn-sû	Primeira Epístola de Pedro
Thì-mô-thai-chhièn-sû	Primeira Epístola a Timóteo
Lí Kông-yeu	Lee Kuan Yew
Chṳ̂-kâ-kô Thai-ho̍k	Universidade de Chicago
Tsṳ̂-fo-yen	Shiga
Mu-nì-het Kî-chhòng	Aeroporto de Munique-Franz Josef Strauss
Yok-hon-ngi-sû	Segunda Epístola de João
Thì-mô-thai-heu-sû	Segunda Epístola a Timóteo
Thì-tô-sû	Epístola a Tito
Yî-sṳ̂-lâ-ki	Livro de Esdras
Nì-hî-mí-ki	Livro de Neemias
Pietersburg	Polokwane
Séu Pha̍k-Lù	Egretta garzetta
Chhòn-ngiam-phiang	Doença infecciosa
Kôn-yàm	Hepatite
Chhûn-chiet	Ano-novo chinês
Shinzō Abe	Shinzō Abe
Mpumalanga-sén	Mpumalanga
Pet Khôi-phú-sén	Cabo Setentrional
Tó-kîn-yen	Shimane
Kông-sân-yen	Okayama
Gauteng-sén	Gauteng
Thung-fûng	Gota (doença)
Thai-fûn-yen	Oita
Tiâu-tshí-yen	Tottori
Nùng-la̍k	Calendário chinês
Kô-tî-yen	Kōchi
Pha̍k-hèu	Difteria
Exeter	Exeter
Saint Lawrence-hò	Rio São Lourenço (América do Norte)
Limpopo-sén	Limpopo (África do Sul)
Kô-tén Kau-yuk	Ensino superior
Â-pí	Kota Kinabalu
Phok Kiún-fi	Park Geun-hye
Lévis	Lévis
Laval (Québec)	Laval (Quebec)
Charlemagne, Québec	Charlemagne (Québec)
Mâ-lòi Pô-lî-nì-sî-â Ngî-chhu̍k	Línguas malaio-polinésias
Fên-yòng-sṳ	Hengyang
Mân-chiu-tshu̍k	Manchu
Zambrów	Zambrów
Doetinchem	Doetinchem
Zamość	Zamość
Malbork	Malbork
Mì-chit-fûn-ho̍k	Cálculo
Ngo̍k-yòng-sṳ	Yueyang
BP	BP
Sú-thiàu	Batata frita
Kiok-tsṳ́	Artelho
Vî-liâm Â-li̍t-sân-thai (Hò-làn)	Guilherme Alexandre dos Países Baixos
Krasnystaw	Krasnystaw
Sî-kung-khî	Sai Kung (distrito)
Mâ-nâ-sî-vòng	Manassés de Judá
Kî-kîm-fi	Fundação (instituição)
A-hîn Kôn-yàm	Hepatite A
Yù-tsiâm-vong-khî	Yau Tsim Mong (distrito)
Fûng-sái	Caqui
Tshṳ̍t-tshòng	Reto
Chhṳ-yù Pâng-sén	Estado Livre
Tsó-fo-yen	Saga (província)
Tet-tó-yen	Tokushima
Sî-pân-ngà-ngìn	Espanhóis
Fu̍t-chhṳ̂ Khiung-chṳn Sṳ̀n-siong	Imagem por ressonância magnética
Hiông-tshon-yen	Kagawa
Reading, Berkshire	Reading
Kâ-chû Lî-kûng Ho̍k-yen	Instituto de Tecnologia da Califórnia
Vì-ngì-tshṳ-páu Thai-ho̍k	Universidade de Würzburgo
Êu-kí-lî-tet Kí-hò	Geometria euclidiana
Si̍t-kuk	Vale do Silício
Khiu Tha̍t-sîn	Thaksin Shinawatra
Kîm-kôa	Abóbora
Thai Sùn-thâ Khiùn-tó	Grandes Ilhas da Sonda
Doesburg	Doesburg
Sî-pet-sén	Noroeste (África do Sul)
Sien-thon	Segmento de reta
Vûn-tai	Clima temperado
Â-kûng	Avós
Thai-khi̍t-khièn	Tai chi chuan
Kiok-khwá	Tornozelo
Hò-làn Tâi-thi Sat-khiet-sùn-ngî	Baixo saxão
Pân-kiêu-é	Rola-comum
Tshòng-khì-yen	Nagasaki (província)
Hà-chhèu	Dinastia Xia
Chû-vì Sṳ̀n-kîn Ne-thúng	Sistema nervoso periférico
Lùn-tûn Thai-ho̍k	Universidade de Londres
Kip-sú	Série (matemática)
Nelspruit	Nelspruit
Sâ-là-ye̍t-chû	Sarawak
Â-chû Thai-phìn-yòng Kîn-tsi Ha̍p-tsok Fi-ngi	Cooperação Econômica Ásia-Pacífico
Kôan-chiet-yàm	Artrite
Montauban	Montauban
Chhòng-sâ-sṳ	Changsha
Thai Put-lie̍t-tiên lâu Oi-ngì-làn Lièn-ha̍p Vòng-koet	Reino Unido da Grã-Bretanha e Irlanda
Kiok-kiên	Calcanhar
Kûng-fûn	Centímetro
Lièn-ha̍p Hòng-khûng	United Airlines
Yen-thèu	Faringe
Hò-mí	Milímetro
Mì-mí	Micrómetro (unidade de medida)
Pâ-mâ Yâu-chhu̍k Chhṳ-chhṳ-yen	Condado Autônomo Yao de Bama
Khi̍t-han (Sú-ho̍k)	Limite
Theu-fú	Tofu
Phù-sat	Bodisatva
Chóng-ló Kau-fi	Presbiterianismo
Hien-thoi Veloster	Hyundai Veloster
Nai-mí	Nanómetro
Berlanga de Duero	Berlanga de Duero
Sâ-pâ-chû	Sabá (Malásia)
Nàm-nèn-sṳ	Nanning
Ngâ-li-ôn-ngìn	Arianos
Yù-sṳn-mî-thi Koet-kâ Kûng-yèn	Parque Nacional de Yosemite
Chhiâng-set	Ciano
Ho̍k-yen	Faculdade
Kô-hiùng-sṳ	Kaohsiung
Pet-mî Chhṳ-yù Mo-yi Hia̍p-ngi	Tratado Norte-Americano de Livre Comércio
Sû-kak-làn-ngìn	Escoceses
Rustenburg	Rustemburgo
Yù-fu̍t-chû	Johor
Ngò-lò-sṳ̂ Lièn-pâng Chhṳ̍t-hot-sṳ	Cidades Autônomas da Rússia
Fì-tshu̍k	Hui (povo)
Sha̍k-sṳ	Mestrado
Preston, Lancashire	Preston
Sî-tí-kâ-vòng	Zedequias
Sâm-koet	Três Reinos
Chhûn-chhiû Sṳ̀-khì	Período das Primaveras e Outonos
Chan-koet Sṳ̀-khì	Período dos Reinos Combatentes
Mâ-liuk-kap-chû	Malaca
Pietermaritzburg	Pietermaritzburg
Kit-làn-tan-chû	Kelantan
Tshông-tshu̍k	Tibetanos
Pîn-sàng-chû	Penang
Blackburn	Blackburn
Chûng-sin Pha̍k-hiet-khiû	Granulócito neutrófilo
Pâng-kâ-tó	Bangka
Phìn-chhông-khiùn	Pyeongchang
Thai-koet Koet-chi Hòng-khûng Kûng-sṳ̂	Thai Airways International
Thai Ngi̍t-pún Ti-koet	Império do Japão
Hiûng-nù	Xiongnu
Phit-li̍t-chû	Perak
Lùn-tûn Ti-koet Ho̍k-yen	Imperial College London
Kui-lìm-sṳ	Guilin
Siet-làn-ngô-chû	Selangor
Tui-kok-sien	Diagonais de um polígono
Fi-li-phi Liuk-sṳ	Filipe VI da Espanha
Kûng-tún	Tonelada
Phàng-hên-chû	Pahang
中國象棋	Xiangqi
Pit-sṳn-hak	Pizza Hut
Yim-suk Siáu-tsṳ́	Sonic the Hedgehog (personagem)
Ngo̍k-vûn-khiet-tshu̍k	Evenkis
Kiu-ên	Salvação
Nàm-kîn Thai-thù-sat	Massacre de Nanquim
Yún Chṳ-Hau	Yun Chi-ho
Phì-mí	Picômetro
Chûng-koet 2010-ngièn Sông-hói Sṳ-kie Pok-lám-fi	Expo 2010
Ngiù-ngiuk	Carne bovina
Carlisle, Cumbria	Carlisle
Sandomierz	Sandomierz
Ngit-tèu-kông	Luz solar
Khwon-kûan-tsiet	Quadril
Fûn-kî-hon-khiûn	Mycobacterium
Chàu-yòng-sṳ	Shaoyang
Hién-mì-kiang	Microscópio
Chông-kâ-kie-sṳ	Zhangjiajie
Chṳ Sṳ̀n-kûng	Koxinga
Chon-hiuk	Zhuanxu
Chu-chû-sṳ	Zhuzhou
Kûng-tshun	Decímetro
McGill Thai-ho̍k	Universidade McGill
Sâm-fòng Ńg-ti	Três Augustos e os Cinco Imperadores
Sanok	Sanok
Mâ-tshâ	Biga
Milton Keynes	Milton Keynes
Â-mî-tshu̍k	Amis (povo)
Ên-tién	Graça
Sṳ̀n-chhùng	Imago
Chang Thien-chṳ́ Fat-sa Kie-son-kî Thôn-chhèn Só-mèu	Tomografia por emissão de positrões
Przemyśl	Przemyśl
Chhiòn-khiû Sàng-sṳ	Cidade global
Pî-mí	Femtômetro
Burnley	Burnley
Tûng Lùn-tûn, Tûng Khôi-phú-sén	East London
Sat-mû-ngí-ki-ha	II Samuel
Li̍t-thoi-chṳ-ha	II Crônicas
Lie̍t-vòng-ki-ha	II Reis
Biała Podlaska	Biała Podlaska
Pet-hói-sṳ	Beihai
Mafikeng	Mafikeng
Mí-sâ-yên Khiùn-tó	Visayas
Lò-pô-ôn-vòng	Roboão
Slough	Slough
Thì-mô-thai	Timóteo de Éfeso
Chho̍k-sṳ̂-lia̍p	Centrómero
Tûng-hò, Néu-yok-sṳ	Rio East
Chhêu-fông-hìn	Hipercubo
Sêm-mî-làn-chû	Negeri Sembilan
Brzeg	Brzeg
Fidel Valdez Ramos	Fidel Valdez Ramos
Łomża	Łomża
Siong-thâm-sṳ	Xiangtan
Thûng-tshu̍k	Dong (etnia)
Pak-fo Kûng-sṳ̂	Loja de departamento
Thòi-vân Ngièn-tshu-mìn	Aborígenes de Taiwan
騷靈現象	Poltergeist
Outaouais	Outaouais
Kuî-é	Testudinata
Pak-sâ-sat	Belsazar
Tshièn-pí	Antebraço
Yî-set-lie̍t Vòng-koet	Reino de Israel
Tshòn-fì Yâ-lu-sat-lâng Yun-thung	Back To Jerusalem
Sîn-sân-sṳ	Johor Bahru
Khiu-kîm-sân Vân	Baía de São Francisco
Li Mâ-teu	Matteo Ricci
Tshài Yîn-vùn	Tsai Ing-wen
Chełm	Chełm
Pha̍k-ngìn	Brancos
Â-ha̍p-vòng	Acabe
Suwałki	Suwałki
Sî-làn-ngî	Zeêuws
Maidenhead	Maidenhead
Chû Khiet-lùn	Jay Chou
Winburg	Winburg
Kiú-liùng	Kowloon
Nâ-pô-nì-tha̍t	Nabonido
Ngie-mí-li-ôn Lò-mâ-nok-ngî	Língua emiliano-romanhola
Sîn-pet-sṳ	Nova Taipé
Hî-sî-kâ-vòng	Ezequias
Thòi-chûng-sṳ	Taichung
IPhone 4S	IPhone 4s
Jędrzejów	Jędrzejów
Kîm-mùn-yen	Kinmen
Kî-lùng-sṳ	Keelung
Busko-Zdrój	Busko-Zdrój
Àu-thai-li-â Ngièn	Dólar australiano
Mò Chhiang-li ke Thung-vu̍t	Animais impuros
Hon-ho̍k	Sinologia
Yî-pó-sṳ	Ipoh
Ná-pô-pha-lâ-sâ-ngì	Nabopolasar
Â-pí-ngâ-vòng	Abias de Judá
Sûn N̂g	Wu Oriental
Pińczów	Pińczów
Aalten	Aalten
Xuxa	Xuxa
Hajnówka	Hajnówka
Lubartów	Lubartów
Lucélia Santos	Lucélia Santos
Montréal-tó	Ilha de Montreal
IPhone 3GS	IPhone 3GS
IPhone 4	IPhone 4
IPhone 3G	IPhone 3G
Alan Dawa Dolma	Alan Dawa Dolma
Mâ-lòi-sî-â Hòng-khûng	Malaysia Airlines
Lì-tshu̍k	Li (etnia)
Mí-nâ-hien-vòng	Menaém
Â-ha̍p-chhia-vòng (Yî-set-lie̍t)	Ocozias de Israel
Â-ha̍p-chhia-vòng (Yù-thai)	Ocozias de Judá
Yok-làn-vòng (Yù-thai)	Jorão de Judá
Â-sat-li-ngâ	Uzias
Yâ-lò-pô-ôn yit-sṳ	Jeroboão I
Am-li-vòng	Omri
Nâ-tap-vòng	Nadabe (filho de Jeroboão)
Pâ-sâ-vòng	Baasa
Yâ-fu-vòng	Jeú
Yok-sî-â-vòng	Josias
Yok-â-sṳ̂-vòng (Yù-thai)	Joás de Judá
Sîm-li-vòng	Zimri
Yâ-lò-pô-ôn ngi-sṳ	Jeroboão II
Yî-vi-mí-lò-tha̍t	Evil-Merodaque
Â-mâ-chhia-vòng	Amassias
Yî-sṳ̂-pô-sat-vòng	Isboset
Â-sat-vòng	Asa (rei de Judá)
Â-mùn-vòng	Amom de Judá
Chong Koet-yùng（Chong Fat-chûng）	Leslie Cheung
Lí Tên-Fî	Lee Teng-hui
Yî-lâ-vòng	Elá (rei de Israel)
Yok-ngâ-kin-vòng	Joaquim de Judá
Hò-se-â-vòng	Oséias (Rei de Israel)
Yok-ngâ-kîn-vòng	Jeconias de Judá
Biłgoraj	Biłgoraj
Chhî Chai-Phit	Philip Jaisohn
Puławy	Puławy
Chuk Hon	Shu Han
Chhâu Ngùi	Cao Wei
Abitibi-Témiscamingue	Abitibi-Témiscamingue
Staszów	Staszów
Mò-tóng-sit	Político sem partido
Iwakuni-sṳ	Iwakuni
Phok Hièn-yún	Pak Hon-Yeong
Sat-kâ-li-ngâ-vòng	Zacarias (rei)
Yok-ha̍p-sṳ̂-vòng	Joacaz de Israel
Fùng Siù-chhiòn	Hong Xiuquan
Yok-â-sṳ̂-vòng (Yî-set-lie̍t)	Joás de Israel
Yok-làn-vòng (Yî-set-lie̍t)	Jorão de Israel
Pí-kâ-vòng	Peca
Sâ-liùng-vòng	Salum
Pí-kâ-hot-vòng	Pecaías
Khiu Sṳ̀n-thûng	Shing-Tung Yau
Fùng Puk-kím Kiê	Faisão-dourado
Grajewo	Grajewo
Yok-ha̍p-sṳ-vòng	Joacaz de Judá
Łapy	Łapy
瑤族	Yao (etnia)
Sîn-chông-khî	Hsinchuang
Hagi-sṳ	Hagi
Chûng-chhiû-chiet	Festival da Lua
Nài-lî-kak-li-sâ-ngì	Neriglissar
Fùng-theu	Vigna angularis
Łuków	Łuków
Łęczna	Łęczna
Świdnik	Świdnik
Pô-sṳ̂ Ti-koet	Império Aquemênida
Nagato-sṳ	Nagato
Sî-lìm-yen	Condado de Xilin
Mâ-thai-fuk-yîm	Evangelho segundo Mateus
Sṳ̍p-sṳ-ka	Cruz cristã
Â-chû Hòng-khûng	AirAsia
Yî-fut-só-sû	Epístola aos Efésios
Sòng-tet-sṳ	Changde
Yit-yòng-sṳ	Yiyang
Chhim-chû-sṳ	Chenzhou
Tshî Kông-khí	Xu Guangqi
10000	Dez mil
Fún-fùng-set	Cor-de-rosa
Nâ-sat-le̍t	Nazaré
Â-thâ-li-ngâ	Atália
Augustów	Augustów
Windsor, Berkshire	Windsor
Kô Khô-kî	Alta tecnologia
Tai Tet-sâng	Hudson Taylor
Tczew	Tczew
Thòi-nàm-yen	Tainan (condado)
Fù-chṳ-mìn-sṳ Kî-chhòng	Aeroporto Internacional Tan Son Nhat
Hien-thoi Accent	Hyundai Accent
Hien-thoi Sonata	Hyundai Sonata
Hien-thoi Elantra	Hyundai Elantra
Hien-thoi Equus	Hyundai Equus
Vû-tsṳ-phe̍t-khiet-chhu̍k	Uzbeques
Hien-thoi Genesis Coupé	Hyundai Genesis Coupe
Thap-kit-khiet-tshu̍k	Tajiques
Wal-Mart Kûng-sṳ̂	Walmart
Yùn-tôn yun-son	Computação em nuvem
Ńg-sùn-chiet Yun-thung	Pentecostalismo
Liu̍k-theu	Vigna radiata
Chêu-siên-chhu̍k	Coreanos
Khúa-ngì-khiet-tsṳ-tshu̍k	Quirguizes
Burgo de Osma-Ciudad de Osma	Burgo de Osma
Sông-hói Ha̍p-tsok Tsû-tsṳt	Organização para Cooperação de Xangai
Yì Kit-chùn	Yu Kil-chun
Reus	Reus
San Esteban de Gormaz	San Esteban de Gormaz
Hien-thoi Santa Fe	Hyundai Santa Fe
Yî-ho̍k-yen	Faculdade de Medicina
Sṳ̀n-chheu-fi	Assembleia de Deus
Phok Chhùng-yòng	Park Jung-yang
Sâ-â-nàm	Shah Alam
Kit-lùng-po Koet-chi Kî-chhòng	Aeroporto Internacional de Kuala Lumpur
Ngiu̍k-Sân	Yu Shan
Hōfu-sṳ	Hōfu
Thai-yí-sân	Lantau
Starogard Gdański	Starogard Gdański
Sîn-chhèu	Dinastia Xin
Mauricie	Mauricie
Strzelce Opolskie	Strzelce Opolskie
Hò-làn Tâi-thi Sat-khiet-sêm-ngî	Baixo-saxão neerlandês
Kâu-thûng	Transporte rodoviário
Vû-yìn	Muscidae
Tha̍t-mâ-thai	Dalmácia
Witwatersrand Thai-ho̍k	Universidade de Witwatersrand
Mâ-lî-sûn	Robert Morrison
Fû-lùn-pi-ngì-sṳ	Hulunbuir
Ǹg-chiu-sṳ	Wuzhou
Fòng-sàng-kóng-sṳ	Fangchenggang
Khîm-chiu-sṳ	Qinzhou
Kui-kóng-sṳ	Guigang
Ngiu̍k-lìm-sṳ	Yulin
Pak-set-sṳ	Baise
Fo-chiu-sṳ	Hezhou
Hò-chhṳ̀-sṳ	Hechi
Lòi-pîn-sṳ	Laibin
Fuk-thièn-khî	Distrito de Futian
Chhùng-chó-sṳ	Chongzuo
Sîn-kie	Novos Territórios
Mo-yi	Comércio
Kędzierzyn-Koźle	Kędzierzyn-Koźle
Yo̍k-ho̍k	Farmácia
Kóng-tó-yen	Província de Hiroshima
IPhone (Thi-yit thoi)	IPhone (original)
Ólvega	Ólvega
Sîn Pâ-pí-lùn Vòng-koet	Império Neobabilônico
Thú-ngí-khì-ngî sṳ-mû	Alfabeto turco
Shūnan-sṳ	Shunan
Skarżysko-Kamienna	Skarżysko-Kamienna
Longás	Longás
Kô-tá-ha̍p-lû-sṳ	Kota Bharu
Kông-phú	Espectro (física)
Chhṳ̂m-súi-phu-khî	Sham Shui Po (distrito)
Mielec	Mielec
客家	Hacá
Wejherowo	Wejherowo
Nâ-po-yen	Condado de Napo
Ńg-fù Sṳ̍p-liuk-koet	Dezasseis Reinos
Néu-yok Tû-fi-khî	Região Metropolitana de Nova Iorque
歷峯雧團	Richemont
Lanaudière	Lanaudière
Vòng Sîm-lìn	Cyndi Wang
Mèu-li̍t-sṳ	Miao Li
2009-ngièn sṳ-kie yun-thung-fi	Jogos Mundiais de 2009
Joy	Joy (banda)
Thai-vú-hiông (Phìn-tûng)	Taiwu
Phìn-fông Kûng-lî	Quilómetro quadrado
Liùng-thâm-hiông	Longtan
Thòi-fûng Mo̍k-Là-Khiet (2009-ngièn)	Tufão Morakot (2009)
Thòi-pet Tshia̍p-yun	Metrô de Taipé
Chhòn-yùng Hòng-khûng	EVA Air
Kôn-yîm	Kuan Yin
Lìm-pâ Se-pâu	Linfócito
Thai-ngâ-ngî	Língua atayal
Thò-yèn-sṳ	Taoyuan (cidade)
Hak-kâ thú-lèu	Tulou de Fujian
100000	Cem mil
Kô-sîn-shì	Ku (imperador)
Jarosław	Jarosław
Gaspésie–Îles-de-la-Madeleine	Gaspésie-Îles-de-la-Madeleine
Ostrowiec Świętokrzyski	Ostrowiec Świętokrzyski
Sîn-kâ-po Koet-li̍p Thai-ho̍k	Universidade Nacional de Singapura
Chojnice	Chojnice
Bronckhorst	Bronkhorst
Thi-kip-sṳ	Prefeitura com nível de cidade
Mine-sṳ	Mine (Yamaguchi)
Włodawa	Włodawa
Starachowice	Starachowice
Stalowa Wola	Stalowa Wola
Chat-ho̍k Pok-sṳ	Doutorado em filosofia
Lì-tó-khî	Distrito das Ilhas (Hong Kong)
Ermelo	Ermelo (Guéldria)
Thông-phûng	Apidae
Tshûng-shîn-yen	Okinawa
Montpellier Thai-ho̍k	Universidade de Montpellier
Końskie	Końskie
Luceni	Luceni
Madrid Chhṳ-chhṳ Thai-ho̍k	Universidade Autónoma de Madrid
Tshṳ-tshṳ-chû	Prefeituras autônomas da China
Nysa, Pô-làn	Nysa
Belver de Cinca	Belver de Cinca
Kôan-tan-sṳ	Kuantan
Sokółka	Sokółka
Thâu-thông-shì	Yao (imperador)
Hikari-sṳ	Hikari
Krosno	Krosno
Kûng-lî	Quilômetro
Almarza	Almarza
Aldealices	Aldealices
Aldealafuente	Aldealafuente
Alentisque	Alentisque
Adradas	Adradas
Abejar	Abejar
Aldealpozo	Aldealpozo
Alcubilla de las Peñas	Alcubilla de las Peñas
Aldealseñor	Aldealseñor
Alcubilla de Avellaneda	Alcubilla de Avellaneda
Covaleda	Covaleda
Almazul	Almazul
Arcos de Jalón	Arcos de Jalón
Aldehuela de Periáñez	Aldehuela de Periáñez
Almenar de Soria	Almenar de Soria
Vinuesa	Vinuesa
Duruelo de la Sierra	Duruelo de la Sierra
San Leonardo de Yagüe	San Leonardo de Yagüe
Mùn-pâ-tshu̍k	Monpas
Kudamatsu-sṳ	Kudamatsu
Afrikaner-ngìn	Africânderes
Yîn-koet-ngìn	Britânico
Kûng-yîn	Hectômetro
Jasło	Jasło
Â-chhông-chhu̍k	Achang
Bielsk Podlaski	Bielsk Podlaski
Kîn-mí	Gigametro
Súi-tshu̍k	Shui (etnia)
Nyet-láu-tshu̍k	Gelao (etnia)
Vì-kî Pak-khô Ngî-ngièn Lie̍t-péu	Wikipédia:Wikipédia em outras línguas
Siên-pî-chhu̍k	Xianbei
Sanyo-Onoda-sṳ	Sanyo-Onoda
Fap-ho̍k	Ensino jurídico
Pet-khî (Hiông-kóng)	Distrito do Norte (Hong Kong)
Mu̍k-láu-tshu̍k	Mulao (etnia)
Sî-sûng-pán-na̍p Thài-tshu̍k Tshṳ-tshṳ-chû	Prefeitura autônoma dai de Xishuangbanna
Ngièn-lóng-khî	Yuen Long (distrito)
Kôn-thòng-khî	Kwun Tong (distrito)
Khwûi-tshiâng-khî	Kwai Tsing (distrito)
Thai-pu-khî	Tai Po distrito
Vòng-thai-siên-khî	Wong Tai Sin (distrito)
Tshiên-vân-khî	Tsuen Wan (distrito)
Bracknell Sêm-lìm	Bracknell Forest
Tomaszów Lubelski	Tomaszów Lubelski
Hrubieszów	Hrubieszów
Pet Québec Thi-khî	Nord-du-Québec
Montérégie	Montérégie
Dębica	Dębica
Québec-ngìn Tóng	Partido Quebequense
Grahamstown	Grahamstown
Cape Town Thai-ho̍k	Universidade da Cidade do Cabo
Daniele Suzuki	Daniele Suzuki
Kraśnik	Kraśnik
Dęblin	Dęblin
Radzyń Podlaski	Radzyń Podlaski
Thûn-mùn-khî	Tuen Mun (distrito)
Kiú-liùng-sàng-khî	Kowloon City (distrito)
Prudnik	Prudnik
Villanueva de Sigena	Villanueva de Sigena
Tân-vi	Unidade
Stockton-on-Tees	Stockton-on-Tees
Kô-lò-sî	Colossas
Lò-fù-khî	Distrito de Luohu
Yàm-thièn-khî	Distrito de Yantian
Graaff-Reinet	Graaff-Reinet
Orania	Orânia
Hói-tsû-khî	Haizhu
Swellendam	Swellendam
Nàm-hói-khî	Distrito de Nanhai
Lièn-chiu-sṳ	Lianzhou
Phìn-siông-sṳ	Cidade de Pingxiang
Vi	Estômago
Liùng-hâ	Nephropidae
Pak-van-mí	Megametro
Chaudière-Appalaches	Chaudière-Appalaches
Pet-ngan Thi-khî (Québec)	Côte-Nord
Mí-nàm-kâ-pó-ngìn	Minangkabau
Néu-yok-kóng	Porto de Nova Iorque
Thai-fa Yâu-chhu̍k Chhṳ-chhṳ-yen	Condado Autônomo Yao de Dahua
Tân-yit kón-lî-khî	Autoridade unitária
Tet-pó-yen	Condado de Debao
Hiông-kóng Thit-sṳ-nì Lo̍k-yèn Thu-ká-khî	Hong Kong Disneyland Resort
Mièn-chuk-sṳ	Mianzhu
Kî-chhòng	Aeroporto
Tû-ôn Yâu-chhu̍k Chhṳ-chhṳ-yen	Condado Autônomo Yao de Du'an
Yen	Condados da China
Thièn-yòng-yen	Condado de Tianyang
Chhìn-sî-yen	Condado de Jingxi
Thièn-tûng-yen	Condado de Tiandong
Lìn-yùn-yen	Condado de Lingyun
Lò-sàng Mu-láu-chhu̍k Chhṳ-chhṳ-yen	Condado Autônomo Mulao de Luocheng
Sé-kiok-lî	João 13
Lùng-lìn Kok-chhu̍k Chhṳ-chhṳ-yen	Condado Autônomo Nacionalidades Várias de Longlin
Thièn-lìm-yen	Condado de Tianlin
Phìn-kó-yen	Condado de Pingguo
Kông-chiu-khî	Jiangzhou
Lo̍k-ngia̍p-yen	Condado de Leye
Thí-ngoi Mo̍k-yòng-ha̍p	Oxigenação por membrana extracorpórea
Lìm Tan	Lin Dan
分類:Tet-koet	Categoria:Alemanha
分類:Yi-thai-li	Categoria:Itália
分類:Kâ-nâ-thai	Categoria:Canadá
分類:Sî-pân-ngà	Categoria:Espanha
分類:Chûng-koet	Categoria:China
分類:Ngi̍t-pún	Categoria:Japão
分類:Àu-thai-li-â	Categoria:Austrália
分類:Yin-thu	Categoria:Índia
分類:Yî-set-lie̍t	Categoria:Israel
分類:Nàm-fî	Categoria:África do Sul
分類:Yin-thu-nì-sî-â	Categoria:Indonésia
分類:Pâ-kî-sṳ̂-thán	Categoria:Paquistão
分類:Pô-làn	Categoria:Polónia
分類:Sîn-kâ-po	Categoria:Singapura
分類:Hòn-koet	Categoria:Coreia do Sul
分類:Thai-koet	Categoria:Tailândia
分類:Ye̍t-nàm	Categoria:Vietname
分類:Phú-nen-lui	Categoria:Mamíferos
分類:Tiâu	Categoria:Aves
分類:Chhṳ̍t-vu̍t	Categoria:Plantas
分類:Vu̍t-lí-ho̍k	Categoria:Física
分類:Chhṳ-yèn Khô-ho̍k	Categoria:Ciências naturais
分類:Sâng-vu̍t-ho̍k	Categoria:Biologia
分類:Fa-ho̍k	Categoria:Química
分類:Li̍t-sṳ́	Categoria:História
分類:Thi-lî	Categoria:Geografia
分類:Sa-fi	Categoria:Sociedade
分類:Chûng-kau	Categoria:Religião
分類:Thí-yuk	Categoria:Desportos
分類:Khô-ho̍k	Categoria:Ciência
分類:Lièn-ha̍p-koet	Categoria:Nações Unidas
分類:Êu-chû Lièn-mèn	Categoria:União Europeia
分類:Kien-chuk-vu̍t	Categoria:Construções
分類:Thûng-sin	Categoria:Comunicação
分類:Thi-khiù	Categoria:Terra
Zuera	Zuera
Langa del Castillo	Langa del Castillo
Contamina	Contamina
Abiego	Abiego
Abanto	Abanto
Kú Lò-mâ	Roma Antiga
La Fueva	La Fueva
Tsui-heu ke Sṳ́m-phan	Juízo Final
Sat-mû-ngí-ki-song	I Samuel
分類:Chet-ho̍k	Categoria:Filosofia
分類:Fu̍t-kau	Categoria:Budismo
分類:Kî-tuk-kau	Categoria:Cristianismo
分類:Yù-thai-kau	Categoria:Judaísmo
Ventersdorp	Venterdorp
Ên-tiâu	Águia
Ngùi Pó-lò	Paul Wei
Hò-sṳ̂n	Mililitro
Bochotnica	Bochotnica
Brandfort	Brandfort
琴浦同學	Kotoura-san
分類:Hàng-sên	Categoria:Planetas
分類:Vùn-fa	Categoria:Cultura
分類:Ngìn-vùn Khô-ho̍k	Categoria:Ciências humanas
分類:Tî-sṳt	Categoria:Conhecimento
Gurrea de Gállego	Religião em Cuba
Sàng-sṳ Fûng-sû Kau-fi	City Harvest Church
Chṳ́-set	Púrpura
Phiàng-fa-sṳ	Fushaw romanizado
Hiông (Thòi-vân)	Distritos da Indonésia
Ap-è	Pato
分類:Yên-yèn	Categoria:Atores
模板:Tl	Predefinição:Ligação para predefinição
模板:Userbox	Predefinição:Userbox
模板:Wikipedialang	Predefinição:Wikipédia em outras línguas
分類:Koet-kâ	Categoria:Países
Wikipedia:Kón-lî-yèn	Wikipédia:Administradores
分類:Chûng-fà Mìn-chhu̍k	Categoria:Grupos étnicos da China
分類:Ngìn-vu̍t	Categoria:Pessoas
分類:Mìn-chhu̍k	Categoria:Grupos étnicos
Wikipedia:Hàng-tsṳn-yèn	Wikipédia:Burocratas
Wikipedia:IP chhà-fûng li-ngoi-chá	Wikipédia:Isento de bloqueio de IP
Wikipedia:Kî-hi-ngìn	Wikipédia:Robôs
分類:Sṳ̀-kiên	Categoria:Tempo
分類:Chhṳ-yèn	Categoria:Natureza
分類:Kûng-chhàng	Categoria:Engenharia
分類:Yî-ho̍k	Categoria:Medicina
分類:Chṳn-chṳ	Categoria:Política
分類:Kau-yuk	Categoria:Educação
分類:Kông-ho̍k	Categoria:Óptica
Âi-khi̍p	Egito
分類:Chat-ho̍k-kâ	Categoria:Filósofos
模板:Bot	Predefinição:Robô
Kâ-nâ-thai	Canadá
分類:Hiûng-ngà-li	Categoria:Hungria
分類:Hî-lia̍p	Categoria:Grécia
分類:Lâ-thot-vì-â	Categoria:Letónia
分類:Yù-hi	Categoria:Jogos
Thiên-koet	Céu (religião)
分類:Êu-chû koet-kâ	Categoria:Países da Europa
分類:Êu-chû	Categoria:Europa
模板:Documentation	Predefinição:Documentação
Wikipedia:Yung-fu	Wikipédia:Usuários
Pok-sṳ	Doutor
Wikipedia:Sa-khî	Wikipédia:Portal comunitário
分類:Wikipedians by language	Categoria:!Wikipedistas por idioma
Sṳ̀n Chhai-kî	Sung Jae-ki
Kî-kèu	Agência (sociologia)
Khi-néu Kî-chhòng	Hub (aviação comercial)
Khî-ngia̍p	Negócio
Ngiuk-yèn	Almôndega
模板:Softredirect	Predefinição:Pseudorredirecionamento
模板:Delete	Predefinição:ER
分類:Kî-su̍t	Categoria:Tecnologia
分類:Ngî-ngièn	Categoria:Línguas
Wikipedia:Chhóng-kien Sîn Thiàu-muk	Ajuda:Guia de edição/Como começar uma página
分類:還無索引嘅頁面	Categoria:!Páginas não indexadas
分類:含有損壞文件鏈接嘅頁面	Categoria:!Páginas com ficheiros inexistentes
模板:Navbox	Predefinição:Navbox
Thoi-chhú	Canguru
Pak-ha̍p-fâ	Lírio
模板:!-	Predefinição:!-
模板:Tnavbar	Predefinição:Tnavbar
模板:Unicode	Predefinição:Unicode
模板:Smallcaps	Predefinição:Smallcaps
模板:Small	Predefinição:Pequeno
模板:Nowrap	Predefinição:Nowrap
分類:Fî-chû	Categoria:África
分類:Chhṳ-yù Pâng-sén	Categoria:Província do Estado Livre
分類:Tûng Khôi-phú-sén	Categoria:Província do Cabo Oriental
分類:Gauteng-sén	Categoria:Província de Gauteng
分類:KwaZulu-Natal-sén	Categoria:Província de KwaZulu-Natal
分類:Mpumalanga-sén	Categoria:Província de Mpumalanga
分類:Pet Khôi-phú-sén	Categoria:Província do Cabo Setentrional
分類:Sṳn-kîn	Categoria:Bíblia
分類:Limpopo-sén	Categoria:Província do Limpopo
分類:Sî Khôi-phú-sén	Categoria:Província do Cabo Ocidental
分類:Sî-pet-sén	Categoria:Província do Noroeste
分類:Si	Categoria:Livros
模板:Pâ-phe̍t	Predefinição:Babel
模板:Reflist	Predefinição:Referências
模板:Stub	Predefinição:Esboço
模板:User ca-1	Predefinição:User ca-1
模板:User de	Predefinição:User de
模板:User de-1	Predefinição:User de-1
模板:User en-3	Predefinição:User en-3
模板:User en-1	Predefinição:User en-1
模板:User en-2	Predefinição:User en-2
模板:User en-4	Predefinição:User en-4
模板:User en-0	Predefinição:User en-0
模板:User en	Predefinição:User en
模板:User de-2	Predefinição:User de-2
分類:Yî-chhiu	Categoria:Universo
模板:User fr-2	Predefinição:User fr-2
模板:User ja-1	Predefinição:User ja-1
模板:User fr	Predefinição:User fr
模板:Location map/Info	Predefinição:Mapa de localização/info
分類:Khûn-chhùng	Categoria:Insectos
分類:Â-chû	Categoria:Ásia
分類:Chṳ-li	Categoria:Chile
分類:Sok-lî-â-sén	Categoria:Província de Sória
分類:Nàm-mî-chû	Categoria:América do Sul
分類:Khà-sṳ̂-tì-li-â lâu Lòi-ngong	Categoria:Castela e Leão
模板:Esoteric	Predefinição:Predefinição complexa
分類:Mâ-lòi-sî-â	Categoria:Malásia
分類:Sṳ̍t-phín	Categoria:Alimentos
模板:Mod	Predefinição:Mod
模板:SIL	Predefinição:ISO639-3Documentação
模板:User es-2	Predefinição:User es-2
模板:Fôn-ngiàng	Predefinição:Bem-vindo(a)
分類:Thiàu-mi-liau	Categoria:Condimentos
分類:Chû-chṳt	Categoria:Organizações
分類:Ngî-ngièn-ho̍k	Categoria:Linguística
模板:ITA	Predefinição:ITA
模板:非洲行政區劃	Predefinição:Países da África
模板:SVK	Predefinição:SVK
模板:Infobox Country	Predefinição:Info/País
模板:Documentation/docname	Predefinição:Documentação/nomedoc
模板:TUR	Predefinição:TUR
分類:User en-4	Categoria:Utilizador en-4
分類:User en	Categoria:Usuários en
分類:User zh	Categoria:Usuários zh
分類:User zh-N	Categoria:Usuário zh
分類:User en-2	Categoria:Usuário en-2
模板:User zh	Predefinição:User zh
模板:Cite web	Predefinição:Citar web
模板:Ombox	Predefinição:Ombox
分類:Hòng-khûng	Categoria:Aviação
模板:Country data	Predefinição:Dados de país
分類:Yím-sṳ̍t	Categoria:Alimentação
模板:Fong-wui	Predefinição:Pontos Cardeais
模板:BS3	Predefinição:BS3
分類:Tsúng-thúng	Categoria:Presidentes
模板:IPA	Predefinição:AFI
分類:Chṳn-chṳ Ngìn-lui	Categoria:Políticos
分類:Mî-chû	Categoria:América
模板:其他	Predefinição:Ver desambig
分類:Language user templates	Categoria:!Predefinições de babel
模板:Imbox	Predefinição:Imbox
Wikipedia:GNU自由文檔協議證書	Wikipédia:GNU Free Documentation License
模板:Topicon	Predefinição:Top icon
模板:Fmbox	Predefinição:Fmbox
模板:大洋洲行政區劃	Predefinição:Países e territórios da Oceania
分類:Vùn-ho̍k-kâ	Categoria:Escritores
分類:Kiûn-sṳ	Categoria:Tópicos militares
分類:Thai-ho̍k	Categoria:Universidades
模板:Country data Malaysia	Predefinição:Country data Malásia
模板:Lang-he	Predefinição:Lang-he
分類:Sṳ-kie Pok-lám-fi	Categoria:Exposições mundiais
模板:Documentation subpage	Predefinição:Subpágina de documentação
分類:Fu̍k-tsông	Categoria:Monges budistas
模板:FIN	Predefinição:FIN
模板:Purge	Predefinição:Purgar
模板:Lang-de	Predefinição:Lang-de
模板:DNK	Predefinição:DNK
模板:Provinces of China	Predefinição:Subdivisões da República Popular da China
模板:Userpage	Predefinição:Página de usuário
模板:DEU	Predefinição:DEU
模板:SWE	Predefinição:SWE
分類:Ye̍t-nàm kî-chhòng	Categoria:Aeroportos do Vietname
Kiet-tshòng	Cólon
分類:Kûng-sṳ̂	Categoria:Empresas
Â-mí	Atómetro
模板:User fr-3	Predefinição:User fr-3
模板:Allcaps	Predefinição:Allcaps
模板:JPN	Predefinição:JPN
分類:Thien-nó	Categoria:Computadores
模板:MKD	Predefinição:MKD
模板:LTU	Predefinição:LTU
100000000	Cem milhões
分類:Sṳ-chhòng	Categoria:Mercado
Mô-li-ngìn	Maoris
模板:Disambig	Predefinição:Desambiguação
模板:Tick	Predefinição:Sim
分類:Khien-không Khô-ho̍k	Categoria:Ciências da saúde
分類:Hàng-thung Thien-fa	Categoria:Telefones celulares
模板:GRC	Predefinição:GRC
模板:Lang-grc	Predefinição:Lang-grc
模板:CZE	Predefinição:CZE
模板:Lifetime	Predefinição:NF
模板:Lang-en	Predefinição:Lang-en
分類:Chhòn-ngiam-phiang	Categoria:Doenças infecciosas
分類:Sîn-kau	Categoria:Protestantismo
模板:GBR	Predefinição:GBR
分類:Sâng-vu̍t	Categoria:Organismos
模板:SVN	Predefinição:SVN
模板:FRA	Predefinição:FRA
模板:Hiông-kóng Hàng-tsṳn Khî-va̍k	Predefinição:Hong Kong
模板:User pt-2	Predefinição:User pt-2
分類:Kâ-li-sî-â	Categoria:Galiza
模板:歐洲行政區劃	Predefinição:Países da Europa
分類:User fr	Categoria:Usuários fr
分類:User ja	Categoria:Usuários ja
分類:User pt	Categoria:Usuários pt
分類:User nl-3	Categoria:Usuário nl-3
分類:User fr-2	Categoria:Usuário fr-2
分類:User ja-2	Categoria:Usuário ja-2
分類:User ko-N	Categoria:Usuário ko
分類:User fr-N	Categoria:Usuário fr
分類:Vùn-sṳ	Categoria:Sistemas de escrita
分類:Tho-kau	Categoria:Taoismo
分類:User ca	Categoria:Usuários ca
分類:User ca-1	Categoria:Usuário ca-1
分類:User de	Categoria:Usuários de
分類:User de-2	Categoria:Usuário de-2
分類:User de-N	Categoria:Usuário de
分類:User en-3	Categoria:Usuário en-3
分類:User en-N	Categoria:Usuário en
分類:User es	Categoria:Usuários es
分類:User es-2	Categoria:Usuário es-2
分類:User es-N	Categoria:Usuário es
分類:Hiông-kóng Thi-lî	Categoria:Geografia de Hong Kong
模板:Lang-lv	Predefinição:Lang-lv
分類:Yî-set-lie̍t kiûn-vòng	Categoria:Reis de Israel
分類:Yù-thai kiûn-vòng	Categoria:Reis de Judá
分類:Kí-hò-ho̍k	Categoria:Geometria
分類:User ja-1	Categoria:Usuário ja-1
分類:User ko	Categoria:Usuários ko
Hà-mà	Sapo
模板:Lang-vi	Predefinição:Lang-vi
分類:Thiên-hi	Categoria:Fenômenos atmosféricos
分類:Lièn-ha̍p-koet Pi-sû-chóng	Categoria:Secretários-gerais da Organização das Nações Unidas
分類:Hói-yòng	Categoria:Mares
分類:Ido-ngî	Categoria:Ido
模板:LUX	Predefinição:LUX
分類:Thai-yòng-ne	Categoria:Sistema solar
分類:Kóng-tûng-sén	Categoria:Guangdong
分類:Fuk-kian	Categoria:Fujian
分類:Kîn-chi	Categoria:Economias
分類:Koet-chi Chû-chṳt	Categoria:Organizações internacionais
分類:Fat-mìn-kâ	Categoria:Inventores
分類:Yím-liau	Categoria:Bebidas
分類:Sa-fi Khô-ho̍k	Categoria:Ciências sociais
分類:Mî-koet Koet-kâ Kûng-yèn	Categoria:Parques nacionais dos Estados Unidos
分類:Kô-tén Kau-yuk	Categoria:Ensino superior
模板:!w	Predefinição:!wrap
分類:Thi-hìn	Categoria:Acidentes geográficos
分類:Pâ-lùn-sî-â Chhṳ-chhṳ-khî	Categoria:Comunidade Valenciana
模板:User ja-2	Predefinição:User ja-2
分類:Thiên-chú-kau	Categoria:Catolicismo
分類:Yîm-ngo̍k-kâ	Categoria:Músicos
模板:!((	Predefinição:!((
模板:))!	Predefinição:))!
模板:Lang	Predefinição:Lang
分類:Fa-kâ	Categoria:Pintores
分類:Yin-thu chûng-kau	Categoria:Religião na Índia
分類:Ho̍k-su̍t	Categoria:Academia
分類:Sa-fi chṳ-thu	Categoria:Instituições sociais
模板:.w	Predefinição:•wrap
分類:Ngìn-lui	Categoria:Humanos
模板:CYP	Predefinição:CYP
分類:Yin-thu Thi-lî	Categoria:Geografia da Índia
分類:Sông-ngia̍p	Categoria:Comércio
分類:Fap-koet fòng-ti	Categoria:Imperadores da França
模板:EST	Predefinição:EST
模板:Nocaps	Predefinição:Nocaps
模板:AUT	Predefinição:AUT
分類:Meu-khô	Categoria:Felídeos
分類:Thòi-vân Thi-lî	Categoria:Geografia da República da China
模板:User zh-3	Predefinição:User zh-3
分類:Nì-pok Thi-lî	Categoria:Geografia do Nepal
分類:Thai-khûng-ngìn	Categoria:Astronautas
分類:Chûng-fà Mìn-tshu̍k Tshṳ-tshṳ-chû	Categoria:Prefeituras autônomas da República Popular da China
分類:Khî-ngia̍p-kâ	Categoria:Empresários
分類:Fî-li̍t-pîn	Categoria:Filipinas
分類:User nl	Categoria:Usuários nl
分類:User zh-1	Categoria:Usuário zh-1
分類:User zh-3	Categoria:Usuário zh-3
分類:User zh-2	Categoria:Usuário zh-2
分類:Yin-thu kiûn-chú	Categoria:Monarcas da Índia
分類:Ho̍k-vi	Categoria:Graus académicos
分類:Pô-sṳ̂ koet-vòng	Categoria:Reis da Pérsia
分類:Kîm-yùng	Categoria:Finanças
分類:Chûng-fà mìn-koet tsúng-thúng	Categoria:Presidentes da República da China
分類:Thien-sṳ	Categoria:Televisão
分類:Chhòn-kau-sṳ	Categoria:Missionários
分類:Hói-hia̍p	Categoria:Estreitos
分類:Yin-Êu Ngî-ne	Categoria:Línguas indo-europeias
分類:Kî-chhòng	Categoria:Aeroportos
分類:Fa-ho̍k ngièn-su	Categoria:Elementos químicos
分類:Khô-ho̍k-kâ	Categoria:Cientistas
分類:Pâ-kî-sṳ̂-thán Thi-lî	Categoria:Geografia do Paquistão
分類:Kî-tuk-kau lî-ngì	Categoria:Liturgia
分類:Nì-pok	Categoria:Nepal
分類:Thòi-vân	Categoria:Taiwan
分類:Chûng-koet chhèu-thoi	Categoria:Dinastias chinesas
分類:Nàm-Â koet-kâ	Categoria:Países da Ásia Meridional
分類:Pet-mî-chû koet-kâ	Categoria:Países da América do Norte
分類:Sṳ-tshòi	Categoria:Hortaliças
分類:Súi-kó	Categoria:Frutos
分類:Khiu-yok Sṳn-kîn	Categoria:Antigo Testamento
分類:Pok-vu̍t-kón	Categoria:Museus
分類:Hì-hèu	Categoria:Clima
分類:Â-chû Thi-lî	Categoria:Geografia da Ásia
分類:Ngìn-lui-ho̍k	Categoria:Antropologia
分類:Thai-khûng Chhàm	Categoria:Estações espaciais
分類:Fap-koet Thai-ho̍k	Categoria:Universidades da França
模板:ESP	Predefinição:ESP
分類:Thung-vu̍t	Categoria:Animais
分類:Chit-chhûi Thung-vu̍t	Categoria:Vertebrados
分類:Ngî-yîm-ho̍k	Categoria:Fonética
分類:Hòng-khûng Kûng-sṳ̂	Categoria:Empresas aéreas
分類:Ngìn-khièn	Categoria:Direitos humanos
分類:Ngo̍k-hi	Categoria:Instrumentos musicais
分類:Ngî-ne	Categoria:Línguas por família
分類:Pó-sa̍k	Categoria:Gemas
分類:Koet-kâ Kûng-yèn	Categoria:Parques nacionais
分類:Hi-siong-ho̍k	Categoria:Meteorologia
分類:Chûng-mî-chû	Categoria:América Central
分類:Fî-kîm-su̍k	Categoria:Não metais
分類:Hiông-kóng	Categoria:Hong Kong
分類:Kóng-sî-sén	Categoria:Guangxi
分類:Yên-liau	Categoria:Combustíveis
分類:Sông-hói	Categoria:Xangai
分類:Sin-sit kî-su̍t	Categoria:Tecnologia da informação
分類:Ngiuk-lui	Categoria:Carnes
分類:Yo̍k-ho̍k	Categoria:Farmácia
分類:Sú-tû	Categoria:Capitais
分類:Kham-thap-pu-lî-â	Categoria:Cantábria
分類:Â-sṳ̂-thù-lî-â-sṳ̂-sén	Categoria:Astúrias
分類:Kîm-su̍k	Categoria:Metais
分類:Thòi-pet-sṳ	Categoria:Taipei
分類:Lò-màn Ngî-chhu̍k	Categoria:Línguas românicas
分類:Kâu-thûng	Categoria:Transporte
分類:Ngiên-kiu	Categoria:Pesquisa
分類:Thông-lui	Categoria:Carboidratos
分類:Fòng-ti	Categoria:Imperadores
分類:Nàm-tó ngî-hì	Categoria:Línguas austronésias
分類:Pet-mî-chû	Categoria:América do Norte
分類:Kô-sú	Categoria:Cantores
分類:Si-chhòng	Categoria:Tibete
分類:Sú-ho̍k-kâ	Categoria:Matemáticos
分類:Vu̍t-lî ho̍k-kâ	Categoria:Físicos
分類:Kîn-chi ho̍k-kâ	Categoria:Economistas
分類:Mìn-tsú	Categoria:Democracia
分類:Kî-tuk-kau Li̍t-sṳ́	Categoria:História do Cristianismo
分類:Àu-mûn	Categoria:Macau
分類:Hàng-sên-ne	Categoria:Sistemas planetários
分類:Hiông-kóng pan-tó	Categoria:Ilhas de Hong Kong
分類:Thòi-vân ngî-ngièn	Categoria:Línguas de Taiwan
分類:Ngiùn-hòng	Categoria:Bancos
Fu̍k-vu	Serviço (economia)
分類:Chûng-fà Ngìn-mìn Khiung-fò-koet	Categoria:República Popular da China
分類:Kâ-thai-lò-nì-â	Categoria:Catalunha
Kap-kut-vùn	Escrita oráculo em ossos
分類:Khien-không	Categoria:Saúde
模板:Lang-pl	Predefinição:Lang-pl
Trojany	Trojany
分類:Pâ-pí-lùn-ngìn	Categoria:Babilônios
分類:Â-chû koet-kâ	Categoria:Países da Ásia
分類:Mî-chû koet-kâ	Categoria:Países da América
模板:MLT	Predefinição:MLT
分類:Hak-kâ	Categoria:Hacá
分類:Kûng-yèn	Categoria:Parques
分類:Thòi-vân ngièn-tshu-mìn ngî-ngièn	Categoria:Línguas formosanas
分類:Si-chhòng Thi-lî	Categoria:Geografia do Tibete
模板:Lts	Predefinição:Lts
分類:Nui-mùng-kú Tshṳ-tshṳ-khî	Categoria:Mongólia Interior
分類:Koet-tsi kîn-tsi tsû-tsṳt	Categoria:Organizações econômicas internacionais
分類:Lâ-tên Mî-chû	Categoria:América Latina
分類:Hiông-kóng Sân-Fûng	Categoria:Montanhas, picos e colinas de Hong Kong
分類:Chûng-fà Mìn-koet	Categoria:República da China
分類:Siak-khiet-kau	Categoria:Siquismo
分類:Sa-fi Mìn-tsú Tsú-ngi	Categoria:Social-democracia
模板:BEL	Predefinição:BEL
分類:Kú-thoi chhu̍k-khiùn	Categoria:Povos da Antiguidade
分類:Pâ-lùn-sî-â-sén	Categoria:Valência (província)
分類:Chûng-kau-ho̍k	Categoria:Estudo da religião
分類:Thien-fa	Categoria:Telefonia
模板:TPE	Predefinição:TPE
分類:Ngân-set	Categoria:Cor
分類:Â-là-kung	Categoria:Aragão
分類:Tseu-mìn	Categoria:Iluminação
模板:Chûng-fà Mìn-koet Hàng-chṳn Khî-va̍k	Predefinição:Divisões administrativas da República da China
分類:Lie̍t-yî-tha̍t-sén	Categoria:Província de Lérida
甲型流感病毒H7N9亞型	Influenza A subtipo H7N9
模板:HUN	Predefinição:HUN
模板:Yin-thu-nì-sî-â	Predefinição:Províncias da Indonésia
Vòng-phûng	Vespa
分類:Thòi-nàm-yen	Categoria:Condado de Tainan
分類:User en-1	Categoria:Usuário en-1
分類:User de-1	Categoria:Usuário de-1
Li̍t-thoi-chṳ-song	I Crônicas
模板:Thòi-pet-sṳ	Predefinição:Distritos de Taipei
Liû-khiû Khiùn-tó	Ryūkyū
模板:User ru-3	Predefinição:User ru-3
模板:User nl-3	Predefinição:User nl-3
模板:Thòi-nàm-yen	Predefinição:Taiwan Tainan divisões
Yòng-ya̍p-é	Borboleta
Chûng-koet Chhèu-thoi	Dinastias chinesas
模板:Style/IPA	Predefinição:Style/IPA
模板:Style/yid	Predefinição:Style/yid
模板:Ping	Predefinição:Responder a
IPhone 5S	IPhone 5s
IPhone 5C	IPhone 5c
Sûng-kú Lô-siên	Dupla hélice
Yun Hyon-seok	Yun Hyon-seok
特殊:最近更改	Especial:Mudanças recentes
模組:HtmlBuilder	Módulo:HtmlBuilder
模組:Navbar	Módulo:Navbar
模組:Navbox	Módulo:Navbox
馬來西亞航空17號班機空難	Voo Malaysia Airlines 17
Ngit-tèu Fuk-sa	Radiação solar
