Abĩrika	África
Japan	Japão
Amerika ya Kuthini	América do Sul
Ngeretha	Inglaterra
Macartsa	Hungria
United States	Estados Unidos
Binirandi	Finlândia
Cuindeni	Suécia
Ndenimaki	Dinamarca
Rithuĩnia	Lituânia
Itari	Itália
Ngiriki	Grécia
Takĩ	Turquia
Wikipedia	Wikipédia
Netharandi	Países Baixos
Los Angeles	Los Angeles
Kenya	Quénia
Ethiopia	Etiópia
Ghana	Gana
Baranja	França
Esperanto	Esperanto
China	República Popular da China
Wiktionary	Wikcionário
Brazil	Brasil
Racia	Rússia
Wikimedia	Wikimedia
Jimmy Wales	Jimmy Wales
Njĩrĩmani	Alemanha
Azerbaijan	Azerbaijão
Canimarino	San Marino
Intel	Intel Corporation
Indonesia	Indonésia
Abĩrika ya Kuthini	África do Sul
Algeria	Argélia
Mai	Água
Terebiceni	Televisão
Singapore	Singapura
Wikibooks	Wikilivros
Bahrain	Bahrein
Armenia	Arménia
İstanbul	Istambul
Australia	Austrália
Physics	Física
Argentina	Argentina
Peru	Peru
Bayorojĩ	Biologia
Mount Everest	Monte Everest
Napoleon	Napoleão Bonaparte
Hydrogen	Hidrogénio
Helium	Hélio
Lithium	Lítio
Beryllium	Berílio
Carbon	Carbono
Nitrogen	Azoto
Oxygen	Oxigénio
Chad	Chade
Sodium	Sódio
Magnesium	Magnésio
Aluminium	Alumínio
Silicon	Silício
Phosphorous	Fósforo
Iron	Ferro
Potasium	Potássio
Calcium	Cálcio
Titanium	Titânio
Ecuador	Equador
Copper	Cobre
Mĩmera	Plantae
Zinc	Zinco
Fungi	Fungi
Jamaica	Jamaica
Haiti	Haiti
Iraq	Iraque
Panama	Panamá
Yemen	Iémen
Virus	Vírus
Laos	Laos
Malaysia	Malásia
Burma	Myanmar
Pakistan	Paquistão
Sri Lanka	Sri Lanka
Syria	Síria
Thailand	Tailândia
United Arab Emirates	Emirados Árabes Unidos
Platinum	Platina
Vietnam	Vietname
South Korea	Coreia do Sul
Afghanistan	Afeganistão
Gold	Ouro
Bangladesh	Bangladesh
Angola	Angola
Bhutan	Butão
Brunei	Brunei
Tanzania	Tanzânia
Isaac Newton	Isaac Newton
Zimbabwe	Zimbabwe
Sũdana ya Kuthini	Sudão do Sul
Benin	Benim
Botswana	Botswana
Burkina Faso	Burkina Faso
Burundi	Burundi
Republic of the Congo	República do Congo
Democratic Republic of the Congo	República Democrática do Congo
Djibouti	Djibouti
Gabon	Gabão
Gambia	Gâmbia
Côte d'Ivoire	Costa do Marfim
Cameroon	Camarões
Lesotho	Lesoto
Madagascar	Madagáscar
Malawi	Malawi
Namibia	Namíbia
Nigeria	Nigéria
Uganda	Uganda
Rwanda	Ruanda
Somalia	Somália
Julius Caesar	Júlio César
Sũdana	Sudão
Usain Bolt	Usain Bolt
Piemonte	Piemonte
Valle d'Aosta	Vale de Aosta
Emilia-Romagna	Emília-Romanha
Chicago	Chicago
Uetersen	Uetersen
Augustus	Augusto
Campania	Campânia
Puglia	Apúlia
Biblia	Bíblia
Kanitha wa Jesũ wa ma	Verdadeira Igreja de Jesus
Dong Hoi	Dong Hoi
Concepción	Concepción (Chile)
Microsoft	Microsoft
Kemu	Química
Ankara	Ancara
Nairobi	Nairóbi
Osasco	Osasco
Curitiba	Curitiba
Monzón	Monzón
Almazán	Almazán
Bill Gates	Bill Gates
Main Page	Wikipédia:Página principal
Cipiyu	Unidade central de processamento
Penza	Penza
Frank Lloyd Wright	Frank Lloyd Wright
Category:Candidates for speedy deletion	Categoria:!Páginas para eliminação rápida
Niels Bohr	Niels Bohr
Bengi ya Thĩ	Banco Mundial
Ndemookirathĩ	Democracia
Kĩheo ya Nobero	Prémio Nobel
Mount Kilimajaro	Kilimanjaro
Mammal	Mamíferos
WHO	Organização Mundial da Saúde
Thayathi cia ndũire	Ciências naturais
Tsunami	Tsunami
Logic	Lógica
Algorithm	Algoritmo
Thomas Edison	Thomas Edison
Michael Faraday	Michael Faraday
Henry Ford	Henry Ford
Cancún	Cancún
Atomu	Átomo
Erwin Schrodinger	Erwin Schrödinger
Ronald Reagan	Ronald Reagan
Metha Njokereri	Tabela periódica
Bacteria	Bactéria
Robot	Robô
Macini	Máquina
Injiniarini	Engenharia
Gatheti	Jornal
Microsoft obici	Microsoft Office
Bobbio	Bobbio
AIDS	Síndrome da imunodeficiência adquirida
Thiori ya Seti	Teoria dos conjuntos
Abacus	Ábaco
Piacenza	Placência
Taranto	Tarento
ISO	Organização Internacional para Padronização
Province ya Piacenza	Placência (província)
Province ya Taranto	Taranto (província)
Template:Link FA	Predefinição:Link FA
Wikipedia:Community Portal	Wikipédia:Esplanada
GPS	Sistema de posicionamento global
Friedrich Schiller	Friedrich Schiller
Moshchena	Mostchena
Paltoga	Paltoga
Kihuruta	Lepidoptera
Paradigm	Paradigma
Gĩgĩkũyũ	Língua kikuyu
Linus Torvalds	Linus Torvalds
Thayathi cia social	Ciências sociais
İzmir	Esmirna
Siligo	Siligo
Markup languages	Linguagem de marcação
IBM	IBM
John Michael Talbot	John Michael Talbot
Mawatho matano ma Newton	Leis de Newton
Radio Studio 54 Network	Rádio Studio 54 Network
Neural networks	Redes neurais biológicas
Montehermoso	Montehermoso
Ford	Ford Motor Company
Template:Commonscat	Predefinição:Commonscat
Toyota	Toyota Motor
Cartesian Coordinates	Sistema de coordenadas cartesiano
Agazzano	Agazzano
Alseno	Alseno
Besenzone	Besenzone
Bettola	Bettola
Borgonovo Val Tidone	Borgonovo Val Tidone
Cadeo	Cadeo
Calendasco	Calendasco
Caminata	Caminata
Caorso	Caorso
Carpaneto Piacentino	Carpaneto Piacentino
Castel San Giovanni	Castel San Giovanni
Castell'Arquato	Castell'Arquato
Castelvetro Piacentino	Castelvetro Piacentino
Cerignale	Cerignale
Coli	Coli
Corte Brugnatella	Corte Brugnatella
Cortemaggiore	Cortemaggiore
Farini	Farini
Ferriere	Ferriere
Fiorenzuola d'Arda	Fiorenzuola d'Arda
Gazzola	Gazzola
Gossolengo	Gossolengo
Gragnano Trebbiense	Gragnano Trebbiense
Gropparello	Gropparello
Lugagnano Val d'Arda	Lugagnano Val d'Arda
Monticelli d'Ongina	Monticelli d'Ongina
Morfasso	Morfasso
Nibbiano	Nibbiano
Ottone	Ottone
Pecorara	Pecorara
Pianello Val Tidone	Pianello Val Tidone
Piozzano	Piozzano
Podenzano	Podenzano
Ponte dell'Olio	Ponte dell'Olio
Pontenure	Pontenure
Rivergaro	Rivergaro
Rottofreno	Rottofreno
San Giorgio Piacentino	San Giorgio Piacentino
San Pietro in Cerro	San Pietro in Cerro
Sarmato	Sarmato
Travo	Travo
Vernasca	Vernasca
Vigolzone	Vigolzone
Villanova sull'Arda	Villanova sull'Arda
Zerba	Zerba
Ziano Piacentino	Ziano Piacentino
RFID	Identificação por radiofrequência
Cybernetics	Cibernética
Bioinformatics	Bioinformática
Euclidean Geometry	Geometria euclidiana
Macini ya Turing	Máquina de Turing
Silicon Valley	Vale do Silício
Maywood	Maywood (Illinois)
Kĩrĩnyaga	Monte Quénia
Boolean Logic	Álgebra booliana
Jomo Kenyatta	Jomo Kenyatta
Thomas Kuhn	Thomas Kuhn
Fujitsu	Fujitsu
Ũramati ũũgĩ	Gestão do conhecimento
Tectonics	Tectónica
Microscope	Microscópio
Tigranes II	Tigranes, o Grande
Cyberspace	Ciberespaço
Palestine	Estado da Palestina
Anggun	Anggun
Fuzzy Logic	Lógica difusa
Ũtuĩria na ũthondeki	Pesquisa e desenvolvimento
Ngũgĩ wa Thiong'o	Ngũgĩ wa Thiong'o
Gatagati mkoa, Kenya	Província Central (Quênia)
Bengi ya Gũkũria Abĩrika	Banco Africano de Desenvolvimento
Hithitorĩ ya Kemu	História da química
Dévanos	Dévanos
Caribbean	Caribe
Alentisque	Alentisque
Adradas	Adradas
Arenillas	Arenillas
Barcones	Barcones
Pozalmuro	Pozalmuro
Duruelo de la Sierra	Duruelo de la Sierra
Pinilla del Campo	Pinilla del Campo
Ucero	Ucero
Portillo de Soria	Portillo de Soria
Herrera de Soria	Herrera de Soria
Deza	Deza
Barca	Barca (Espanha)
Hinojosa del Campo	Hinojosa del Campo
Bayo-egekia	Biomimética
Category:German	Categoria:Alemanha
Category:Italy	Categoria:Itália
Category:USA	Categoria:Estados Unidos
Category:Urusi	Categoria:Rússia
Category:Spain	Categoria:Espanha
Category:Turkey	Categoria:Turquia
Category:South Korea	Categoria:Coreia do Sul
Category:Thayathi cia ndũire	Categoria:Ciências naturais
Category:Kemu	Categoria:Química
Category:Sport	Categoria:Desportos
Category:Thayathi	Categoria:Ciência
Wikipedia:Administrators	Wikipédia:Administradores
Category:Medicine	Categoria:Medicina
Category:Politics	Categoria:Política
Egypt	Egito
Template:Bot	Predefinição:Robô
Canada	Canadá
Category:Rũraya	Categoria:Europa
Template:Documentation	Predefinição:Documentação
Sung Jae-ki	Sung Jae-ki
Template:Softredirect	Predefinição:Pseudorredirecionamento
Template:Delete	Predefinição:ER
Wikipedia:Statistics	Wikipédia:Estatísticas
Template:Navbox	Predefinição:Navbox
Category:Abĩrika	Categoria:África
Template:Babel	Predefinição:Babel
Template:Commons	Predefinição:Commons
Template:User af-1	Predefinição:User af-1
Template:User ar-1	Predefinição:User ar-1
Template:User az	Predefinição:User az
Template:User bar-1	Predefinição:User bar-1
Template:User eo-1	Predefinição:User eo-1
Template:User da-2	Predefinição:User da-2
Template:User be-2	Predefinição:User be-2
Template:User da-1	Predefinição:User da-1
Template:User cs-1	Predefinição:User cs-1
Template:User bg-1	Predefinição:User bg-1
Template:User eo-3	Predefinição:User eo-3
Template:User de	Predefinição:User de
Template:User de-1	Predefinição:User de-1
Template:User eu	Predefinição:User eu
Template:User et-1	Predefinição:User et-1
Template:User el	Predefinição:User el
Template:User es	Predefinição:User es
Template:User de-3	Predefinição:User de-3
Template:User en-3	Predefinição:User en-3
Template:User el-1	Predefinição:User el-1
Template:User en-1	Predefinição:User en-1
Template:User en-2	Predefinição:User en-2
Template:User eo-2	Predefinição:User eo-2
Template:User en-4	Predefinição:User en-4
Template:User fi	Predefinição:User fi
Template:User en-0	Predefinição:User en-0
Template:User en	Predefinição:User en
Template:User de-2	Predefinição:User de-2
Template:User es-1	Predefinição:User es-1
Template:User fa	Predefinição:User fa
Template:User fi-1	Predefinição:User fi-1
Template:User fr-1	Predefinição:User fr-1
Template:User ia-2	Predefinição:User ia-2
Template:User hi-1	Predefinição:User hi-1
Template:User hr	Predefinição:User hr
Template:User he-1	Predefinição:User he-1
Template:User hu	Predefinição:User hu
Template:User id-3	Predefinição:User id-3
Template:User io-3	Predefinição:User io-3
Template:User it-3	Predefinição:User it-3
Template:User sk	Predefinição:User sk
Template:User tr-2	Predefinição:User tr-2
Template:User fr-2	Predefinição:User fr-2
Template:User ja	Predefinição:User ja
Template:User ja-1	Predefinição:User ja-1
Template:User it-1	Predefinição:User it-1
Template:User hr-1	Predefinição:User hr-1
Template:User fr	Predefinição:User fr
Template:User gsw-1	Predefinição:User gsw-1
Category:Amerika ya Kuthini	Categoria:América do Sul
Category:Football	Categoria:Futebol
Template:Mod	Predefinição:Mod
Template:User uk	Predefinição:User uk
Template:User es-2	Predefinição:User es-2
Template:Welcome	Predefinição:Bem-vindo(a)
Template:Bururi wa Abĩrika	Predefinição:Países da África
Template:Documentation/docname	Predefinição:Documentação/nomedoc
Template:User zh	Predefinição:User zh
Template:Legend	Predefinição:Legenda
Template:User ru-4	Predefinição:User ru-4
Template:Pp-template	Predefinição:Pp-template
Template:User nl-1	Predefinição:User nl-1
Template:User nl-2	Predefinição:User nl-2
Category:America	Categoria:América
Template:Mikoa cia Italy	Predefinição:Itália/Regiões
Template:User pt-1	Predefinição:User pt-1
Template:ICD10	Predefinição:CID10
Template:User pl	Predefinição:User pl
Template:User nl	Predefinição:User nl
Template:User no-2	Predefinição:User no-2
Template:Emergency-bot-shutoff	Predefinição:Botão de emergência
Template:User pl-1	Predefinição:User pl-1
Template:User lt	Predefinição:User lt
Template:User nds-1	Predefinição:User nds-1
Template:User ar	Predefinição:User ar
Template:User ksh	Predefinição:User ksh
Template:User no	Predefinição:User no
Template:User sv-2	Predefinição:User sv-2
Template:User lb-1	Predefinição:User lb-1
Template:User la-1	Predefinição:User la-1
Category:Template documentation	Categoria:!Instruções de predefinições
Category:User be-2	Categoria:Usuário be-2
Template:User pdc-1	Predefinição:User pdc-1
Category:User sk-N	Categoria:Usuário sk
Template:User la-3	Predefinição:User la-3
Category:Province ya Piacenza	Categoria:Província de Piacenza
Template:User sv-1	Predefinição:User sv-1
Template:User ka-1	Predefinição:User ka-1
Category:Thayathi cia social	Categoria:Ciências sociais
Template:User ru-2	Predefinição:User ru-2
Template:User es-3	Predefinição:User es-3
Template:User ko-3	Predefinição:User ko-3
Category:Main	Categoria:Artigos
Template:ICD9	Predefinição:CID9
Category:Kenya	Categoria:Quénia
Template:User ca-3	Predefinição:User ca-3
Template:User cs-3	Predefinição:User cs-3
Template:User la-2	Predefinição:User la-2
Template:User li-1	Predefinição:User li-1
Template:User mk-1	Predefinição:User mk-1
Template:User nn-2	Predefinição:User nn-2
Template:User no-1	Predefinição:User no-1
Template:User pt	Predefinição:User pt
Template:User ru-1	Predefinição:User ru-1
Template:User sk-1	Predefinição:User sk-1
Template:User sk-2	Predefinição:User sk-2
Template:User sr-1	Predefinição:User sr-1
Template:User sxu-1	Predefinição:User sxu-1
Template:User uk-4	Predefinição:User uk-4
Template:User vo-1	Predefinição:User vo-1
Template:User zh-1	Predefinição:User zh-1
Template:User zh-2	Predefinição:User zh-2
Template:User pfl-1	Predefinição:User pfl-1
Category:Mirimu	Categoria:Doenças
Template:User sl-1	Predefinição:User sl-1
Trojany	Trojany
Template:User tokipona-1	Predefinição:User tokipona-1
Category:Mikoa cia Kenya	Categoria:Províncias do Quénia
Ebola	Vírus Ebola
Template:User sh-2	Predefinição:User sh-2
Special:RecentChanges	Especial:Mudanças recentes
