អាហ្វ្រិក	África
ជប៉ុន	Japão
អង់គ្លេស	Inglaterra
ស្កុតឡែន	Escócia
វ៉ែល	País de Gales
អៀរឡង់ខាងជើង	Irlanda do Norte
សាធារណរដ្ឋអៀរឡង់	República da Irlanda
ប្រទេសហុងគ្រី	Hungria
អេស្ប៉ាញ	Espanha
សហរដ្ឋអាមេរិក	Estados Unidos
ផែនដី	Terra
ប៊ឺណឺស លី	Tim Berners-Lee
ស៊ុយអែត	Suécia
ប្រទេសប៉ូឡូញ	Polónia
អ៊ីតាលី	Itália
ព័រទុយហ្គាល់	Portugal
អឺរ៉ុប	Europa
អាស៊ី	Ásia
វិគីភីឌា	Wikipédia
ភីអេចភី	PHP
ទីក្រុងញូវយ៉ក	Nova Iorque
កុំព្យូទ័រ	Computador
អ៊ីនធើណេត	Internet
បារ៉ាក់ អូបាម៉ា	Barack Obama
ប៉ារីស	Paris
អាប្រាហាម លីនខូន	Abraham Lincoln
ប្រព័ន្ធប្រតិបត្តការ Android	Android
Google ស្វែងរក	Google
ម៉ិកស៊ិក	México
មហាសមុទ្រអាត្លង់ទិក	Oceano Atlântico
មហាសមុទ្រប៉ាស៊ីហ្វិក	Oceano Pacífico
ថ្ងៃច័ន្ទ	Segunda-feira
ខែមករា	Janeiro
ខែកុម្ភៈ	Fevereiro
ខែមីនា	Março
ភពអង្គារ	Marte (planeta)
ខែមេសា	Abril
ខែឧសភា	Maio
ខែមិថុនា	Junho
ខែកក្កដា	Julho
ខែសីហា	Agosto
ខែកញ្ញា	Setembro
ខែតុលា	Outubro
ខែវិច្ឆិកា	Novembro
ខែធ្នូ	Dezembro
អង្គារ	Terça-feira
ថ្ងៃពុធ	Quarta-feira
ថ្ងៃព្រហស្បតិ៍	Quinta-feira
ថ្ងៃសុក្រ	Sexta-feira
ថ្ងៃសៅរ៍	Sábado
ថ្ងៃអាទិត្យ	Domingo
សេះ (​អុក​)	Cavalo (xadrez)
បារាំង	França
សត្វឆ្កែ	Canis lupus familiaris
រាជាណាចក្ររួម	Reino Unido
ឆ្មា	Gato
ភាសាបារាំង	Língua francesa
ប្រេស៊ីល	Brasil
រុស្ស៊ី	Rússia
ការ៉េ	Quadrado
សមុទ្រ	Mar
អាល្លឺម៉ង់	Alemanha
ភាសាអាល្លឺម៉ង់	Língua alemã
ប្រទេសអាយឡែន	Islândia
ភពសៅរ៍	Saturno (planeta)
១ (លេខ)	Um
២ (លេខ)	Dois
៣ (លេខ)	Três
៥	Cinco
ចតុកោណកែង	Retângulo
មុំកែង	Ângulo reto
អ៊ុយក្រែន	Ucrânia
ទីក្រុងរ៉ូម	Roma
អាល់បានី	Albânia
អាស៊ែបៃហ្សង់	Azerbaijão
អង់ដូរ៉ា	Andorra
សាធារណរដ្ឋកាហ្សាក់ស្ថាន	Cazaquistão
បុរីវ៉ាទីកង់	Vaticano
គុយបា	Cuba
ឥណ្ឌូនេស៊ី	Indonésia
អាហ្វ្រិកខាងត្បូង	África do Sul
ប្រវត្តិសង្ខេប ក្រុមតន្រ្តី រ៉ុក linkin park	Linkin Park
ប្រទេសអាល់ហ្សេរី	Argélia
ស្រា	Vinho
ទឹក	Água
ទូរទស្សន៏	Televisão
ភាសាអាយឡែន	Língua islandesa
ឈីលី	Chile
ព្រះយេស៊ូវ គ្រីស្ទ	Jesus
ភពពុធ	Mercúrio (planeta)
ប្រវត្តិសាស្ត្រ	História
ភពសុក្រ	Vénus (planeta)
ភាសា	Linguagem
ភពព្រហស្បតិ៍	Júpiter (planeta)
ភពអ៊ុយរ៉ានុស	Urano (planeta)
វិគីភីឌាភាសាអង់គ្លេស	Wikipédia em inglês
ភពណិបទូន	Netuno (planeta)
សិង្ហបុរី	Singapura
ភ្លុយតុង	Plutão
ហ្វេសប៊ុក	Facebook
សង្គ្រាមលោកលើកទីមួយ	Primeira Guerra Mundial
សង្គ្រាមលោកលើកទី២	Segunda Guerra Mundial
ទំព័រគំរូ:Corruption	Corrupção
Ubuntu	Ubuntu
លីនុច	Linux
គណិតវិទ្យា	Matemática
បារ៉ែន	Bahrein
ព្រះចន្ទ	Lua
អូស្ត្រាលី	Austrália
រូបវិទ្យា	Física
ជីវវិទ្យា	Biologia
កូរ៉េខាងជើង	Coreia do Norte
ព្រះរាជាណាចក្រកម្ពុជា	Camboja
ឌីណូស័រ	Dinossauros
សាសនាឥស្លាម	Islão
សេរីភាព	Paz
សហភាពអឺរ៉ុប	União Europeia
ចេក	Banana
ណាប៉ូលេអុងបូណាប៉ារត៍	Napoleão Bonaparte
ព្រះអាទិត្យ	Sol
ឆ្នាំពន្លឺ	Ano-luz
អូសេអានី	Oceania
ប្រព័ន្ធព្រះអាទិត្យ	Sistema Solar
អុីដ្រូសែន	Hidrogénio
ទីម័រខាងកើត	Timor-Leste
ម៉ុង ប្លុង	Monte Branco
សឺរេស	Ceres (planeta anão)
អៀរីស	Éris (planeta anão)
ភព	Planeta
តន្ត្រី	Música
ភាសាអ៊ីតាលី	Língua italiana
អាលុយមីញ៉ូម	Alumínio
នូវែលសេឡង់	Nova Zelândia
ឥណ្ឌា	Índia
អង់ដ្រេ ម៉ារី អំពែរ	André-Marie Ampère
វីលីម ហ្សេកស្ពែរ	William Shakespeare
ប៉ាឡាវ	Palau
ម៉ុងហ្គោលី	Mongólia
ជេនហ្គិស ខាន់	Gengis Khan
កូឡុំប៊ី	Colômbia
ព្រះពុទ្ធសាសនា	Budismo
ហ្គាតេម៉ាឡា	Guatemala
មហាសមុទ្រអាកទិក	Oceano Ártico
អ៊ីរ៉ង់	Irão
ភាសាប៉ូឡូញ	Língua polaca
ហ្សកដង់	Jordânia
កៀហ៊្សីស៊ីស្ថាន	Quirguistão
គុយវ៉ែត	Kuwait
ឡាវ	Laos
លីបង់	Líbano
ទ្វីបអាមេរិក	América
ម៉ាឡេស៊ី	Malásia
មីយ៉ាន់ម៉ា	Myanmar
នេប៉ាល់	Nepal
ប៉ាគីស្ថាន	Paquistão
MySQL	MySQL
អារ៉ាប៊ីសាអូឌីត	Arábia Saudita
ស្រីលង្កា	Sri Lanka
ផ្លាតូ	Platão
តាជីគីស្ថាន	Tajiquistão
YouTube	YouTube
អារីស្តូត	Aristóteles
ថៃ	Tailândia
វិទ្យុ	Rádio (telecomunicações)
តួរមិនីស្ថាន	Turquemenistão
វៀតណាម	Vietname
កូរ៉េខាងត្បូង	Coreia do Sul
សាធារណរដ្ឋឥស្លាមអាហ្វហ្កានីស្ថាន	Afeganistão
ព្រែកជីកស៊ុយអែស	Canal de Suez
បង់ក្លាដែស្ស	Bangladesh
សូក្រាត	Sócrates
ធ្វិតថឺរ	Twitter
ប៊្រុយណេ	Brunei
ហ្វីលីពីន	Filipinas
អ៊ីសាក់ ញូតុន	Isaac Newton
OpenStreetMap	OpenStreetMap
អាល់បឺត អែងស្តែង	Albert Einstein
ប្រទេសហ្សំប៊ី	Zâmbia
ប៉េកាំង	Pequim
មហាត្មះគន្ធី	Mahatma Gandhi
ឆាលែស ដាវីន	Charles Darwin
ជូលីស៍ សេសារ	Júlio César
ឥន្ទធនូ	Arco-íris
អង្គការសហប្រជាជាតិ	Organização das Nações Unidas
ភូមិវិទ្យា	Geografia
ទីក្រុងប្រាក	Praga
បន្ទុកអគ្គីសនី	Carga elétrica
ខេត្តជើងភ្នំ (ប្រទេសអ៊ីតាលី)	Piemonte
មហាសមុទ្រឥណ្ឌា	Oceano Índico
អូសាម៉ា ប៊ីន ឡាឌែន	Osama bin Laden
ភាសាអេស្ប៉ាញ	Língua castelhana
ភីឡាដេលផ្យា	Filadélfia
ញូវយ៉ក	Nova Iorque (estado)
វ្លាឌីមៀរ អ៊ីលីច លេនីន	Lenin
អូហ្គុសទុស	Augusto
លោកកៃយុសសេសារ	Calígula
ត្រាហ្សាន	Trajano
Kde	KDE
កូរ៉ាស៊ូន អាគីណូ	Corazón Aquino
ទីក្រុងតូខ្យូ	Tóquio
ហ្វឺឌីណាន់ដ៏ ម៉ាហ្សេឡង់	Fernão de Magalhães
ស៊ីសេរ៉ូ	Cícero
ភ្នំពេញ	Phnom Penh
ទីក្រុងព្រៃនគរ	Cidade de Ho Chi Minh
ទីក្រុងហានូយ	Hanói
គ្រិស្តសាសនា	Verdadeira Igreja de Jesus
ភាសាអង់គ្លេស	Língua inglesa
គូឡាឡាំពួ	Kuala Lumpur
២០០១	2001
JavaScript	JavaScript
HTML5	HTML5
ល្បឿនពន្លឺ	Velocidade da luz
JPEG	Joint Photographic Experts Group
អេឡិចត្រុង	Elétron
ចក្រភព រ៉ូម	Império Romano
Microsoft	Microsoft
គីមីវិទ្យា	Química
ស៊ីទ្រុងជ្រូក	C Sharp
បេណេឌីកទី១៦	Papa Bento XVI
៧ កក្កដា	7 de julho
បាល់ទាត់	Futebol
ទីក្រុងបូកូតា	Bogotá
ថ្ងៃទី៣១ខែធ្នូ	31 de dezembro
រិសថា	4 Vesta
ស៊ីដនីយ៏	Sydney
ភ្លើង	Fogo
ខ្យល់	Atmosfera terrestre
កោះស៊ូម៉ាត្រា	Sumatra
ចាការតា	Jacarta
ចំណាត់ថ្នាក់ក្រុម:Wikipedia templates	Categoria:!Predefinições Wikipédia
កោះជ្វា	Java
ចំណាត់ថ្នាក់ក្រុម:ចំណាត់ថ្នាក់ក្រុមនៃទំព័រគំរូវិគីភីឌា	Categoria:!Predefinições por tema
កាលីម៉ាន់តាន់	Kalimantan
ខេត្តបន្ទាយមានជ័យ	Banteay Meanchey
វិគីភីឌា:ប្រអប់ខ្សាច់	Wikipédia:Página de testes
អាកាសយានដ្ឋាន ដុង ហ៊យ	Aeroporto de Dong Hoi
អាន់ ហ្វ្រែង	Anne Frank
ខុង ជឺ	Confúcio
ម៉ារីលីន ម៉ុនរ៉ូ	Marilyn Monroe
ចំណាត់ថ្នាក់ក្រុម:គណិតវិទ្យា	Categoria:Matemática
ទំព័រគំរូ:ទិន្នន័យប្រទេស អ៊ីរ៉ង់	Predefinição:Country data Irã
ចំណាត់ថ្នាក់ក្រុម:ប្រវត្តិសាស្ត្រខ្មែរ	Categoria:História do Camboja
ចំណាត់ថ្នាក់ក្រុម:ប្រវត្តិសាស្រ្តសិង្ហបុរី	Categoria:História de Singapura
សមុទ្រ មេឌីទែរ៉ានេ	Mar Mediterrâneo
វីនដូអេច	Windows 8
ទំព័រគំរូ:ប្រទេសនៅទ្វីបអាស៊ី	Predefinição:Países da Ásia
ទំព័រគំរូ:Agree	Predefinição:Concordo
ទន្លេហ្គារ៉ូន	Rio Garona
ស៊ីតថល	Seattle
ជញ្ជាំង ប៊ែរឡាំង	Muro de Berlim
ស្រូវ	Arroz
ទំព័រគំរូ:Lang-tr	Predefinição:Lang-tr
ទំព័រគំរូ:ផតថល	Predefinição:Portal
ទំព័រគំរូ:តំបន់នៃពិភពលោក	Predefinição:Regiões do mundo
ប៊ីល ហ្គេត	Bill Gates
ភាសាជប៉ុន	Língua japonesa
ប្រជុំវីជ្ជា	Enciclopédia
ឌីវីឌី	DVD
ទំព័រដើម	Wikipédia:Página principal
Central processing unit	Unidade central de processamento
រេស៊ីស្ទ័រ	Resistor
កីឡាអូឡាំពិក	Jogos Olímpicos
សមុទ្រ កាសព្យែន	Mar Cáspio
ឈី ហ្គីវ៉ារ៉ា	Che Guevara
ទីក្រុងកាបូល	Cabul
ហ្គ្រាប្រីអ៊ែល ហ្រ្គារ៉ាស្សៀ ម៉ារ៉ាហ្គេស	Gabriel García Márquez
ទស្សនវិជ្ជា	Filosofia
ចំណាត់ថ្នាក់ក្រុម:លុប	Categoria:!Páginas para eliminação rápida
លិទ្ធិកុម្មុយនិស្ត	Comunismo
ហ៊ីលឡារី រូដហេម គ្លីនតុន	Hillary Clinton
Boeing 737	Boeing 737
អាហារនៅប្រទេសបារំាង និង របៀបធ្វើ	Culinária da França
មណ្ឌលម៉ាញេតូ	Magnetosfera
UTC+7	UTC+7
ភាសាកាតាឡាន	Língua catalã
បណ្ណាល័យ	Biblioteca
នីល ហេនរីក ដេវីដ ប៊័រ	Niels Bohr
និវេសនវិទ្យា	Ecologia
ក្លឹបបាល់ទាត់បារសេឡូណា	Futbol Club Barcelona
នយោបាយ	Política
ធនាគារពិភពលោក	Banco Mundial
ប្រជាធិបតេយ្យ	Democracia
អង្គការសន្ធិសញ្ញាអាត្លង់ទិកខាងជើង	Organização do Tratado do Atlântico Norte
ម៉ារី ស្កូដូស្កា គុយរី	Marie Curie
រង្វាន់ណូបែល	Prémio Nobel
មជ្ឈិមបូព៌ា	Médio Oriente
រាជវង្សហាន	Dinastia Han
ប្រទេស	Estado
គ្រឹស្តុបផើ កូឡំបូស (Christopher Columbus)	Cristóvão Colombo
ព្រែកជីកប៉ាណាម៉ា	Canal do Panamá
មហាសមុទ្រខាងត្បូង	Oceano Antártico
ត្រីផ្សោតនៅកម្ពុជា	Golfinho
ក្មេង	Criança
លេអុនហាដ អយល័រ	Leonhard Euler
ណាប៉ូលេអុងទី៣	Napoleão III de França
ភាសារុស្ស៊ី	Língua russa
ល្វី ដ៏អស្ចារ្យ	Luís XIV de França
សមាគមប្រជាជាតិអាស៊ីអាគ្នេយ៍	Associação de Nações do Sudeste Asiático
ប្រវត្តិសាស្ត្របារាំង	História da França
តុលាការយុត្តិធម៌អន្តរជាតិ	Tribunal Internacional de Justiça
យូណេស្កូ	Organização das Nações Unidas para a Educação, a Ciência e a Cultura
អង្គការសុខភាពពិភពលោក	Organização Mundial da Saúde
អង្គការពាណិជ្ជកម្មពិភពលោក	Organização Mundial do Comércio
ភាសាចិន	Língua chinesa
ធម្មជាតិ	Natureza
ឈាម	Sangue
រញ្ជួយផែនដី	Sismo
សមុទ្រឡាប់តែវ	Mar de Laptev
ភ្លើងចរាចរ	Semáforo
ម៉ាទីន ឡូតធឺរ ឃីង	Martin Luther King Jr.
ត្រីកោណមាត្រ	Trigonometria
ធរណីមាត្រ	Geometria
វេយ្យាករណ៍	Gramática
សេដ្ឋកិច្ច	Economia
អក្សរក្រិច	Alfabeto grego
អក្សរឡាតាំង	Alfabeto latino
រឿងមហាភារតយុទ្ធ	Mahabharata
ការិយាល័យសហព័ន្ធស៊ើបអង្កេត	FBI
វីយោឡុង	Violino
អេឡិចសាន់ដឺ ដឹ ហ្គារ៉ែត	Alexandre, o Grande
សង្គម	Sociedade
ការអប់រំ	Educação
មនុស្សប្រុស	Homem
វិគីភីឌាភាសាអេស៉្បាញ	Wikipédia em espanhol
សិទ្ធិមនុស្ស	Direitos humanos
ទាសភាព	Escravidão
សង្គ្រាមស៊ីវិល	Guerra civil
ភ្នំ	Montanha
ហុងកុង	Hong Kong
សង្គ្រាមត្រជាក់	Guerra Fria
សេអ៊ូល	Seul
សង្គ្រាមវៀតណាម	Guerra do Vietnã
ម៉ៃឃើល ហ្វារ៉ាដេយ	Michael Faraday
អង់រីកូ ហ្វែរមី	Enrico Fermi
ភាសាអ៊ុយក្រែន	Língua ucraniana
HTML	HTML
ច្យូហានេស គូទេនបឺគ	Johannes Gutenberg
ភាសាដាណឺម៉ាក	Língua dinamarquesa
ភាសាអេស្តូនី	Língua estónia
ហិណ្ឌូសាសនា	Hinduísmo
ភាសាពែក	Língua persa
សាសនា	Religião
ភាសាកូរ៉េ	Língua coreana
ភាសាខ្មែរ	Língua khmer
ហ្រ្គេតស៊ីងមួន	Sigmund Freud
ភាសាថៃ	Língua tailandesa
ភាសាម៉ាឡេ	Língua malaia
ភាសាឥណ្ឌូនេស៊ី	Língua indonésia
ភាសាហេប្រ៊ូ	Língua hebraica
ចន ឡុក	John Locke
ថ្លើម	Fígado
ចិត្តវិទ្យា	Psicologia
មហាសមុទ្រ	Oceano
ពុទ្ធប្រវត្តិសង្ខេប	Sidarta Gautama
ចរិយាមារយាទ	Ética
សារជីវកម្មផ្សព្វផ្សាយព័ត៌មានរបស់ចក្រភពអង់គ្លេស(BBC)	British Broadcasting Corporation
ក្លិបបាល់ទាត់ឆេលស៊ី	Chelsea Football Club
គ្រោងឆ្អឹងមនុស្ស	Esqueleto humano
ក (អវយវៈ)	Pescoço
រាជវង្សថាង	Dinastia Tang
John F. Kennedy	John F. Kennedy
LibreOffice	LibreOffice
ផ្លូវរូងដីក្រោមសមុទ្រ	Eurotúnel
តារាងខួបនៃធាតុគីមី	Tabela periódica
ប្រូម៉ាស	Queijo
ទំពាំងបាយជូរ	Uva
បន្លែ	Hortaliça
បច្ចេកវិទ្យា	Tecnologia
វិស្វកម្ម	Engenharia
ទំនាក់ទំនង	Comunicação
វិជ្ជាជីវៈខាងសារព័ត៌មាន	Jornalismo
កាសែត	Jornal
ទូរស័ព្ទ	Telefone
វប្បធម៌	Cultura
សំស្ក្រឹត	Sânscrito
ប្រដាប់របត់ឈាម	Sistema circulatório
The Guardian	The Guardian
សមីការឌីផេរ៉ង់ស្យែល	Equação diferencial
មៃក្រូសូហ្វអ៊ិសេល	Microsoft Excel
មុំ	Ângulo
សំទុះ	Aceleração
ព្រះសិវៈ	Shiva
ព្រះវិស្ណុ	Vixnu
Local Area Network	Rede de área local
Wide Area Network	Rede de longa distância
ព្រះព្រហ្ម	Brama
កម្លាំង	Força
អេឡិចត្រូម៉ាញ៉េទិច	Eletromagnetismo
កសិកម្ម	Agricultura
សំលៀកបំពាក់	Roupa
ល្បឿន	Velocidade
ក្រដាស	Papel
សុញ្ញកាស	Vácuo
ស៊ីនេម៉ាទិច	Cinemática
ក្រលាផ្ទៃ	Área
ទ្រឹស្តីបទពីតាករ	Teorema de Pitágoras
ចំនួនកុំផ្លិច	Número complexo
Cristiano Ronaldo	Cristiano Ronaldo
អ្នកថតរូប	Fotografia
ល្ខោន	Teatro
គ្រឿងអេឡិចត្រូនិច	Componente eletrônico
ព័ត៌មានវិទ្យា	Tecnologia da informação
អាស៊ីអាគ្នេយ៍	Sudeste Asiático
ក្រុងសៀមរាប	Siem Reap (cidade)
បញ្ជីរាយនាម ប្រទេស	Lista de Estados soberanos
វិគីភីឌាភាសាព័រទុយហ្គាល់	Wikipédia em português
ប្រដាប់រំលាយអាហារ	Digestão
កីឡាចាក់សាប	Esgrima
រោគផ្ដាសាយធម្មតា	Constipação
រោគសរសៃប្រសាទ	Transtorno mental
ប្រតិទិន ក្រេកូរី	Calendário gregoriano
សុខភាព	Saúde
ជម្ងឺរលាកទងសួត	Pneumonia
ជំងឺអេដស៍	Síndrome da imunodeficiência adquirida
កូដ QR	Código QR
ជំងឺទឹកនោមផ្អែម	Diabetes mellitus
ទំព័រគំរូ:Location map Belgium	Predefinição:Mapa de localização/Bélgica
ទំព័រគំរូ:Location map Croatia	Predefinição:Mapa de localização/Croácia
ទំព័រគំរូ:Location map Ukraine	Predefinição:Mapa de localização/Ucrânia
ទំព័រគំរូ:Location map Burma	Predefinição:Mapa de localização/Myanmar
ទំព័រគំរូ:Location map Philippines	Predefinição:Mapa de localização/Filipinas
ទំព័រគំរូ:Location map Vietnam	Predefinição:Mapa de localização/Vietnã
ទំព័រគំរូ:Location map Cambodia	Predefinição:Mapa de localização/Camboja
ទំព័រគំរូ:Location map Thailand	Predefinição:Mapa de localização/Tailândia
ទំព័រគំរូ:Location map Indonesia	Predefinição:Mapa de localização/Indonésia
ទំព័រគំរូ:Location map Australia	Predefinição:Mapa de localização/Austrália
ញូតុន	Newton (unidade)
ចក្រភព អូតូម៉ង់	Império Otomano
ម៉ាស៊ីនចំហេះក្នុង	Motor de combustão interna
ក្បាច់គិតលេខ	Ábaco
វឺតប្រែស	WordPress
Joomla!	Joomla
ដើមដូង	Coqueiro
ភាសាណាវ៉ាថ្ល៍	Língua náuatle
ភាសាម៉ាយ៉ាយូកាតិក	Iucateque
អែនជេលីណា ចូលី	Angelina Jolie
អ៊ីលដឺហ្រ្វែន	Ilha de França
ភាសាអារ៉ាប់	Língua árabe
Thanksgiving	Ação de Graças
តំបន់ឃ្ជឺស្សឺ	Kyushu
តំបន់ស៊ីកុគឹ	Shikoku
នាយករដ្ឋមន្ត្រី	Primeiro-ministro
ទង់ជាតិ	Bandeira
ខ្មៅដៃ	Lápis
សហភាពសូវៀត	União Soviética
ចំណុចរលាយ	Ponto de fusão
កាមេរ៉ា	Câmera
កម្មវិធីទូរទស្សន៍	Programa de televisão
ខេត្តខាហ្គុស៊ីម៉ា	Kagoshima
ភាសាស៊ី	C (linguagem de programação)
ម៉ង់តេរីយើ	Montesquieu
វិគីភីឌា:អត្ថបទពិសេស	Wikipédia:Artigos destacados
ទំព័រគំរូ:Link FA	Predefinição:Link FA
ពិភពលោក	Mundo
ឈូក	Nelumbo nucifera
ឡងប៊ិច (កាលីផ្វនញ៉ា)	Long Beach (Califórnia)
រង្វង់	Círculo
ប្លង់	Plano (geometria)
វិគីភីឌាភាសាកូរ៉េ	Wikipédia em coreano
ទៀបកោះម៉ាឡេ	Península da Malásia
អេប៉ុងហ្ស៍ (ពពុះទឹក)	Porifera
មធ្យមនព្វន្ធ	Média aritmética
World Cup	Copa do Mundo FIFA
សម្ដេចប៉ាប	Papa
IATA	Associação Internacional de Transportes Aéreos
បុណ្យណូអែល	Natal
ត្រីកោណ	Triângulo
លោកអេលីសេ រីខ្លាស	Élisée Reclus
អ្នកប្រើប្រាស់:អេង ឡុង/សង្គមវិទ្យាមូលដ្ឋាន	Sociologia
សញ្ញាសំលេងអន្តរជាតិ	Alfabeto fonético internacional
តៃវ៉ាន់	Ilha Formosa
Friedrich Schiller	Friedrich Schiller
ជំនឿបាហៃ	Fé bahá'í
១	1
អាប្រាហាម ម៉ាស្លូ	Abraham Maslow
ខ្ទឹមស	Alho
អ៊ូលេនបាធរ	Ulan Bator
កោះ	Ilha
ភាសាផ្លូវការ	Língua oficial
ខ្សែអេក្វាទ័រ	Linha do equador
ទិស	Ponto cardeal
លេខអាតូម	Número atómico
អាល់ហ្វ្រិដ ណូបែល	Alfred Nobel
សម្ដេចប៉ាប យូហាន ទី២៣	Papa João XXIII
កិរិយាសព្ទ	Verbo
ទីតានិច	RMS Titanic
សត្វឆ្អឹងកង	Vertebrados
បាគូ	Poupa-eurasiática
អំពែរ	Ampere
ISO 3166-1	ISO 3166-1
១ មុនគ.ស	1 a.C.
ម៉ែត្រការ៉េ	Metro quadrado
ជំនួយ:Interlanguage links	Plâncton
សហស្សវត្សរ៍ទី២	Segundo milénio d.C.
ខេត្តកំពង់គោ	Long An
ទ្រឹស្តីបទទ្វេធា	Binómio de Newton
សមុទ្រជប៉ុន	Mar do Japão
អាស៊ីខាងកើត	Ásia Oriental
អាមេរិក កណ្ដាល	América Central
គ្រីស្ទអឌែលហ្វៀន	Cristadelfianos
បរិមាត្រ	Perímetro
ចក្រភព អូទ្រីស-ហុងគ្រី	Áustria-Hungria
បណ្ណាល័យជាតិ	Biblioteca pública
ផាយថុន	Python
អានន្ទ	Ananda (discípulo de Buda)
អាស៊ីហ្គេមឆ្នាំ១៩៥១	Jogos Asiáticos de 1951
បាកាន	Bagan
ចិន	China (civilização)
សំទុះទំនាញដី	Aceleração da gravidade
ច្បាប់ធម្មតា	Common law
អ្នកម្តាយ តេរេសា​ (Mother Teresa)	Madre Teresa de Calcutá
ប្លូក	Blog
រោគគ្រុនចាញ់	Dengue
ដុល្លារហុងកុង	Dólar de Hong Kong
ខ្សែបណ្ដោយ	Meridiano (geografia)
ខេត្តឃ្លាំង	Soc Trang
ខេត្តទឹកខ្មៅ	Cà Mau
សមុទ្រខារ៉ា	Mar de Kara
ផ្លេតបន្ទោរ	Raio (meteorologia)
កំរងកោះ	Arquipélago
តួប្រុស	Ator
អំបូរភាសាយូតូអាហ្សតិក	Línguas uto-astecas
ចាស្ទីន ពីពេ្រ	Justin Bieber
ក្រុម​ភាសា​ថៃកៈដៃ	Línguas kradai
ចក្រភព រុស្ស៊ី	Império Russo
មឞវជ	Mošovce
បេណាហ្សៀរ ប៊ូតូ	Benazir Bhutto
ស៊ីឌី	Compact Disc
ឧទ្ធម្ភាគចក្រ	Helicóptero
គុណនាម	Adjetivo
វីតាមីន	Vitamina
វែបសាយ	Site
តំបន់ហុកកៃដូ	Hokkaido
រូបមន្តសមមូលម៉ាស់-ថាមពល	Equivalência massa-energia
សមុទ្រ អារ៉ាល់	Mar de Aral
ហូ ជីមិញ	Ho Chi Minh
ម៉ាក ហ្សុកឃឺបឺក	Mark Zuckerberg
ប្រតិកម្មគីមី	Reação química
ខេត្តក្រមួនស	Kien Giang
ខេត្តមាត់ជ្រូក	An Giang
ខេត្តរោងដំរី	Tay Ninh
ខេត្តព្រះត្រពាំង	Tra Vinh
Binomial nomenclature	Nomenclatura binomial
ខេត្តពលលាវ	Bac Lieu
ខេត្តផ្សារដែក	Dong Thap
វ៉ែសបែង	Cisjordânia
ភាសាបាលី	Língua páli
គេហទំព័រ	Página web
ចតុកោណ	Quadrilátero
ឈិន ឡុង	Jackie Chan
ទិវាកុមារអន្តរជាតិ	Dia Mundial da Criança
Yahoo!	Yahoo!
បន្ទាត់	Reta
ហ្មរិឩពឡ	Mariupol
អង្កត់ផ្ចិត	Diâmetro
គ្រូបង្រៀន	Professor
ស្នាដៃនៃបុព្វបុរសខ្មែរ	Escrita
ស្ដេចប៉ាប យ៉ូហាន ប៉ូលទី១	Papa João Paulo I
ណៃពិដោ	Naypyidaw
ISO 4217	ISO 4217
ព្យែរ គុយរី	Pierre Curie
ក្រុមប្រឹក្សាសន្តិសុខ អង្គការសហប្រជាជាតិ	Conselho de Segurança das Nações Unidas
ពហុកោណ	Polígono
ទិវានៃក្ដីស្រលាញ់	Dia dos Namorados
ហ្គូហ្គល	Mercado
សមុទ្រចិនខាងត្បូង	Mar da China Meridional
និវេសនប្រព័ន្ធ	Ecossistema
សមុទ្រលឿង	Mar Amarelo
យ៉ាំងហ្គូន	Rangum
សូរព្យញ្ជនៈ	Consoante
ច្បាប់ចលនារបស់ញូតុន	Leis de Newton
ឈូងសមុទ្របេងហ្គាល់	Golfo de Bengala
ទិវានារីអន្តរជាតិ	Dia Internacional da Mulher
.jp	.jp
ភ្នំហ្វឹជី	Monte Fuji
ប៉ុលពត	Pol Pot
ភ្នំភ្លើង អ៊ីស៊ាឡឺក	Eyjafjallajökull
ម៉ាក្រូសេដ្ឋកិច្ច	Macroeconomia
ដីជ្រោយហ្គាស្សា	Faixa de Gaza
​វិទ្យុ​ស្ទូឌីយោ 54 បណ្តាញ	Rádio Studio 54 Network
អេលីប	Elipse
សមាគមន៍សារព័ត៌មាន	Associated Press
អធិដ្ឋាន	Oração
គណៈកម្មាធិការអូឡាំពិកអន្តរជាតិ	Comité Olímpico Internacional
Skype	Skype
.kh	.kh
ចតុកោណស្មើ	Losango
ទន្លេមេគង្គ	Rio Mekong
មេកានិច	Mecânica
វិចិត្រសាលវលញ្ឆករប្រទេស	Galeria de brasões de armas nacionais
ហែងរីហ ហឺត	Heinrich Hertz
អង់រី បិកកឺរ៉ែល	Antoine Henri Becquerel
ទស្សនាវដ្ដី	Revista
សមីការដឺក្រេទី២	Equação quadrática
រូពីឥណ្ឌូនេស៊ី	Rupia indonésia
សមុទ្រអុកហុតស្គ៍	Mar de Okhotsk
ចិត្តវិភាគ	Psicanálise
ខ្មែរម៉ាស្ទើ	Webmaster
.kr	.kr
URL	URL
ក្រុមបាល់ទាត់ជម្រើសជាតិ អេស្ប៉ាញ	Seleção Espanhola de Futebol
Google Earth	Google Earth
ប៊ែនហាដ រីម៉ាន	Bernhard Riemann
កោន	Cone
អាតុល	Atol
ទិន្នន័យ	Dados
ខ្លែង	Pipa (brinquedo)
ស្ថាបត្យករ	Arquiteto
មហាអំណាច អាប់ស៊ីស	Potências do Eixo
វិគីភីឌា:FAQ	Ajuda:FAQ
.th	.th
ចក្រភព អាល្លឺម៉ង់	Império Alemão
ក្រុមបាល់ទាត់ជម្រើសជាតិ អាល្លឺម៉ង់	Seleção Alemã de Futebol
ហេរី ផោតធ័រ និង សិលាទេព	Harry Potter e a Pedra Filosofal
អង្គការ Creative Commons	Creative Commons
ឥណ្ឌូចិន	Indochina
ប្រាសាទអង្គរវត្ត	Angkor Wat
ទ្រឹស្ដីរ៉ឺឡាទីវីតេ	Teoria da relatividade
ប្រុស	Macho
Toulon	Toulon
ប៉ាស្កាល់	Pascal (unidade)
ទ្រឹស្ដីល្បែង	Teoria dos jogos
សមុទ្រចិនខាងកើត	Mar da China Oriental
ខ្នុរ	Artocarpus heterophyllus
ប្រលេឡូក្រាម	Paralelogramo
ប្រាសាទព្រះវិហារ	Templo Hindu de Preah Vihear
ចតុកោណព្នាយ	Trapézio (geometria)
ស៊ូស៊ី	Sushi
រូប៊ិក ខ្យូប	Cubo de Rubik
កាល	Plauto
ចង្រិត	Grilo
ទិវាពលកម្មអន្ដរជាតិ	Dia do Trabalhador
ស្ទឹង	Córrego
សមុទ្រអង់ដាម៉ង់	Mar de Andamão
ប៉ិបស៊ី	Pepsi
ក្រុមបាល់ទាត់ជម្រើសជាតិ អង់គ្លេស	Seleção Inglesa de Futebol
ក្រុមបាល់ទាត់ជម្រើសជាតិ បារាំង	Seleção Francesa de Futebol
ទំព័រគំរូ:Commonscat	Predefinição:Commonscat
វិគីភីឌាភាសាអាល្លឺម៉ង់	Wikipédia em alemão
អាស៊ីខាងលិច	Oriente Próximo
យេនឌ័រ	Identidade de gênero
អង្គការសហភាពអន្តរជាតិដើម្បីអភិរក្សធម្មជាតិ	União Internacional para a Conservação da Natureza e dos Recursos Naturais
ទីក្រុងមេឌេយីណ	Medellín
ប៉ារ៉ាបូល	Parábola
ខេត្តអ៊ីវ៉ាតិ	Iwate
ទ្វារសមុទ្រមលក្កា	Estreito de Malaca
មហាយាន	Maaiana
ប្រព័ន្ធប្រតិបត្តការ iOS	IOS
ចំនួនបឋម	Número primo
សង្គ្រាម ប្រាំមួយ ថ្ងៃ	Guerra dos Seis Dias
ក្រុងឡូវែល រដ្ឋម៉ាស្សាឈូស៊ែត	Lowell (Massachusetts)
សមុទ្រជ្វា	Mar de Java
សិប្បកម្មខ្ញុំ	Minecraft
ច្រកសមុទ្រធ្ងន់ធ្ងរ	Dire Straits
វីហ្សួលបេហ៊្សិក.ណេត	Visual Basic .NET
បំណែងចែករដ្ឋបាលនៃកម្ពុជា	Subdivisões do Camboja
អនុគមន៍ដឺក្រេទី២	Função quadrática
ច្បាប់អំពែរ	Lei de Ampère
ជំងឺអ៊ីបូឡា	Doença por vírus Ébola
ច្រកកូរ៉េ	Estreito da Coreia
ឆកសមុទ្រកូរ៉េ	Golfo da Coreia
កង្កែប	Anura
ខ្សែទឹកឃឹរ៉ុស៊ីអុ	Corrente Kuro Shivo
ចំណាត់ថ្នាក់ក្រុម:ព្រះមហាក្សត្រ	Categoria:Monarcas
ចំណាត់ថ្នាក់ក្រុម:រដ្ឋាភិបាល	Categoria:Governo
ទំព័រគំរូ:Infobox legislature	Predefinição:Info/Órgão legislativo
ទន្លេយ៉ាលូ	Rio Yalu
ទំព័រគំរូ:ប្រវត្តិសាស្ត្រចិន	Predefinição:História da China
ទំព័រគំរូ:ប្រវត្តិសាស្ត្រអាស៊ី	Predefinição:História da Ásia
មីហ្គេល អ៊ីដាលហ្គោ អ៊ី កុស្ទីយ៉ា	Miguel Hidalgo
នរោត្តម សីហមុនី	Norodom Sihamoni
ហ៊ុន សែន	Hun Sen
តូក្យូស្កាយទ្រី	Tokyo Skytree
ភាសាប៉ាស្តូ	Língua pachto
កំណែទម្រង់រូបិយវត្ថុ	Reforma monetária
ធនាគារកណ្ដាល	Banco central
Pidgin	Pidgin (comunicador instantâneo)
​វិលហែម វុឌ	Wilhelm Wundt
យិដា តាដូ	Gerda Taro
មនុស្សពីងពាង	Homem-Aranha
សារធាតុគីមី	Substância
ចលនានៅក្នុងរូបវិទ្យា	Movimento
ជម្ងឺកញ្ជ្រឹល	Sarampo
ក្រុមបាល់ទាត់ជម្រើសជាតិ អាហ្សង់ទីន	Seleção Argentina de Futebol
ខ្យល់ព្រះអាទិត្យ	Vento solar
បាល់ទាត់ពិភពលោក ២០១៤	Copa do Mundo FIFA de 2014
ម៉ូបាល (អាល់ឡាបាម៉ា)	Mobile (Alabama)
កុំព្យូទ័រផ្រូក្រាមមីង(Computer programming)	Programação de computadores
ខេត្តឈីបា	Chiba
អាំងតេក្រាល	Integral
ខេត្តអៃឈិ	Aichi
វិបត្តិសេដ្ឋកិច្ចឆ្នាំ ១៩៩៧	Crise financeira asiática de 1997
ខ្មែរ	Adulto
សិល្បៈប្រើវោហារបង្ហូរគំនិត	Retórica
ឃីមីហ្គាយ៉ុ	Kimi ga Yo
សាល អូហ្គុស្ទីន ដឺ គូឡុំ	Charles Augustin de Coulomb
ខេត្តអាគីតា	Akita
ថ្នាក់ពាក្យ	Classe gramatical
ស្ថានភាពអភិរក្ស	Estado de conservação
កាន់ជិ	Kanji
នាម	Nome
ប្រវត្តិសាស្ត្រចិន	História da China
អវតារ	Avatar
ច្បាប់គូឡុំ	Lei de Coulomb
រឿង រ៉ូមេអូ និង ហ្ស៊ុយលីយេ	Romeu e Julieta
សាលីណា កូមាស់	Selena Gomez
ក្រុម (តារាងខួបនៃធាតុគីមី)	Grupo (química)
ក្រុមបាល់ទាត់ជម្រើសជាតិ ប្រេស៊ីល	Seleção Brasileira de Futebol
កាល ឡែមស្ដែនណឺ	Karl Landsteiner
ឯកសារភាពយន្ត	Documentário
អនុគមន៍ត្រីកោណមាត្រ	Função trigonométrica
ហ្រាន្ដកូស ហ្វីឡុន	François Fillon
ខួប (តារាងខួបនៃធាតុគីមី)	Período (química)
ល្បែងទាញព្រ័ត្រ	Cabo de guerra
Article (grammar)	Artigo (gramática)
មេដ្យានទ័រ	Compasso (geometria)
Rfid	Identificação por radiofrequência
អ៊ីប៉ូតេនុស	Hipotenusa
ហិចហ្វាន់	Fundo de cobertura
ISO 3166	ISO 3166
សញ្ញាជាតិកូរ៉េខាងជើង	Brasão de armas da Coreia do Norte
មេហ្គា	Mega
គីឡូ	Quilo
ការតាំងសមាធិ	Meditação
ប៉េតា	Peta (prefixo)
យ៉ុតតា	Yotta
សង់ទី	Centi
ហ្គីហ្គា	Giga
តេរ៉ា	Tera
ហ្វង់តូ	Femto
ហ្សិតតា	Zetta
ច្រកតារតារី	Estreito da Tartária
ហ្សិបតូ	Zepto
កាតែត	Cateto
អាត់តូ	Atto
យ៉ុកតូ	Yocto
ដេស៊ី	Deci
ចំណែករដ្ឋបាលនៃម៉ិចស៊ិក	Divisões políticas do México
ម៉ាស៊ីនស្វែងរក	Metabusca
អាំងតេក្រាលមិនកំនត់	Primitiva
គណបក្សហ៊្វុនស៊ិនប៉ិច	Funcinpec
ខេត្តក្យូតុ	Quioto (província)
តំលៃដាច់ខាត	Função modular
ហេដ្ឋារចនាសម្ព័ន្ធ	Infraestrutura (engenharia)
តេគីឡា	Tequila
សន្ធិសញ្ញាប្រេស្ត-លីតូវស្ក	Tratado de Brest–Litovski
William Thomson, 1st Baron Kelvin	William Thomson
អាណាខេត្តអូសាកា	Osaka
ខេត្តអិហ៊ីមិ	Ehime
វាំងននដែក	Cortina de Ferro
Kara (band)	Kara (banda)
វីលៀម ជែម	William James
ខេត្តយ៉ាម៉ាកាតា	Yamagata
ច្រកតៃវ៉ាន់	Estreito de Taiwan
គំរោងម៉ាន់ហាត់ថាន់	Projeto Manhattan
ខេត្តយ៉ាម៉ាហ្គឹឈិ	Yamaguchi
ខេត្តខាន់ណាហ្គាវ៉ា	Kanagawa
បញ្ចកោណ	Pentágono
តំបន់ជឺហ្គុកឹ	Região de Chugoku
ខេត្តណាហ្គាណុ	Nagano
ខេត្តសៃតាម៉ា	Saitama
ខេត្តមីអិ	Mie
ណុត	Nó (unidade)
តំបន់តុហុកកឹ	Região de Tōhoku
ខេត្តហ្គឺនម៉ា	Gunma
ជ្រូកទឹក	Dugongo
ខ្សែទឹកមហាសមុទ្រ	Corrente oceânica
ខេត្តមីយ៉ាសាគី	Miyazaki
ខេត្តឃឹម៉ាម៉ុតុ	Kumamoto
Mikoyan MiG-29	Mikoyan-Gurevich MiG-29
សប្ដាហ៏ពិសិដ្ឋ	Semana Santa
ឈូងសមុទ្រថៃ	Golfo da Tailândia
អ៊ីមម៉ាជីន និងផូស៊ី	IMMAGINE&POESIA
លី ក្វាន់យូ	Lee Kuan Yew
កម្មសិទ្ធិបញ្ញា	Propriedade intelectual
អាណាខេត្តណារ៉ា	Nara (Japão)
បុព្វបទនៅក្នុងប្រព័ន្ធខ្នាតអន្តរជាតិ	Prefixo SI
យន្តហោះប៉ូឡូញកំទេចឆ្នាំ២០១០	Acidente do Tu-154 da Força Aérea Polonesa
ជនភៀសខ្លួន	Refugiado
ហង់រី កាវិនឌីស	Henry Cavendish
បុណ្យចូលឆ្នាំចិន	Ano-novo chinês
ថេរវាទ	Teravada
តំបន់ខាន់តូ	Região de Kanto
ខេត្តនីហ្គាតាក់	Niigata
ខេត្តយ៉ាម៉ាណាស៊ី	Yamanashi
ខេត្តស៊ីម៉ាណិ	Shimane
ខេត្តតុយ៉ាម៉ា	Toyama
ខេត្តអូកាយ៉ាម៉ា	Okayama
ISO 3166-2	ISO 3166-2
ខេត្តអយតាក់	Oita
ខេត្តខូឈិ	Kōchi
អង្គការអន្តរជាតិនៃនយោបាយរបស់បារាំង	Organização Internacional da Francofonia
ភ្នំមេរ៉ាពី	Merapi
ព្រះធម៌	Darma
តំបន់ឈឺប៊ឹ	Região de Chubu
វ៉ាក់សាំង	Vacina
រោគក្អកមាន់	Pertússis
កម្ពុជា នៅកីឡាអូឡាំពិករដូវក្ដៅ ២០០៨	Camboja nos Jogos Olímpicos de Verão de 2008
គីមឈី	Kimchi
ខេត្តកំពង់ចាម	Kampong Cham (província)
ខ្សែទឹកហាំបុល	Corrente de Humboldt
ខ្សែទឹកអូស្ត្រាលីខាងកើត	Corrente da Austrália oriental
ជ័រទឹក	Resina
ដុនបូស្កូ	Dom Bosco
ធ្នូរង្វង់	Arco (matemática)
អប្សរា	Apsarás
ស្រុក	Distrito
រាជវង្សចោឡា	Império Chola
ខ្លារខិន ២ (រថក្រោះ)	Leopard 2
មហាអំណាច កណ្ដាល	Impérios Centrais
អិចសា	Exa
ហិកតូ	Hecto
ដេកា	Deca
រ៉ូបឺតកាប៉ា	Robert Capa
មីល្លី	Mili
មីក្រូ	Micro
ពីកូ	Pico (prefixo)
ណាណូ	Nano
លីប៉ូល ស៊ីដាស៊ាងហ័រ	Léopold Sédar Senghor
វិគីភីឌាភាសាឥណ្ឌូនេស៊ី	Wikipédia em indonésio
ទន្ដគោម	Agave
ប្រវតិ្តBoney M	Boney M
វីមេអូ	Vimeo
អំពើអនិត្យានុកូល	Violência doméstica
ហង់រី ការចេរ ប្រេស្សុង	Henri Cartier-Bresson
ត្រីកោណសម័ង្ស	Triângulo equilátero
ម៉ាក់ណូលា	Magnólia
ចូសេហ្វ ហិនរី	Joseph Henry
មន ស	Morus alba
ពិធីបញ្ជាប់ពាក្យ	Noivado
ត្រីកោណកែង	Triângulo retângulo
សមុទ្រហ្វីលីពីន	Mar das Filipinas
ប្រព័ន្ធកូអ័រដោណេភូមិសាស្ត្រ	Geopolítica
Eurocopter Tiger	Eurocopter Tiger
តេត្រាអែត	Tetraedro
ម៉ោងផែនដី	Hora do Planeta
នរោត្ដម សីហនុ	Norodom Sihanouk
ទន្លេរីយ៉ូហ្គ្រែនដេ	Rio Grande (América do Norte)
សំព័រ	Artocarpus
កម្មវិធីអភិវឌ្ឍន៍សហប្រជាជាតិ	Programa das Nações Unidas para o Desenvolvimento
ម៉ាស៊ីនថត លេកា	Leica Camera
សេវាសាធារណៈ	Serviço público
មេគុណជីនី	Coeficiente de Gini
នីត្រូគ្លីសេរីន	Nitroglicerina
វណ្ណយុត្តិ	Diacrítico
ទង់ជាតិកម្ពុជា	Bandeira do Camboja
ក្រុងអង្គរ	Angkor
ក្រពេញទីមុស	Timo
ទ្រឹស្តីបទកូស៊ីនុស	Lei dos cossenos
ទក្សិណ ជិនវ័ត្រ	Thaksin Shinawatra
ប្រធាន	Sujeito
ហិនរី រ៉េម៉ុន	Henry Jarvis Raymond
អ៊ែង​ហ្គ្រី បឺដ	Angry Birds
អ៊ីពែបូល	Hipérbole
វិសមភាពស្វ័យគុណ	Desigualdade
ប៊ិច	Caneta
ចេក​	Musa × paradisiaca
XHTML	XHTML
ចម្ប៉ាក្រហម	Michelia champaca
គ្រោះទុរ្ភិក្ស	Carestia
អរិយសច្ច៤	Quatro Nobres Verdades
ស្តាទិច	Estática
ខេត្តណាហ្គាសាគី	Nagasaki (província)
វិគីភីឌាភាសាស្វីស	Wikipédia em sueco
ភ្លើងឆេះព្រៃ	Incêndio florestal
ទ្រឹស្តីបទស៊ីនុស	Lei dos senos
ច្បាប់ហ៊ូក	Lei de Hooke
ក្រុមបាល់ទាត់ជម្រើសជាតិ ជប៉ុន	Seleção Japonesa de Futebol
រោគឈឺចាប់ក្នុងសន្លាក់ឆ្អឹង	Artrite
ប្លុកហ្គឺ (Blogger)	Blogger
ធម្មនុញ្ញនៃអង្គការសហប្រជាជាតិ	Carta das Nações Unidas
Boeing AH-64 Apache	AH-64 Apache
រោគហើមសួត	Bronquite
អេមីល្យូ ហ្គីណូ សេហ្គ្រែ	Emilio Gino Segrè
Sukhoi Su-27	Sukhoi Su-27
ម៉ាស៊ីនត្រជាក់	Condicionamento de ar
កាំ	Raio (geometria)
អភិសិទ្ធិ វេជ្ជាជីវៈ	Abhisit Vejjajiva
HAL Tejas	HAL Tejas
លីមីត	Limite
អ៊ីដ្រូស្តាទិច	Hidrostática
វិគីភីឌាភាសាជប៉ុន	Wikipédia em japonês
គោលនយោបាយរូបិយវត្ថុ	Política monetária
យានដឹកជញ្ជូនសាធារណៈ	Transporte público
ការសំភាសន៏	Entrevista
ពាណិជ្ជកម្មអន្តរជាតិ	Comércio internacional
ចក្រភពអាណានិគមបារាំង	Império colonial francês
ពន្ធលើប្រាក់ចំណូល	Imposto de renda
HTML tag	Elemento HTML
រូបចំលាក់	Estátua
ពុយមីស	Pedra-pomes
FM	Modulação em frequência
សង្គមស៊ីវិល	Sociedade civil
សមុទ្របូហៃ	Mar de Bohai
ការិយាល័យ	Escritório
ការបង្រៀនដែនដីបរិសុទ្ធ	E-learning
ម៉ែត្រក្នុងមួយវិនាទី	Metro por segundo
រូបមន្តហេរុង	Teorema de Herão
ទន្សោង	Bos javanicus
វីតាមីន B	Complexo B
គណៈកម្មាធិការជាតិអូឡាំពិក	Comitê Olímpico Nacional
ប៉មតូក្យូ	Torre de Tóquio
ទិវាទឹកអន្តរជាតិ	Dia Mundial da Água
រូបមន្តអយល័រ	Fórmula de Euler
ស៊ីយ៉ាញួរ	Cianeto
អរិយដ្ឋង្គិកមគ្គ	Nobre Caminho Óctuplo
សហភាពឥណ្ឌូចិន	Indochina Francesa
ចន្ទគតិ	Calendário lunar
សំទុះមុំ	Aceleração angular
អាស៊ីហ្គេមឆ្នាំ១៩៧០	Jogos Asiáticos de 1970
កាលប្បវត្តិព្រះពុទ្ធសាសនា	Cronologia do budismo
គោលនយោបាយសារពើពន្ធ	Política orçamental
ឡាហ្គូន	Laguna
Mathew Brady	Mathew Brady
អប់សិន (ហិរញ្ញវត្ថុ)	Mercado de opções
អង្កត់ធ្នូ	Corda (geometria)
អាយុសង្ឃឹម	Esperança de vida
ជំនួយ:Using colours	Ajuda:Usando cores
ខុទ្ទកាល័យ	Conselho de administração
សីដក់	Sepaktakraw
ធនាគារអភិវឌ្ឍន៍អាស៊ី	Banco Asiático de Desenvolvimento
បញ្ជីរដ្ឋមានអាវុធនុយក្លេអ៊ែរ	Países com armamento nuclear
ទីផ្សារអ៊ីធើណែត	Marketing de Internet
សៀវភៅ	O Livro da Selva (literatura)
បារីអេឡិចត្រូនិច	Cigarro eletrônico
Eagles (ក្រុមភ្លេង)	Eagles
កំណើនសេដ្ឋកិច្ច	Crescimento econômico
យន្តសាស្រ្តរថយន្ត	Indústria automobilística
អាឌាម លេមបឺត	Adam Lambert
រូបមន្តដឺម័រ	Fórmula de De Moivre
អនុគមន៍ហ្គាំម៉ា	Função gama
ច្បាប់ប៉ាស្កាល់	Princípio de Pascal
សញ្ញាជាតិបង់ក្លាដែស្ស	Brasão de armas de Bangladesh
នាង​សីតា	Sita
សូរ (​ភាសាសាស្ត្រ​)	Língua tonal
ខ្មែរក្រហម	Khmer Vermelho
ម៉ូឌុល​យ៉ាំង	Módulo de Young
យុន ជីមិ-ហូ	Yun Chi-ho
កែវម៉ាស៊ីនថត	Objectiva (fotografia)
ទីភ្នាក់ងារសារព័ត៌មាន	Agência de notícias
វិគីភីឌាភាសាស្លូវ៉ាគី	Wikipédia em eslovaco
ថេរហ្វារ៉ាដេយ	Constante de Faraday
ប្រវត្តិអ៊ីនធើណេត	História da Internet
ខូប្រា	Copra
ទ្រឹស្តីបទមេនេឡូស	Teorema de Menelaus
អត្ថបទ(ប្រើបា្រស់ភាសា)	Contexto
ជូគ័រលាង	Zhuge Liang
បំលែងឡាប្លាស	Transformada de Laplace
សញ្ញាជាតិតួរគី	Brasão de armas da Turquia
បឹងទន្លេសាប	Tonle Sap
Dassault Mirage 2000	Dassault-Breguet Mirage 2000
ចំនួនអវិជ្ជមាន	Número negativo
សញ្ញាជាតិវៀតណាម	Brasão de armas do Vietname
ខ្មែរ (ជនជាតិ)	Khmers
សញ្ញាជាតិកូរ៉េខាងត្បូង	Brasão de armas da Coreia do Sul
សញ្ញាជាតិឡាវ	Brasão de armas do Laos
សញ្ញាជាតិប៉ាគីស្ថាន	Brasão de armas do Paquistão
Tigranes the Great	Tigranes, o Grande
អាណាចក្រខ្មែរ	Império Khmer
ត្រីពណ៌	Tricolor (vexilologia)
សញ្ញាជាតិប៊្រុយណេ	Brasão de armas do Brunei
រង្វង់ត្រីកោណមាត្រ	Círculo unitário
ចំរៀករង្វង់	Setor circular
អនុគមន៍ដឺក្រេទី៣	Equação cúbica
អនុគមន៍អ៊ីពែបូលីក	Função hiperbólica
ឆាវ ឆាវ	Cao Cao
Sukhoi Su-30	Sukhoi Su-30
កម្មវិធីស្បៀងអាហារពិភពលោក	Programa Alimentar Mundial
រៀល	Riel cambojano
សមុទ្រស្ទើរបិទ	Mar marginal
ច្រកសិង្ហបុរី	Estreito de Singapura
វិគីភីឌាភាសារុស្ស៊ី	Wikipédia em russo
សញ្ញាជាតិអូម៉ង់	Brasão de armas de Omã
ភាសាកម្មវិធី Lua	Lua (linguagem de programação)
សញ្ញាជាតិប៊ូតាន	Brasão de armas do Butão
ភ្លេងជាតិថៃ	Phleng Chat
ព្រះរតនត្រ័យ	Três Jóias
អាហារនៅប្រទេសម៉ិចស៊ិក	Culinária do México
ច្រកឡាប៉េរូស	Estreito de La Pérouse
ខ្នាតកំលាយនៅក្នុងប្រព័ន្ធខ្នាតអន្តរជាតិ	Unidades derivadas do Sistema Internacional
ផ្សារហិរញ្ញវត្ថុ	Mercado financeiro
ញ៉ែ	Flerte
ព្រះឆាយាល័ក្ខកម្ពុជា	Brasão de armas do Camboja
ទិវាអង្គការសហប្រជាជាតិ	Dia das Nações Unidas
ខ្សែទឹកអាត្លង់ទិកខាងជើង	Corrente Norte-Atlântica
ប្រវត្តិសាស្ត្រវៀតណាម	História do Vietname
ខ្សែទឹកខាណារី	Corrente das Canárias
ទ្រឹស្តីបទឆិវ៉ា	Teorema de Ceva
LinkedIn	LinkedIn
បុណ្យវិសាខបូជា	Vesak
ទីក្រុងព្រែកឫស្សី	Can Tho
ជនជាតិចាម	Champa
រីស្ស៉ាត កាពុសស៊ីនស្គី	Ryszard Kapuściński
ប្រវត្តិសាស្ត្រភូមា	História de Myanmar
ស៊ាន ឃីងស្តន	Sean Kingston
កងទ័ពជើងទឹកបារាំង	Marinha Nacional da França
ចំប៉ី	Plumeria
ពហុកីឡាដ្ឋានសុផាចាឡាសៃ	Estádio Suphachalasai
អនុគមន៍បេសែ្សល	Função de Bessel
លោក អាប់ឌូ ឌីអោហ្វ	Abdou Diouf
វិធីហ្វៃណៃថ៍អ៊េលម៉ិន	Método dos elementos finitos
ច្បាប់អគ្គីសនីវិភាគរបស់ហ្វារ៉ាដេយ	Lei de Faraday da eletrólise
ខេត្តព្រះសីហនុ	Sihanoukville
មានប្រ	Anggun
ប្រហុក	Prahok
ដុនបូស្កូសាឡេស៊ាន្ត	Salesianos
ខ្នាតគោលនៅក្នុងប្រព័ន្ធខ្នាតអន្តរជាតិ	Unidades básicas do SI
អង្គរធំ	Angkor Thom
Kara	Kara
១៤១	Cento e quarenta e um
ព្រះបាទសុទ្ធោទន	Suddhodana
ប្រទេសនៅអឺរ៉ុប	Lista de Estados soberanos e territórios dependentes da Europa
វិទ្យុសម្លេងសហរដ្ឋអាមេរិក	Voz da América
ជេឃ្វីរី	JQuery
ទិវាពិភពលោកគ្មានថ្នាំជក់	Dia Mundial Sem Tabaco
គម្ពីរបញ្ចតន្ត្រ	Panchatantra
មេដ្យាន	Mediana (geometria)
ផ្លាយ អាស់	Cinzas volantes
T-80	T-80
សញ្ញាជាតិកាតារ	Brasão de armas do Catar
សញ្ញាយ៉ាកូប៊ី	Símbolo de Jacobi
សត្វព្រៃ	Vida selvagem
មីហ៊្គោ	MeeGo
វិភាគចិត្តវិទ្យា	Psicologia analítica
លីវ ប៉ី	Liu Bei
កិច្ចព្រមព្រៀងពាណិជ្ជកម្ម	Acordo comercial
ម៉ាត្សឹស៊ីតា ខូណុស្កិ	Konosuke Matsushita
សង្គ្រាមគ្រីមៀ	Guerra da Crimeia
នាវាចរណ៏	Velejador
Pinterest	Pinterest
អាស៊ីហ្គេមឆ្នាំ១៩៦២	Jogos Asiáticos de 1962
ភ្នំសេមេរូ	Monte Semeru
កោះសមុយ	Ko Samui
ថវិការដ្ឋាភិបាល	Orçamento de Estado
អាំងតេក្រាលដោយផ្នែក	Integração por partes
ផ្សោតក្បាលត្រឡោក	Golfinho-do-irrawaddy
Near Field Communication	Near Field Communication
ហិរញ្ញវត្ថុសាធារណៈ	Finanças públicas
កប៉ាល់ ជួង	Sino de navio
សាលាសំណាក់	Pavilhão
១៤៨	Cento e quarenta e oito
OSM	OSM
ប្រមោញ	Atherurus macrourus
ខេត្តសាឡៈវ៉ាន់	Saravane (província)
WikiHow	WikiHow
ទិន្នន័យបើកចំហ	Dados abertos
ទិន ហ្វី	Stephen Chow
ហាំង ង៉ោ	Haing S. Ngor
ព្រះបាទសូរ្យវរ្ម័នទី២	Suryavarman II
ហិនរី វីលសុន	Henry Wilson
ហុងដា សូអ៊ិជិរ៉ូ	Soichiro Honda
ស៊ុន ឈាន	Sun Quan
ឆាវ ភី	Cao Pi
ម៉ាស៊ីនថតវីឌីអូ	Câmera de vídeo
សមុទ្រកូរ៉ូ	Mar de Koro
ពិម្ពិសារ	Bimbisara
ដូមីនិក សាវីយ៉ូ	Domingos Sávio (santo católico)
ក្រុមបាល់ទាត់ជម្រើសជាតិកម្ពុជា	Seleção Cambojana de Futebol
Seo Jae-pil	Philip Jaisohn
ព្រះសារីបុត្រ	Shariputra
ទ្រឹស្តីបទគ្រីន	Teorema de Green
ប្រាសាទអូសាកា	Castelo de Osaka
ការប្រើប្រាស់ភាសា	Linguística aplicada
គោព្រៃ	Bos sauveli
VCD	VCD
ថ្ងៃបាស់ស្ទីល	Festa nacional francesa
កម្ពុជាប្រជាធិបតេយ្យ	Kampuchea Democrático
ស៊ុនធិ បុណ្យ រ័តក្លិន	Sonthi Boonyaratglin
ខេត្តផុងសាលី	Phongsali (província)
ខេត្តបកែវ	Bokeo
ខេត្តចំប៉ាសក្តិ	Champassak
កិលេស	Paixão (sentimento)
ព្រះបាទជ័យវរ្ម័នទី៧	Jayavarman VII
កាំង ហ្កិច អ៊ាវ	Kang Kek Iev
ស៊ឺ ម៉ាអ៉ី	Sima Yi
ប្រវត្តិសាស្រ្តនៃរូបថត	História da fotografia
ឋានន្តរសក្ដិរាជវង្សនិងអភិជន	Título nobiliárquico
ក្រុមហ៊ុនអាកាសចរណ៍ជាតិ កម្ពុជាអង្គរអ៊ែរ	Cambodia Angkor Air
កីឡាឧបទ្វីបអាស៊ីអាគ្នេយ៍លើកទី៥	Jogos Peninsulares do Sudeste Asiático de 1969
ទ្រឹស្តីបទមេអំបៅ	Teorema da borboleta
កន្ថឹក	Tupaia belangeri
ហេង សំរិន	Heng Samrin
ខៀវ សំផន	Khieu Samphan
ជេកខប រីស	Jacob Riis
ព្យែរ វ៉ារីញ៉ុង	Pierre Varignon
ជយវម៌្មទី៣	Jayavarman II
អជាតសត្តុ	Ajatasatru
បន្ទាត់អយល័រ	Reta de Euler
ប្រវត្តិសាស្ត្រថៃ	História da Tailândia
បុណ្យសែនព្រះខែ	Festival da Lua
មហាមោគ្គលាន	Mahamoggallana
ប្រេម ទីនសូឡានុន្ទ	Prem Tinsulanonda
គុណកិរិយា	Advérbio
ឌីណាមិក HTML	DHTML
កុំផ្លិចឆ្លាស់	Conjugado de um número complexo
ការកើនឡើងនៃចំនួនប្រជាជននៅលើពិភពលោក	Crescimento populacional
ស៊ីហ្គេមលើកទី៩	Jogos do Sudeste Asiático de 1977
ប្រវត្តិសាស្ត្រលាវ	História do Laos
ព្រះបរមរាជវាំង	Palácio Real de Phnom Penh
តារាងអាំងតេក្រាល	Tábua de integrais
បន្ទាត់សេកង់	Reta secante
សម្ដេចប៉ាបហ្វ្រង់សូ័រ	Papa Francisco
ទ្រឹស្តីបទតូលេមី	Teorema de Ptolomeu
Regional Internet registry	Registro Regional da Internet
គុណវិបត្តិនៃការជក់បារី	Tabagismo e saúde
ខ្វែងជ័យបុរី	Sayaburi
ខ្វែងជើងខ្វែង	Xieng Khouang
ខេត្តឧត្តមជ័យ	Oudomxai
ខេត្តកោះកុង	Koh Kong
ខេត្តកណ្ដាល	Kandal
ម៉ារី ដូមីនិក ម៉ាសារីលូ	Maria Mazzarello
ព្រះនាងយសោធរា	Yashodhara
អនុគមន៍បែតា	Função beta
ទ្រឹស្តីបទតង់សង់	Lei das tangentes
ឌិត ប្រន	Dith Pran
មធ្យមនព្វន្ធ-ធរណីមាត្រ	Média aritmética-geométrica
កូម៌ៈ	Kurma
អាស៊ីហ្គេមឆ្នាំ១៩៧៤	Jogos Asiáticos de 1974
អាកាសយានដ្ឋានអន្តរជាតិតានសូនណាត្ត	Aeroporto Internacional Tan Son Nhat
KAI T-50 Golden Eagle	KAI T-50 Golden Eagle
ឧបទ្វីបកូរ៉េ	Península da Coreia
វីគីប្រជុំ	Wikimania
អាស៊ីហ្គេម	Jogos Asiáticos
ទង់ជាតិសិង្ហបុរី	Bandeira de Singapura
បង្អួចឆ្នាំ 2000	Windows 2000
តារាងអាំងតេក្រាលនៃអនុគមន៍សនិទាន	Lista de integrais de funções racionais
សមីការដឺក្រេទី១	Equação linear
សញ្ញាជាតិអាហ្វហ្គានីស្ថាន	Brasão de armas do Afeganistão
E-commerce	Comércio eletrônico
Sukhoi Superjet 100	Sukhoi Superjet 100
អ្នក​មាន​ជាង​គេ​លើ​ពិភពលោក	Listas de bilionários
គណកម្មាធិការអូឡាំពិកកូរ៉េ	Comitê Olímpico da Coreia do Sul
កីឡាអាស៊ីខាងកើតឆ្នាំ១៩៩៧	Jogos da Ásia Oriental de 1997
ច្រកខាន់ម៉ុង	Estreito de Kanmon
អាស៊ីហ្គេមឆ្នាំ២០០២	Jogos Asiáticos de 2002
ឆកសមុទ្រលាវតុង	Baía de Liaodong
T-ARA	T-ara
អាស៊ីហ្គេមឆ្នាំ១៩៨៦	Jogos Asiáticos de 1986
អាណាស្រុកម៉ូបាល (អាល់ឡាបាម៉ា)	Condado de Mobile
កូរ៉េ	Educação na Coreia do Sul
ម្កាក់	Cajá-manga
បារខែម	BarCamp
ខេត្តកំពង់ធំ	Kampong Thom (província)
ខេត្តព្រះវិហារ	Preah Vihear
ខេត្ត ហួ ផាន់	Houaphanh
ខ្វែងអាចម៍ក្រពើ	Attapeu (província)
បញ្ជីទីក្រុងនិងទីប្រជុំជននៅកម្ពុជា	Lista de cidades no Camboja
ខេត្តខាំមួន	Khammouane
ខេត្តប៉ៃលិន	Pailin
ឆាយាលក្សសារព័ត៌មាន	Fotojornalismo
ឧទ្យានជាតិភ្នំគូលែន	Parque nacional Phnom Kulen
បារីសង់	Centroide
ក្រុមបាល់ទាត់ជម្រើសជាតិ កូរ៉េខាងត្បូង	Seleção Sul-Coreana de Futebol
គោលនយោបាយសាធារណៈ	Política pública
ឆកសមុទ្រចាការតា	Baía de Jacarta
Xian MA60	Xian MA60
ប្រមា	Hystrix brachyura
ភូមិសាស្រ្ដនៃប្រទេសកម្ពុជា	Geografia do Camboja
នរោត្តម	Norodom I
ម៉ាសែលលីន ចាមប៉ាញេត	Marcellin Champagnat
អេដូអារដូ អាម៉ាល់ឌី	Edoardo Amaldi
វេយ្យាករណ៍អង់គ្លេស	Gramática da língua inglesa
ស៊ីឡាត	Silat
ទ្រឹស្តីបទវ្យែត	Fórmulas de Viète
តារាងអាំងតេក្រាលនៃអនុគមន៍អិចស្ប៉ូណង់ស្យែល	Lista de integrais de funções exponenciais
តារាងអាំងតេក្រាលនៃអនុគមន៍អសនិទាន	Lista de integrais de funções irracionais
តារាងអាំងតេក្រាលនៃអនុគមន៍លោការីត	Lista de integrais de funções logarítmicas
អាំងតេក្រាលហ្វ្រេនែល	Integral de Fresnel
គោលនយោបាយសេដ្ឋកិច្ច	Política econômica
ប្រាសាទភិមានអាកាស	Phimeanakas
ប្រាសាទតាព្រហ្ម	Ta Prohm
អាជ្ញាធរអន្តរកាលសហប្រជាជាតិនៅកម្ពុជា	Autoridade Provisória das Nações Unidas no Camboja
អាំងតេក្រាលផ្ទៃ	Integral de superfície
ប្រាសាទបន្ទាយក្តី	Banteay Kdei
ក្រុងសំរោង	Samraong
រួបថតនៅក្នុងសង្គ្រាម	Fotografia de guerra
ខេត្តតាកែវ	Takéo (província)
ខេត្តហ៊ីរ៉ូស៊ីម៉ា	Província de Hiroshima
បន្ទប់រៀន	Sala de aula
សេដ្ឋកិច្ចកម្ពុជា	Economia do Camboja
ជំរំជនភៀសខ្លួន	Campo de refugiados
ខេត្តឧត្ដរមានជ័យ	Oddar Mean Cheay
ប្រភេទស្រាទំពាំងបាយជូរពីប្រទេសបារាំង	Vinhos da França
អុក	Makruk
បទនគររាជ	Nokoreach
នគររាជសីមា	Nakhon Ratchasima
ចំនួនអាកស៊ីម៉ែដ	Número de Arquimedes
សង្គ្រាមកម្ពុជា-វៀតណាម	Guerra cambojana-vietnamita
អនុគមន៍អ៊ីពែបូលីកច្រាស់	Função hiperbólica inversa
កីឡាចុងបូព៌ាឆ្នាំ១៩២៥	Jogos do Extremo Oriente de 1925
១៥០	Cento e cinquenta
ទ្រឹស្តីបទពីក	Teorema de Pick
ខេត្តសៀមរាប	Siem Reap (província)
ខេត្តមណ្ឌលគិរី	Mondul Kiri
ខេត្តកំពង់ស្ពឺ	Kampong Speu (província)
ប្រាសាទបាយ័ន	Bayon
អុនសេន	Onsen
ឧត្តមស្នងការអង្គការសហប្រជាជាតិទទួលបន្ទុកសិទ្ធិមនុស្ស	Escritório do Alto Comissário das Nações Unidas para os Direitos Humanos
ត្រីតុកកែជ្រូក	Cromileptes altivelis
ជាតក	Jataka
អនុគមន៍ត្រីកោណមាត្រច្រាស់	Funções trigonométricas inversas
ប្រវត្តិសាស្ត្រខ្មែរ	História do Camboja
ម៉ាជូ ពីជូ	Machu Picchu
គណនីធនាគារ	Conta bancária
ខ្សែទឹកប្រេស៊ីល	Corrente do Brasil
ក្រុមអសនិក (អាកាសចរណ៍)	Esquadrilha
ត្រកៀតប៉ោង	Eichhornia crassipes
ជ្រោយណុតុ	Península de Noto
ចតុកោណចារឹកក្នុងរង្វង់	Quadrilátero cíclico
១៣៨	Cento e trinta e oito
គីឡូម៉ែត្រការ៉េ	Quilómetro quadrado
ចេននី រីវឺរ៉ា	Jenni Rivera
ពហុកោណនិយ័ត	Polígono regular
ប្រទេសនៅអាស៊ី	Lista de Estados soberanos e territórios dependentes da Ásia
១៤៤	Cento e quarenta e quatro
១៤០	Cento e quarenta
១៤៣	Cento e quarenta e três
១៤៧	Cento e quarenta e sete
១៤៦	Cento e quarenta e seis
១៤៩	Cento e quarenta e nove
១៤២	Cento e quarenta e dois
១៣៩	Cento e trinta e nove
១៤៥	Cento e quarenta e cinco
ប្រទេសមួយ ប្រព័ន្ធពីរ	Um país, dois sistemas
ត្រកៀត	Pontederiaceae
អាស៊ីហ្គេមឆ្នាំ១៩៥៤	Jogos Asiáticos de 1954
អាស៊ីហ្គេមឆ្នាំ១៩៥៨	Jogos Asiáticos de 1958
អាស៊ីហ្គេមឆ្នាំ១៩៦៦	Jogos Asiáticos de 1966
អាស៊ីហ្គេមឆ្នាំ១៩៧៨	Jogos Asiáticos de 1978
អាស៊ីហ្គេមឆ្នាំ១៩៨២	Jogos Asiáticos de 1982
អាស៊ីហ្គេមឆ្នាំ១៩៩០	Jogos Asiáticos de 1990
អាស៊ីហ្គេមឆ្នាំ១៩៩៤	Jogos Asiáticos de 1994
អាស៊ីហ្គេមឆ្នាំ១៩៩៨	Jogos Asiáticos de 1998
ច្រកចូហរ	Estreitos de Johor
ព្រះសង្ឃ	Monge
ត្រីរាជ	Peixe-gato-gigante
ទ្រឹស្តីបទស្តេអាត	Teorema de Stewart
Yeghishe Charents	Yeghishe Charents
ភាពលំអៀង	Viés
ខេត្តរតនគិរី	Ratanakiri
បញ្ចក្ខន្ធ	Cinco agregados
Gloomy Sunday	Szomorú Vasárnap
ខេត្តហ្លួងព្រះបាង	Luang Prabang (província)
ខេត្តកំពត	Kampot
សង្គ្រាមឥណ្ឌូចិនលើកទី១	Primeira Guerra da Indochina
ខេត្តស្វាយរៀង	Svay Rieng (província)
សង្គាយនា	Concílios budistas
ISO 9362	Bank Identifier Code
ប៉ាកាយ៉ា	Pacaya
ខ្លែងប្រម៉ង់	Microhierax caerulescens
ទ្រឹស្ដីបទការ៉េទាំង៤របស់ឡាហ្គ្រង់	Teorema de Fermat-Lagrange
សុត្តន្តបិដក	Sutta Pitaka
ខេត្តអូគីណាវ៉ា	Okinawa
គណបក្សប្រជាជនកម្ពុជា	Partido Popular de Camboja
អាស៊ីខាងត្បូង	Ásia Meridional
កំណាត់រង្វង់	Segmento circular
ខេត្តក្រចេះ	Kratié
ប្រាសាទបក្សីចាំក្រុង	Baksei Chamkrong
សមីការឌីផេរ៉ង់ស្យែលប៊ែរនូយី	Equação diferencial de Bernoulli
កណ្ដុរភ្នំ	Rhizomys
ខេត្តបាត់ដំបង	Battambang (província)
តំបន់ត្រីកោណមាស	Triângulo Dourado
សង្គ្រាមផ្ទៃក្នុងកម្ពុជា	Guerra Civil do Camboja
ESET	Eset
អាស៊ីហ្គេមរដូវរងារ	Jogos Asiáticos de Inverno
ក្រុងយ៉ាណៃ	Yanai
កុសិនារា	Kushinagar
KM	Quilômetro
BRIC	BRIC
បញ្ជីព្រះមហាក្សត្រកម្ពុជា	Lista de reis do Camboja
ផ្លូវកណ្ដាល	Caminho do Meio
ជម្រើសអ្នកប្រើប្រាស់	Teoria do consumidor
ខេត្តពោធិ៍សាត់	Pursat (província)
វិស័យអប់រំនៅប្រទេសជប៉ុន	Educação no Japão
ខេត្តស្ទឹងត្រែង	Stung Treng
ប្រព័ន្ធគោល	Base (aritmética)
ក្រុមប្រឹក្សាអូឡាំពិកអាស៊ី	Conselho Olímpico da Ásia
McDonnell Douglas F-15E Strike Eagle	F-15E Strike Eagle
តារាងអាំងតេក្រាលនៃអនុគមន៍ត្រីកោណមាត្រ	Lista de integrais de funções trigonométricas
ច្រកកាលីម៉ាតា	Estreito de Karimata
បញ្ជី ប្រទេស មានចំនួនអ្នកអានសៀវភៅ	Lista de países por índice de alfabetização
សារមន្ទីរទួលស្លែង	Tuol Sleng
ខេត្តកែប	Keb
ទ្រឹស្តីបទវីវីអានី	Teorema de Viviani
បញ្ជីអ្នកទទួលបានជ័យលាភីណូបែលខាងរូបវិទ្យា	Laureados com o Nobel de Física
VietJet Air	VietJet Air
ក្រុងសិរីសោភ័ណ	Sisophon
ក្រុងកំពង់ចាម	Kampong Cham
សាកលវិទ្យាល័យ ចុឡាលុងករណ៍	Universidade de Chulalongkorn
Gallery of dependent territory flags	Bandeiras de territórios dependentes
អនុគមន៍ស៊ីនុសកាឌីណាល់	Função sinc
ខេត្តព្រៃវែង	Prey Veng (província)
បញ្ជីរាយនាម សេដ្ឋវិទូ	Lista de economistas
កប្ប	Kalpa (aeon)
សាធារណរដ្ឋប្រជាមានិតកម្ពុជា	República Popular do Kampuchea
នគរវ្នំ	Reino de Funan
ក្រុងកំពត	Kampot (cidade)
ខេត្តកំពង់ឆ្នាំង	Kampong Chhnang (província)
ស៊ីហ្គេម	Jogos do Sudeste Asiático
ISO 3166-3	ISO 3166-3
បាល់ទាត់កញ្ចុំផ្កាយ	Galactik Football
ការ​បញ្ចាំង​ស្លាយ	Diaporama
វីគីភីឌាភាសាខ្មែរ	Composto orgânico volátil
ប្រទេសនៅអាមេរិកខាងត្បូង	Lista de países da América do Sul
ចំប៉ីសៀម	Rosa-do-deserto
ជំនួយ:មាតិកា	Ajuda:Página principal
ស៊ីហ្គេមលើកទី២៣	Jogos do Sudeste Asiático de 2005
ច្បាប់ប្រលេឡូក្រាម	Regra do paralelogramo
មីក្រូម៉ែត្រការ៉េ	Ordens de magnitude (área)
ព្រៃវែង	Prey Veng
ធនធានដែលមិនកកើតឡើងវិញ	Recurso não renovável
ស៊ីហ្គេមលើកទី១១	Jogos do Sudeste Asiático de 1981
ជួរភ្នំដងរែក	Montes Dângrêk
ប្រាសាទព្រះខ័ន	Preah Khan
ភ្នំគូលេន	Phnom Kulen
ទីភ្នាក់ងារសហប្រតិបត្តិការអន្តរជាតិជប៉ុន	Agência de Cooperação Internacional do Japão
ស្វាកន្ទុយស	Pygathrix nigripes
ស៊ីហ្គេមលើកទី២១	Jogos do Sudeste Asiático de 2001
ប្រដាល់សេរី	Pradal Serey
សុន សេន	Son Sen
គណកម្មាធិការអូឡាំពិកជប៉ុន	Comitê Olímpico Japonês
ចំនួនតេត្រាអែក	Número tetraédrico
ក្រុងកំពង់ធំ	Kampong Thom
អង់រីកូ ពែរស៊ីកូ	Enrico Persico
ព្រះពុទ្ធសាសនា​នៅ​ស្រីលង្កា	Budismo no Sri Lanka
ចំណុចរំពុះ	Ponto de ebulição
Coats of arms of dependent territories	Brasões de territórios dependentes
តារាងលីមីត	Lista de limites
វិសមភាពភីដូ	Desigualdade de Pedoe
ក្រុងកំពង់ឆ្នាំង	Kampong Chhnang
ត្រៃលក្ខណ៍	Três marcas da existência
អាកាសយានដ្ឋានអន្តរជាតិភ្នំពេញ	Aeroporto Internacional de Phnom Penh
វិសមភាពហាតវីហ្គឺហ្វីនស្លឺ	Desigualdade de Hadwiger–Finsler
ព្រះនិព្វាន៤ថ្នាក់	Quatro Estágios da Iluminação
សាធារណរដ្ឋខ្មែរ	República Khmer
អាកាសយានដ្ឋានអន្តរជាតិសៀមរាបអង្គរ	Aeroporto Internacional de Siem Reap
បច្ចេកវិទ្យាសារពត៌មាន	Jornalismo online
ក្មេងទំនើង	Delinquência juvenil
ចេនឡា	Reino Chenla
ស្ដេចចក្រពត្តិ	Chakravartin
តថាគត	Tathagata
អាំងតេក្រាលប្តូរអថេរ	Integração por substituição
កម្មវីធីសូនីវីហ្គាស	Sony Vegas Pro
ស៊ីហ្គេមលើកទី២៥	Jogos do Sudeste Asiático de 2009
ខ្សែទឹកអេក្វាទ័រខាងត្បូង	Corrente Sul Equatorial
សិក្ខាបទ៥	Cinco preceitos (budismo)
ការប្រកួតកីឡាជើងឯកចុងបូព៌ា	Jogos do Extremo Oriente
កងទ័ពអេហ្ស៊ីប	Forças Armadas do Egito
តារាងដេរីវេ	Tabela de derivadas
មេកានិច​សូលីដ	Mecânica dos sólidos
ការប្រកួតកីឡា កម្ពុជា	Campeonato Cambojano de Futebol
CAIC Z-10	CAIC Z-10
អាំងតេក្រាលត្រីកោណមាត្រ	Integral trigonométrica
សមីការឌីផេរ៉ងស្យែលក្លែរ៉ូ	Equação de Clairaut
សាសនា សកល	Simbolismo religioso
ទង់ព្រះពុទ្ធសាសនា	Bandeira Budista
ISO 3166-1 alpha-2	ISO 3166-1 alfa-2
តំបន់អឌ្ឍច័ន្ទមាស	Crescente Dourado
សហរដ្ឋ	União política
អាស៊ីហ្គេមលើឆ្នេរខ្សាច់	Jogos Asiáticos de Praia
បណ្ឌិត្យ​សភា​នីតិ​អន្តរជាតិ​នៃ​ទីក្រុង​ឡាអេ	Academia de Direito Internacional de Haia
ស៊ីហ្គេមលើកទី២៦	Jogos do Sudeste Asiático de 2011
ប្រពលវប្បកម្ម	Agricultura intensiva
មុំក្នុង	Ângulo interno
ផលបូក រីម៉ាន	Soma de Riemann
ផ្នែកពិត	Parte real
កីឡាអាស៊ីខាងកើតឆ្នាំ១៩៩៣	Jogos da Ásia Oriental de 1993
វិសមភាព វេតស្សឹនបុក	Desigualdade de Weitzenböck
កីឡាអាស៊ីខាងកើត	Jogos da Ásia Oriental
ស៊ីហ្គេមលើកទី២០	Jogos do Sudeste Asiático de 1999
បុណ្យ តារា	Tanabata
ក្រុងតាកែវ	Takéo
សមីការកូស៊ី-អយល័រ	Equação de Euler-Cauchy
ស្ពានខាន់ម៉ុងក្យូ	Ponte Kanmon
កីឡាអាស៊ីខាងត្បូង	Jogos Sul-Asiáticos
វិគីភីឌា:ស្ថានទូតខ្មែរ	Wikipédia:Embaixada
Bottleneck	Ponto de estrangulamento
ស៊ីហ្គេមលើកទី១៩	Jogos do Sudeste Asiático de 1997
ស៊ីហ្គេមលើកទី២៧	Jogos do Sudeste Asiático de 2013
ស៊ីហ្គេមលើកទី១៧	Jogos do Sudeste Asiático de 1993
ស៊ីហ្គេមលើកទី១០	Jogos do Sudeste Asiático de 1979
ស៊ីហ្គេមលើកទី២៤	Jogos do Sudeste Asiático de 2007
ស៊ីហ្គេមលើកទី១៤	Jogos do Sudeste Asiático de 1987
កីឡាចុងបូព៌ាឆ្នាំ១៩១៧	Jogos do Extremo Oriente de 1917
ទីឃនិកាយ	Digha Nikaya
ហ្វ្រង់កូ រ៉ាសិតទី	Franco Rasetti
ខ្សែទឹករង្វល់របស់មហាសមុទ្រ	Giro oceânico
កូស៊ីនុសអ៊ីពែបូលីក	Cosseno hiperbólico
កូស៊ីនុស	Cosseno
វិទ្យុតាមអ៊ីនធើណែត	Rádio digital
តង់សង់អ៊ីពែបូលីក	Tangente hiperbólica
ស៊ីនុសអ៊ីពែបូលីក	Seno hiperbólico
កីឡាឧបទ្វីបអាស៊ីអាគ្នេយ៍លើកទី៣	Jogos Peninsulares do Sudeste Asiático de 1965
កីឡាឧបទ្វីបអាស៊ីអាគ្នេយ៍លើកទី៤	Jogos Peninsulares do Sudeste Asiático de 1967
កីឡាឧបទ្វីបអាស៊ីអាគ្នេយ៍លើកទី៦	Jogos Peninsulares do Sudeste Asiático de 1971
កីឡាឧបទ្វីបអាស៊ីអាគ្នេយ៍លើកទី៨	Jogos Peninsulares do Sudeste Asiático de 1975
វិសមភាពស្យ៉ឺរ	Desigualdade de Schur
អនុគមន៍ហ្គុឌែរម៉ាន់	Função gudermanniana
វិធីសាស្រ្តហ្រ្វូបេនៀស	Método de Frobenius
ផ្នែកនិម្មិត	Parte imaginária
ចន វ៉នណុក	John Warnock
មួយម៉ូនីកា	Agnes Monica
Candies	Candies
កីឡាឧបទ្វីបអាស៊ីអាគ្នេយ៍លើកទី១	Jogos Peninsulares do Sudeste Asiático de 1959
កីឡាអាស៊ីកណ្ដាល	Jogos Centro-Asiáticos
កីឡាអាស៊ីខាងកើតឆ្នាំ២០០៥	Jogos da Ásia Oriental de 2005
កីឡាឧបទ្វីបអាស៊ីអាគ្នេយ៍លើកទី២	Jogos Peninsulares do Sudeste Asiático de 1961
ស៊ីហ្គេមលើកទី១៦	Jogos do Sudeste Asiático de 1991
ស៊ីហ្គេមលើកទី១៥	Jogos do Sudeste Asiático de 1989
ស៊ីហ្គេមលើកទី១៨	Jogos do Sudeste Asiático de 1995
កីឡាឧបទ្វីបអាស៊ីអាគ្នេយ៍លើកទី៧	Jogos Peninsulares do Sudeste Asiático de 1973
កីឡាអាស៊ីខាងកើតឆ្នាំ២០០១	Jogos da Ásia Oriental de 2001
ខ្មែរក្រោម	Khmer Krom
ស៊ីហ្គេមលើកទី២២	Jogos do Sudeste Asiático de 2003
ស៊ីហ្គេមលើកទី១៣	Jogos do Sudeste Asiático de 1985
ស៊ីហ្គេមលើកទី១២	Jogos do Sudeste Asiático de 1983
កីឡាចុងបូព៌ាឆ្នាំ១៩១៥	Jogos do Extremo Oriente de 1915
កីឡាចុងបូព៌ាឆ្នាំ១៩១៣	Jogos do Extremo Oriente de 1913
ស្រុកព្រះនេត្រព្រះ	Preah Netr Preah
ESET NOD32 Antivirus	NOD32
វិគីភីឌា:Glossary	Wikipédia:Glossário
ចំណាត់ថ្នាក់ក្រុម:ប្រទេសជប៉ុន	Categoria:Japão
ចំណាត់ថ្នាក់ក្រុម:ម៉ិកសិច	Categoria:México
ចំណាត់ថ្នាក់ក្រុម:ឥណ្ឌូនេស៊ី	Categoria:Indonésia
ចំណាត់ថ្នាក់ក្រុម:សិង្ហបុរី	Categoria:Singapura
ចំណាត់ថ្នាក់ក្រុម:រូបវិទ្យា	Categoria:Física
ចំណាត់ថ្នាក់ក្រុម:វិទ្យាសាស្រ្តធម្មជាតិ	Categoria:Ciências naturais
ចំណាត់ថ្នាក់ក្រុម:ជីវវិទ្យា	Categoria:Biologia
ចំណាត់ថ្នាក់ក្រុម:សាសនា	Categoria:Religião
ចំណាត់ថ្នាក់ក្រុម:កីឡា	Categoria:Desportos
ចំណាត់ថ្នាក់ក្រុម:វិទ្យាសាស្ត្រ	Categoria:Ciência
ប្រជាមតិទាក់ទងនឹងឯករាជភាពរបស់ស្កុតឡែនឆ្នំា២០១៤	Referendo sobre a independência da Escócia em 2014
សំយោជនៈ	Renascimento (budismo)
សាសនាក្នុងប្រទេសចិន	Religião na China
G8+5	G8+5
Honda HA-420 HondaJet	Honda HA-420 HondaJet
ទ្រឹស្ដីនៃពណ៌	Teoria das cores
នើនដូ	Steinberg Nuendo
អង្គាបុស្ប	Millingtonia
ស្ដង់ដា	Standard
ចំនុចកណ្ដាល	Ponto médio
ទំព័រគំរូ:Dts	Predefinição:Dts
ទីក្រុងរ៉ូមបុរាណ	Roma Antiga
ទំព័រគំរូ:Box-footer	Predefinição:Box-footer
កន្ថឹកក្បាលឆ្នូត	Dendrogale murina
អាស៊ីហ្គេមអ៊ីនដរ	Jogos Asiáticos em Recinto Coberto
អាំងតេក្រាលមាឌ	Integral de volume
ការវាយប្រហារដែនអាកាសនៅទីក្រុងបេកដាត ថ្ងៃទី ១២ កក្តដា ២០០៧	Ataque aéreo em Bagdá de 12 de julho de 2007
សញ្ញាណលោការីត	Identidades logarítmicas
អាគីតា	Akita (desambiguação)
ទ្រឹស្ដីបទវ៉ារីញ៉ុង	Teorema de Varignon (geometria)
កូវែស៊ីនុស	Cosseno verso
ចំណាយរដ្ឋាភិបាល	Despesa pública
អ្នកសារពត័មាន	Repórter
ប៉ែន សុវណ្ណ	Pen Sovan
ស្រុកមង្គលបុរី	Mongkol Borey
ក្រុងតាខ្មៅ	Ta Khmau
ចំណាត់ថ្នាក់ក្រុម:អូឡាំពិក	Categoria:Jogos Olímpicos
ចំណាត់ថ្នាក់ក្រុម:ព្រះពុទ្ធសាសនា	Categoria:Budismo
វប្បធម៍បារាំង	Cultura da França
ប្រទេសនៅអាមេរិកខាងជើង	Lista de países da América do Norte
បញ្ជីឈ្មោះអនុគមន៍គណិតវិទ្យា	Lista de funções matemáticas
ស្ថានីយទូរទស្សន៍	Canal de televisão
សាលាសាធារណៈឡូវែល	Escolas Públicas de Lowell
ជំងឺរលាកបំពង់ក	Faringite
ទេសចរបារាំង	Turismo na França
កម្ពុជាសម័យលង្វែក	Lovek
អាកាសយានដ្ឋានអន្តរជាតិក្រុងព្រះសីហនុ	Aeroporto Internacional de Sihanoukville
អង្គការសង្គមអភិរក្សសត្វព្រៃ	Wildlife Conservation Society
ស្រុកមេមត់	Memot
ឧទ្យានជាតិវីរៈជ័យ	Parque Nacional Viracheyn
ទំព័រគំរូ:Lang-ta	Predefinição:Lang-ta
ស៊ុកូឡា	História do chocolate na Espanha
ខេត្តបលិខាំសៃ	Borikhamxai
សោតទស្សន៏	Audiovisual
ភ្នំឧដុង្គ	Oudong
អនុស័យ​	Anasuya
ស្ថាបត្យករខ្មែរ	Arquitetura Khmer
អភិញ្ញា៦	Abhijna
ចំនួនថេរត្រីកោណមាត្រពិត	Constantes trigonométricas exatas
ព្រះរាជាណាចក្រកម្ពុជា (១៩៥៣-១៩៧០)	Reino do Camboja (1953-1970)
សមីការតូរីចេល្លី	Equação de Torricelli
កីឡាចុងបូព៌ាឆ្នាំ១៩១៩	Jogos do Extremo Oriente de 1919
កីឡាចុងបូព៌ាឆ្នាំ១៩២១	Jogos do Extremo Oriente de 1921
ច្បាប់នៃកម្ម	Carma no budismo
កីឡាចុងបូព៌ាឆ្នាំ១៩៣០	Jogos do Extremo Oriente de 1930
កីឡាចុងបូព៌ាឆ្នាំ១៩២៧	Jogos do Extremo Oriente de 1927
កីឡាចុងបូព៌ាឆ្នាំ១៩២៣	Jogos do Extremo Oriente de 1923
កីឡាចុងបូព៌ាឆ្នាំ១៩៣៤	Jogos do Extremo Oriente de 1934
WNBT	WNBC
កត្តាអាំងតេក្រាល	Fator integrante
រដ្ឋាភិបាលចម្រុះកម្ពុជាប្រជាធិបតេយ្យ	Governo de Coalizão da Kampuchea Democrática
សញ្ញាជាតិរបស់បណ្ដាប្រជាជាតិនៅអាស៊ី	Brasões de armas da Ásia
ព្រហ្មជាលសូត្រ	Brahmajala Sutta
ចំណាត់ថ្នាក់ក្រុម:អត្ថបទខ្លីមិនពេញលេញ	Categoria:!Esboços
ចំណាត់ថ្នាក់ក្រុម:ទ្វីប	Categoria:Continentes
ចំណាត់ថ្នាក់ក្រុម:ភូមិវិទ្យា	Categoria:Geologia
ឆាលេស ហ្គេសស្គី	Charles Geschke
យុទ្ធនាការកម្ពុជា	Campanha do Camboja
កម្ពុជាសម័យអាណានិគមបារាំង	Protetorado Francês do Camboja
ទំព័រគំរូ:ប្រព័ន្ធព្រះអាទិត្យ	Predefinição:Sistema Solar
វិគីភីឌា:សារ ទំព័រគំរូ/លំហឈ្មោះ ការពិភាក្សារបស់អ្នកប្រើប្រាស់	Wikipédia:Lista de predefinições/Mensagens para usuários
ដេរីវេនៃអនុគមន៍ត្រីកោណមាត្រ	Diferenciação de funções trigonométricas
សេដ្ឋកិច្ចគ្រប់គ្រង	Economia gerencial
អនុរុទ្ធ	Anuruddha
ស្រុកភ្នំស្រុក	Phnum Srok
ពីរ៉ាមីត	Pirâmide
ការគ្រប់គ្រងរបស់ខ្មែរក្រហមនៅកម្ពុជា	Regime do Khmer Vermelho
ពន្ធតែមប្រិ៍	Imposto do selo
ជំនួយ:ការកត់ឈ្មោះចូល	Ajuda:Guia de edição/Como criar uma conta
វិគីភីឌាភាសាខ្មែរ	Wikipédia em khmer
កន្លះបរិមាត្រ	Semiperímetro
សាកលវិទ្យាល័យ ន័រតុន	Universidade Norton
គ្រោះមហន្តរាយ	Desastre
ទំព័រគំរូ:Authority control	Predefinição:Controle de autoridade
ទំព័រគំរូ:Quote	Predefinição:Quote
ទំព័រគំរូ:Wikipedia languages	Predefinição:Wikipédia em outras línguas
ទំព័រគំរូ:Location map Scotland	Predefinição:Mapa de localização/Escócia
ទំព័រគំរូ:Location map England	Predefinição:Mapa de localização/Inglaterra
ចំណាត់ថ្នាក់ក្រុម:សេដ្ឋកិច្ច	Categoria:Economia
វិគីភីឌា:សុំប្តូរអត្តនាម	Wikipédia:Renomeação de conta
វិគីភីឌា:Oversight	Wikipédia:Supervisão
វិគីភីឌា:IP block exemption	Wikipédia:Isento de bloqueio de IP
ចំណាត់ថ្នាក់ក្រុម:Container categories	Categoria:!Categorias contêiner
វិគីភីឌា:រូបយន្ត	Wikipédia:Robôs
ចំណាត់ថ្នាក់ក្រុម:Hidden categories	Categoria:!Categorias ocultas
ទេវតា	Deva (budismo)
អេហ៊្សីប	Egito
វិគីភីឌា:វិគីគម្រោង	Wikipédia:WikiProjeto
ទំព័រគំរូ:Bot	Predefinição:Robô
វិគីភីឌា:អ្វីៗដែលវិគីភីឌាមិនអនុញ្ញាត	Wikipédia:O que a Wikipédia não é
ឧទ្យានជាតិបុទុមសាគរ	Parque Nacional de Botum Sakor
កាណាដា	Canadá
ចំណាត់ថ្នាក់ក្រុម:ប្រទេសអាយឡែន	Categoria:Islândia
វិគីភីឌា:អំពីវិគីភីឌា	Wikipédia:Sobre a Wikipédia
ចំណាត់ថ្នាក់ក្រុម:ខ្នាតក្រលាផ្ទៃ	Categoria:Unidades de área
ជំនួយ:ពាក្យទិព្វ	Ajuda:Palavras mágicas
ទំព័រគំរូ:Flagicon	Predefinição:ÍconeBandeira
ចំណាត់ថ្នាក់ក្រុម:អឺរ៉ុប	Categoria:Europa
ចំណាត់ថ្នាក់ក្រុម:បច្ចេកវិទ្យា	Categoria:Classificações dos tópicos principais
ចំណាត់ថ្នាក់ក្រុម:ជំនួយក្នុងវិគីភីឌា	Categoria:!Ajuda
វិគីភីឌា:ទំព័រអ្នកប្រើប្រាស់	Wikipédia:Página de usuário
វិគីភីឌា:ព្រឹត្តិការណ៍​ថ្មីៗ	Portal:Eventos atuais
ទំព័រគំរូ:Documentation	Predefinição:Documentação
វិគីភីឌា:អ្នកប្រើប្រាស់	Wikipédia:Usuários
វិគីភីឌា:Protection policy	Wikipédia:Página protegida
វិគីភីឌា:WikiLove	Wikipédia:Wikiamor
វិគីភីឌា:Userboxes	Wikipédia:Userbox
វិគីភីឌា:ហត្ថលេខា	Wikipédia:Regras para assinaturas
វិគីភីឌា:អត្ថបទខ្លីមិនពេញលេញ	Wikipédia:Esboço
វិគីភីឌា:លក្ខណៈវិនិច្ឆ័យនៃលុបជាបន្ទាន់	Wikipédia:Eliminação rápida
វិគីភីឌា:Most wanted articles	Wikipédia:Artigos pedidos
ចំណាត់ថ្នាក់ក្រុម:ទំព័រអសង្ស័យកម្ម អំពីឈ្មោះទីកន្លែង	Categoria:Desambiguações de topônimos
្ឞ្ញ ហ្សអិ-អិអៀ	Sung Jae-ki
វិគីភីឌា:Huggle	Wikipédia:Huggle
ទំព័រគំរូ:Softredirect	Predefinição:Pseudorredirecionamento
ទំព័រគំរូ:លុបជាបន្ទាន់	Predefinição:ER
ឃុំបន្ទាយនាង	Banteay Neang
ឃុំបត់ត្រង់	Bat Trang
ក្លោងទ្វារ:ចិន	Portal:China
វិគីភីឌា:វិគីគម្រោង ជីវប្រវត្តិ	Wikipédia:Projetos/Biografias
ជំនួយ:ប្រអប់ព័ត៌មាន	Ajuda:Infocaixa
កម្ពុជាសម័យទំនើប	História moderna do Camboja
យុគអន្ធកាលនៃកម្ពុជា	Idade das Trevas do Camboja
ការត្រួតត្រារបស់ជប៉ុននៅកម្ពុជា	Ocupação japonesa do Camboja
រដ្ឋប្រហារកម្ពុជាឆ្នាំ១៩៧០	Golpe de Estado no Camboja em 1970
តេលេសុខភាព	Telessaúde
ការប្រមូលទិន្នន័យ	Coleção de dados
ឃុំចំណោម	Chamnaom
ឃុំគោកបល្ល័ង្គ	Kouk Ballangk
ឃុំទឹកជោរ	Tuek Chour Smach
ឧទ្យានជាតិមុនីវង្យបូកគោ	Parque Nacional Preah Monivong
ចំណាត់ថ្នាក់ក្រុម:ភាសា	Categoria:Línguas
ចំណាត់ថ្នាក់ក្រុម:វេយ្យាករណ៍	Categoria:Gramática
ចំណាត់ថ្នាក់ក្រុម:វិគីភីឌា	Categoria:Wikipédia
វិគីភីឌា:ការបដិសេធ ទូទៅ	Wikipédia:Aviso geral
ជំនួយ:ចំណាត់ថ្នាក់ក្រុម	Ajuda:Categoria
វិគីភីឌា:សារទំព័រគំរូ	Wikipédia:Lista de predefinições
វិគីភីឌា:អសង្ស័យកម្ម	Wikipédia:Livro de estilo
Portal:Contents/Portals	Portal:Índice
ទំព័រគំរូ:Navbox	Predefinição:Navbox
ខណ្ឌចំការមន	Chamkarmon
ជំនួយ:រូបមន្ត	Ajuda:Guia de edição/Fórmulas TeX
ទំព័រគំរូ:Coat of arms	Predefinição:Brasão
ខណ្ឌដង្កោ	Dangkao
ខណ្ឌដូនពេញ	Daun Penh
ជំនួយ:តំណភ្ជាប់	Ajuda:Conteúdo/Ligações
ទំព័រគំរូ:Citation needed	Predefinição:Carece de fontes
តំបន់ពាណិជ្ជកម្មសេរី	Área de livre-comércio
វិស័យអប់រំនៅកម្ពុជា	Educação no Camboja
ទំព័រគំរូ:Error	Predefinição:Erro
ចំណាត់ថ្នាក់ក្រុម:Flag templates	Categoria:!Predefinições sobre bandeiras
ទំព័រគំរូ:((	Predefinição:Chaves-abre
ទំព័រគំរូ:))	Predefinição:Chaves-fecha
ទំព័រគំរូ:=	Predefinição:=
ទំព័រគំរូ:Navbar	Predefinição:Tnavbar
ទំព័រគំរូ:Loop	Predefinição:Loop
ទំព័រគំរូ:Void	Predefinição:Void
ទំព័រគំរូ:Key press	Predefinição:Tecla
ទំព័រគំរូ:Okina	Predefinição:Okina
ទំព័រគំរូ:Transclude	Predefinição:Transclude
ទំព័រគំរូ:Sc	Predefinição:Smallcaps
ទំព័រគំរូ:Small	Predefinição:Pequeno
ទំព័រគំរូ:Clear	Predefinição:Limpar
ទំព័រគំរូ:Col-break	Predefinição:Col-break
ទំព័រគំរូ:Col-begin	Predefinição:Col-begin
ទំព័រគំរូ:Trim	Predefinição:Trim
ទំព័រគំរូ:Color	Predefinição:Color
ទំព័រគំរូ:Nowrap	Predefinição:Nowrap
ទំព័រគំរូ:Bots	Predefinição:Bots
ទំព័រគំរូ:Abbr	Predefinição:Abbr
ទ្រឹស្តីបទមុំក្រៅ	Teorema dos ângulos externos
ចំណាត់ថ្នាក់ក្រុម:ខ្សែកោង	Categoria:Curvas
ទំព័រគំរូ:Babel	Predefinição:Babel
ទំព័រគំរូ:Commons	Predefinição:Commons
ទំព័រគំរូ:Link GA	Predefinição:Bom interwiki
ទំព័រគំរូ:Reflist	Predefinição:Referências
ទំព័រគំរូ:NavPeriodicTable	Predefinição:Elemento/mini tabela periódica
វិគីភីឌា:Citing sources	Wikipédia:Livro de estilo/Cite as fontes
ទំព័រគំរូ:អត្ថបទខ្លីមិនពេញលេញ	Predefinição:Esboço
ទំព័រគំរូ:User af-1	Predefinição:User af-1
ទំព័រគំរូ:User az	Predefinição:User az
ទំព័រគំរូ:User bar-1	Predefinição:User bar-1
ទំព័រគំរូ:See also	Predefinição:VT
ទំព័រគំរូ:User de	Predefinição:User de
ទំព័រគំរូ:User de-1	Predefinição:User de-1
ទំព័រគំរូ:User et-1	Predefinição:User et-1
ទំព័រគំរូ:User el	Predefinição:User el
ទំព័រគំរូ:User es	Predefinição:User es
ទំព័រគំរូ:User de-3	Predefinição:User de-3
ទំព័រគំរូ:User en-3	Predefinição:User en-3
ទំព័រគំរូ:User en-1	Predefinição:User en-1
ទំព័រគំរូ:User en-2	Predefinição:User en-2
ទំព័រគំរូ:User en-4	Predefinição:User en-4
ទំព័រគំរូ:User fi	Predefinição:User fi
ទំព័រគំរូ:User en-0	Predefinição:User en-0
ទំព័រគំរូ:User en	Predefinição:User en
ទំព័រគំរូ:User de-2	Predefinição:User de-2
ទំព័រគំរូ:User es-1	Predefinição:User es-1
ទំព័រគំរូ:User fa	Predefinição:User fa
ទំព័រគំរូ:User fr-1	Predefinição:User fr-1
ទំព័រគំរូ:User id-3	Predefinição:User id-3
ទំព័រគំរូ:User it-3	Predefinição:User it-3
ទំព័រគំរូ:User tr-2	Predefinição:User tr-2
ទំព័រគំរូ:User fr-2	Predefinição:User fr-2
ទំព័រគំរូ:User tr	Predefinição:User tr
ទំព័រគំរូ:User ja	Predefinição:User ja
ទំព័រគំរូ:User ja-1	Predefinição:User ja-1
ទំព័រគំរូ:User it-1	Predefinição:User it-1
ទំព័រគំរូ:User fr	Predefinição:User fr
ទំព័រគំរូ:User gsw-1	Predefinição:User gsw-1
ទំព័រគំរូ:Location map/Info	Predefinição:Mapa de localização/info
ចំណាត់ថ្នាក់ក្រុម:Navigational boxes	Categoria:!Predefinições de caixas de navegação
ទំព័រគំរូ:ទិន្នន័យ នៃប្រទេសតាជីគីស្ថាន	Predefinição:Country data Tajiquistão
ចំណាត់ថ្នាក់ក្រុម:អាស៊ី	Categoria:Ásia
ចំណាត់ថ្នាក់ក្រុម:User uk-N	Categoria:Usuário uk
ទំព័រគំរូ:Intricate template	Predefinição:Predefinição complexa
ទំព័រគំរូ:Lang-ja	Predefinição:Lang-ja
ទំព័រគំរូ:Football squad player	Predefinição:Football squad player
ទំព័រគំរូ:ទិន្នន័យប្រទេស គុយវ៉ែត	Predefinição:Country data Kuwait
ទំព័រគំរូ:Mod	Predefinição:Mod
ទំព័រគំរូ:Now Commons	Predefinição:Now Commons
ទំព័រគំរូ:User it	Predefinição:User it
ទំព័រគំរូ:User uk	Predefinição:User uk
ទំព័រគំរូ:User es-2	Predefinição:User es-2
ទំព័រគំរូ:ស្វាគមន៍	Predefinição:Bem-vindo(a)
ទំព័រគំរូ:គម្រោងវិគីជាបងប្អូន	Predefinição:Projetos correlatos
ចំណាត់ថ្នាក់ក្រុម:External link templates	Categoria:!Predefinições de ligações externas
ទំព័រគំរូ:ទិន្នន័យប្រទេស ស្លូវ៉ាគី	Predefinição:Country data Eslováquia
ចំណាត់ថ្នាក់ក្រុម:ទំព័រគំរូសំរាប់កូអរដោនេ	Categoria:!Predefinições de coordenadas
ទំព័រគំរូ:Country flagnavy	Predefinição:Marinha/core
ទំព័រគំរូ:USA	Predefinição:USA
ទំព័រគំរូ:ទិន្នន័យប្រទេស អេត្យូពី	Predefinição:Country data Etiópia
ទំព័រគំរូ:ទិន្នន័យប្រទេស ឆេក	Predefinição:Country data República Checa
ទំព័រគំរូ:ទិន្នន័យ នៃប្រទេសថៃ	Predefinição:Country data Tailândia
ទំព័រគំរូ:Scinote	Predefinição:Scinote
ទំព័រគំរូ:ទិន្នន័យប្រទេស គុយបា	Predefinição:Country data Cuba
ទំព័រគំរូ:Lang-km	Predefinição:Lang-km
ទំព័រគំរូ:ទិន្នន័យប្រទេស អាល់បានី	Predefinição:Country data Albânia
ទំព័រគំរូ:ទិន្នន័យ នៃប្រទេសប៉េរូ	Predefinição:Country data Peru
ទំព័រគំរូ:ទិន្នន័យ នៃប្រទេសម៉ាកាវ	Predefinição:Country data Macau
ទំព័រគំរូ:ទិន្នន័យប្រទេស សាធារណរដ្ឋចិន	Predefinição:Country data República da China
ទំព័រគំរូ:ទិន្នន័យ នៃប្រទេសអ៊ូបេគីស្ថាន	Predefinição:Country data Uzbequistão
ចំណាត់ថ្នាក់ក្រុម:User ms	Categoria:Usuários ms
ទំព័រគំរូ:Continent-based templates	Predefinição:Continente-baseada em templates
ទំព័រគំរូ:Months	Predefinição:Dias do ano
ទំព័រគំរូ:ទិន្នន័យ នៃប្រទេសឡាតវី	Predefinição:Country data Letónia
ទំព័រគំរូ:Football kit	Predefinição:EquipamentoFutebol
ទំព័រគំរូ:ទិន្នន័យ នៃប្រទេសម៉ាល់តា	Predefinição:Country data Malta
ទំព័រគំរូ:ទិន្នន័យ នៃប្រទេសម៉ូណាកូ	Predefinição:Country data Mônaco
ទំព័រគំរូ:ទិន្នន័យ នៃប្រទេសដាណឺម៉ាក	Predefinição:Country data Dinamarca
ទំព័រគំរូ:Wikiatlas	Predefinição:Wikiatlas
ទំព័រគំរូ:ទិន្នន័យ នៃប្រទេសប៉ូឡូញ	Predefinição:Country data Polônia
ទំព័រគំរូ:Wikipedia policies and guidelines	Predefinição:Políticas e recomendações da Wikipédia
ចំណាត់ថ្នាក់ក្រុម:User fr-1	Categoria:Usuário fr-1
ទំព័រគំរូ:ទិន្នន័យ នៃប្រទេសណ័រវ៉េ	Predefinição:Country data Noruega
ទំព័រគំរូ:ទិន្នន័យប្រទេស ហ្សកហ៊្សី	Predefinição:Country data Geórgia
ទំព័រគំរូ:Navbox suite	Predefinição:Navbox suite
ទំព័រគំរូ:Wikiquote	Predefinição:Wikiquote
ទំព័រគំរូ:Country showdata	Predefinição:Country showdata
ទំព័រគំរូ:Image label	Predefinição:Image label
ទំព័រគំរូ:Cat handler	Predefinição:Cat handler
ទំព័រគំរូ:ទិន្នន័យប្រទេស ស្រីលង្កា	Predefinição:Country data Sri Lanka
ទំព័រគំរូ:ទិន្នន័យ នៃប្រទេសមិចសិច	Predefinição:Country data México
ទំព័រគំរូ:ទិន្នន័យប្រទេស ក្រិច	Predefinição:Country data Grécia
ទំព័រគំរូ:ទិន្នន័យ នៃប្រទេសអារ៉ាប៊ីសាអូឌីត	Predefinição:Country data Arábia Saudita
ទំព័រគំរូ:Category tree	Predefinição:Árvore categoria
ទំព័រគំរូ:ទិន្នន័យប្រទេស ក្រូអាត	Predefinição:Country data Croácia
ទំព័រគំរូ:ប្រអប់ព័ត៌មាន អ្នកនិពន្ធ	Predefinição:Info/Escritor
ទំព័រគំរូ:Stub category	Predefinição:Esboço categoria
ទំព័រគំរូ:Ja icon	Predefinição:((ja))
ទំព័រគំរូ:ទិន្នន័យ នៃប្រទេសសហភាពអារ៉ាប់អេមីរ៉េត	Predefinição:Country data Emirados Árabes Unidos
ទំព័រគំរូ:Infobox television	Predefinição:Info/Televisão
ទំព័រគំរូ:Geographic location	Predefinição:Localização geográfica
ទំព័រគំរូ:Infobox musical artist	Predefinição:Info/Música/artista
ទំព័រគំរូ:Finance	Predefinição:Finanças
ទំព័រគំរូ:ទិន្នន័យប្រទេស Serbia	Predefinição:Country data Sérvia
ទំព័រគំរូ:Collapsible list	Predefinição:Collapsible list
ទំព័រគំរូ:ទិន្នន័យ នៃប្រទេសអូស្រ្តាលី	Predefinição:Country data Austrália
ទំព័រគំរូ:ទិន្នន័យ​នៃប្រទេសប៉ាឡេស្ទីន	Predefinição:PSE
ទំព័រគំរូ:Subatomic particle	Predefinição:SubatomicParticle
ទំព័រគំរូ:Sidebar	Predefinição:Sidebar
ទំព័រគំរូ:In use	Predefinição:Em edição
ទំព័រគំរូ:Es icon	Predefinição:((es))
ទំព័រគំរូ:ទិន្នន័យ នៃប្រទេសបារាំង	Predefinição:Country data França
ទំព័រគំរូ:Ambox	Predefinição:Ambox
ទំព័រគំរូ:Update	Predefinição:Desatualizado
ទំព័រគំរូ:CalendarCustom	Predefinição:Calendário
ទំព័រគំរូ:ប្រអប់ព័ត៌មាន មន្ទីរពេទ្យ	Predefinição:Info/Hospital
ទំព័រគំរូ:ប្រអប់ព័ត៌មាន ទស្សនាវដ្ដី	Predefinição:Info/Revista
ទំព័រគំរូ:Image requested	Predefinição:Sem imagem
ទំព័រគំរូ:ប្រអប់ព័ត៌មាន ភ្លេងជាតិ	Predefinição:Info/Hino
ទំព័រគំរូ:Navigation templates	Predefinição:Modelo de navegação
ទំព័រគំរូ:Very long	Predefinição:Aviso-artigo longo
ទំព័រគំរូ:ទិន្នន័យ​នៃប្រទេសគាហ្គីស្ថាន	Predefinição:KGZ
ទំព័រគំរូ:ប្រអប់ព័ត៌មាន សាលារៀន	Predefinição:Info/Escola
ទំព័រគំរូ:Fossil range/bar	Predefinição:Período fóssil/barra
ទំព័រគំរូ:Userboxbottom	Predefinição:Userboxbottom
ទំព័រគំរូ:Copy to Wikimedia Commons	Predefinição:Mover para o Commons
ទំព័រគំរូ:Rnd	Predefinição:Rnd
ទំព័រគំរូ:ចំណាត់ថ្នាក់ក្រុមនៃទំព័រគំរូ	Predefinição:Categoria com predefinições
ទំព័រគំរូ:Font color	Predefinição:Fontcolor
ទំព័រគំរូ:ប្រអប់ព័ត៌មាន ប្រទេស	Predefinição:Info/País
ទំព័រគំរូ:Max	Predefinição:Max
ទំព័រគំរូ:Infobox software	Predefinição:Info/Software
ទំព័រគំរូ:Column-count	Predefinição:Column-count
ទំព័រគំរូ:ទិន្នន័យប្រទេស ឡាវ	Predefinição:Country data Laos
ទំព័រគំរូ:Infobox airline	Predefinição:Info/Companhia aérea
ទំព័រគំរូ:Wide image	Predefinição:Panorama
ទំព័រគំរូ:ទិន្នន័យ នៃប្រទេសអូទ្រីស	Predefinição:Country data Áustria
ទំព័រគំរូ:Collapsible option	Predefinição:Collapsible option
ទំព័រគំរូ:ប្រអប់ព័ត៌មាន ជម្លោះយោធា	Predefinição:Info/Conflito militar
ទំព័រគំរូ:Redirect4	Predefinição:Str left
ទំព័រគំរូ:Cat more	Predefinição:Catmore
ទំព័រគំរូ:ទិន្នន័យ នៃប្រទេសនេប៉ាល់	Predefinição:Country data Nepal
ទំព័រគំរូ:Px	Predefinição:Px
ទំព័រគំរូ:Resolved	Predefinição:Feito
ទំព័រគំរូ:Str sub long	Predefinição:Str sub old
ទំព័រគំរូ:Documentation/docname	Predefinição:Documentação/nomedoc
ទំព័រគំរូ:ទិន្នន័យ នៃប្រទេសហ្វាំងឡង់	Predefinição:Country data Finlândia
ទំព័រគំរូ:Selfref	Predefinição:Selfref
ទំព័រគំរូ:Flatlist	Predefinição:Lista horizontal
ទំព័រគំរូ:ទិន្នន័យ​នៃប្រទេសហ្វីលីពីន	Predefinição:PHL
ទំព័រគំរូ:ទិន្នន័យ នៃប្រទេសអេស៊ីប	Predefinição:Country data Egito
ទំព័រគំរូ:ទិន្នន័យ នៃប្រទេសលីថូនី	Predefinição:Country data Lituânia
ទំព័រគំរូ:ប្រអប់ព័ត៌មាន គណបក្សនយោបាយ	Predefinição:Info/Partido político
ទំព័រគំរូ:ទិន្នន័យប្រទេស ជប៉ុន	Predefinição:Country data Japão
ទំព័រគំរូ:Endflatlist	Predefinição:Endflatlist
ទំព័រគំរូ:Expand section	Predefinição:Expandir
ទំព័រគំរូ:ទិន្នន័យ នៃប្រទេសហូឡង់	Predefinição:Country data Países Baixos
ទំព័រគំរូ:Tmbox	Predefinição:Tmbox
ទំព័រគំរូ:Navbox with columns	Predefinição:Navbox with columns
ទំព័រគំរូ:ប្រអប់ព័ត៌មាន ល្បែងវីដេអូ	Predefinição:Info/Jogo eletrônico
ទំព័រគំរូ:S-start	Predefinição:Começa caixa
ទំព័រគំរូ:IsLeapYear	Predefinição:AnoBissexto
ទំព័រគំរូ:Age in years and days	Predefinição:Idade em anos e dias
ទំព័រគំរូ:Nom	Predefinição:Ind
ទំព័រគំរូ:Facebook	Predefinição:Facebook
ទំព័រគំរូ:Cleanup	Predefinição:Reciclagem
ទំព័រគំរូ:ប្រអប់ព័ត៌មាន សាកលវិទ្យាល័យ	Predefinição:Info/Universidade
ទំព័រគំរូ:Cite journal	Predefinição:Citar periódico
ទំព័រគំរូ:ទិន្នន័យប្រទេស អាស៊ែបៃហ្សង់	Predefinição:Country data Azerbaijão
ទំព័រគំរូ:ទិន្នន័យ​នៃប្រទេសប្រ៊ុយណេ	Predefinição:BRN
ទំព័រគំរូ:វិគីសៀវភៅ	Predefinição:Wikilivros
ទំព័រគំរូ:Hatnote	Predefinição:Dablink
ទំព័រគំរូ:User browser:Firefox	Wikipédia:Userbox/Firefox
ទំព័រគំរូ:Xpd	Predefinição:Xpd
ទំព័រគំរូ:User es-0	Predefinição:User es-0
ទំព័រគំរូ:Time ago	Predefinição:Tempo passado
ទំព័រគំរូ:Familytree	Predefinição:Árvore genealógica
ទំព័រគំរូ:ទិន្នន័យប្រទេស វៀតណាម	Predefinição:Country data Vietname
ទំព័រគំរូ:S-aft	Predefinição:S-aft
ទំព័រគំរូ:Featured article	Predefinição:Artigo destacado
ទំព័រគំរូ:ទិន្នន័យ នៃប្រទេសរុស្ស៊ី	Predefinição:Country data Rússia
ទំព័រគំរូ:Infobox monarch	Predefinição:Info/Monarca
ចំណាត់ថ្នាក់ក្រុម:User en-4	Categoria:Utilizador en-4
ចំណាត់ថ្នាក់ក្រុម:User en	Categoria:Usuários en
ចំណាត់ថ្នាក់ក្រុម:User zh	Categoria:Usuários zh
ចំណាត់ថ្នាក់ក្រុម:User zh-N	Categoria:Usuário zh
ចំណាត់ថ្នាក់ក្រុម:User en-2	Categoria:Usuário en-2
ទំព័រគំរូ:ប្រអប់ព័ត៌មាន	Predefinição:Info
ទំព័រគំរូ:Infobox instrument	Predefinição:Info/Instrumento
ទំព័រគំរូ:TOC right	Predefinição:TOC-direita
ទំព័រគំរូ:Main other	Predefinição:Artigos e outros
ទំព័រគំរូ:RankedMedalTable	Predefinição:RankedMedalTable
ទំព័រគំរូ:User zh	Predefinição:User zh
ទំព័រគំរូ:Lang-kk	Predefinição:Lang-kk
ទំព័រគំរូ:Navbox/core	Predefinição:Navbox/core
ទំព័រគំរូ:Template other	Predefinição:Template other
ទំព័រគំរូ:Legend	Predefinição:Legenda
ទំព័រគំរូ:ប្រអប់ព័ត៌មាន បណ្ណាល័យ	Predefinição:Info/Biblioteca
ទំព័រគំរូ:Cite web	Predefinição:Citar web
ទំព័រគំរូ:YouTube	Predefinição:Youtube
ទំព័រគំរូ:ទិន្នន័យ នៃប្រទេសអ៊ីតាលី	Predefinição:Country data Itália
ទំព័រគំរូ:Current	Predefinição:Evento atual
ទំព័រគំរូ:Ombox	Predefinição:Ombox
ទំព័រគំរូ:ទិន្នន័យប្រទេស	Predefinição:Dados de país
ទំព័រគំរូ:Won	Predefinição:Ven
ទំព័រគំរូ:Tnavbar-collapsible	Predefinição:Tnavbar-collapsible
ទំព័រគំរូ:Coor URL	Predefinição:Coor URL
ទំព័រគំរូ:Pp-template	Predefinição:Pp-template
ទំព័រគំរូ:Min	Predefinição:Min
ទំព័រគំរូ:Wiktionary	Predefinição:Wikcionário
ទំព័រគំរូ:Mbox templates	Predefinição:Mbox templates
ទំព័រគំរូ:Multi-listen start	Predefinição:Multi-escuta início
ទំព័រគំរូ:ទិន្នន័យ នៃប្រទេសស៊ុយអែត	Predefinição:Country data Suécia
ទំព័រគំរូ:Bar box	Predefinição:Bar box
ទំព័រគំរូ:Chem	Predefinição:Fórmula química
ទំព័រគំរូ:Language icon	Predefinição:Languageicon
ទំព័រគំរូ:Lang-sr	Predefinição:Lang-sr
ទំព័រគំរូ:Infobox settlement	Predefinição:Info/Assentamento
ទំព័រគំរូ:User ru	Predefinição:User ru
ទំព័រគំរូ:IPA	Predefinição:AFI
ទំព័រគំរូ:អត្ថន័យដទៃទៀត	Predefinição:Ver desambig
ទំព័រគំរូ:SeptemberCalendar	Predefinição:Calendário de setembro
ទំព័រគំរូ:ទិន្នន័យប្រទេស សហភាពសូវៀត	Predefinição:Country data União Soviética
ទំព័រគំរូ:ទិន្នន័យ នៃប្រទេសឥណ្ឌា	Predefinição:Country data India
ទំព័រគំរូ:Language with name	Predefinição:Língua com nome
ទំព័រគំរូ:Imbox	Predefinição:Imbox
ទំព័រគំរូ:Rellink	Predefinição:Rellink
ទំព័រគំរូ:Navbox subgroup	Predefinição:Navbox subgroup
ទំព័រគំរូ:Non-free use rationale	Predefinição:Informação
ទំព័រគំរូ:Birth year and age	Predefinição:Ani
ទំព័រគំរូ:List of African capitals	Predefinição:Lista de capitais da África
ទំព័រគំរូ:ប្រអប់ព័ត៌មាន ក្រុមជនជាតិ	Predefinição:Info/Grupo étnico
ទំព័រគំរូ:Archive box	Predefinição:Arquivo-índice
ទំព័រគំរូ:MONTHNAME	Predefinição:MONTHNAME
វិគីភីឌា:Text of GNU Free Documentation License	Wikipédia:GNU Free Documentation License
ទំព័រគំរូ:Commons category-inline	Predefinição:Commonscat em linha
ទំព័រគំរូ:Sisterlinks	Predefinição:Correlatos
ទំព័រគំរូ:ទិន្នន័យប្រទេស អង់ដូរ៉ា	Predefinição:Country data Andorra
ទំព័រគំរូ:ប្រអប់ព័ត៌មាន តំបន់ការពារ	Predefinição:Info/Área protegida
ទំព័រគំរូ:Border	Predefinição:Borda
ទំព័រគំរូ:ទិន្នន័យប្រទេស ព័រទុយហ្គាល់	Predefinição:Country data Portugal
ទំព័រគំរូ:MONTHNUMBER	Predefinição:MONTHNUMBER
ចំណាត់ថ្នាក់ក្រុម:People stubs	Categoria:!Esboços de biografias
ទំព័រគំរូ:ទិន្នន័យប្រទេស បុរីវ៉ាទីកង់	Predefinição:Country data Vaticano
ទំព័រគំរូ:Top icon	Predefinição:Top icon
ទំព័រគំរូ:Icon	Predefinição:Ícone
ចំណាត់ថ្នាក់ក្រុម:Template:Country data templates	Categoria:!Predefinições Country data
ទំព័រគំរូ:Birth category header	Predefinição:Categoria de nascidos por ano
ទំព័រគំរូ:Namespace detect	Predefinição:Namespace detect
ចំណាត់ថ្នាក់ក្រុម:ជ័យលាភីរង្វាន់ណូបែល ផ្នែករូបវិទ្យា	Categoria:Nobel de Física
ចំណាត់ថ្នាក់ក្រុម:ជ័យលាភីរង្វាន់ណូបែល ផ្នែកគីមីវិទ្យា	Categoria:Nobel de Química
ទំព័រគំរូ:Fmbox	Predefinição:Fmbox
ទំព័រគំរូ:Navbox with collapsible groups	Predefinição:Navbox with collapsible groups
ទំព័រគំរូ:GeoGroup	Predefinição:GeoGroupTemplate
ទំព័រគំរូ:ទិន្នន័យប្រទេស ចិន	Predefinição:Country data Chine
ទំព័រគំរូ:Wikify	Predefinição:Wikificação
ទំព័រគំរូ:ទិន្នន័យ នៃ ប្រទេស អង់គ្លេស	Predefinição:Country data Inglaterra
ទំព័រគំរូ:ទិន្នន័យ នៃប្រទេសអៀរឡង់	Predefinição:Country data República da Irlanda
ទំព័រគំរូ:ទិន្នន័យ នៃប្រទេសទួរគី	Predefinição:Country data Turquia
ទំព័រគំរូ:ទិន្នន័យ នៃប្រទេសស្វីស	Predefinição:Country data Suíça
ទំព័រគំរូ:ទិន្នន័យ នៃប្រទេសហ្វីលីពីន	Predefinição:Country data Filipinas
ទំព័រគំរូ:Hidden begin	Predefinição:Hidden begin
ទំព័រគំរូ:ParmPart	Predefinição:ParmPart
ទំព័រគំរូ:Army	Predefinição:Exército
ទំព័រគំរូ:ទិន្នន័យ នៃប្រទេសម៉ាឡេស៊ី	Predefinição:Country data Malásia
ទំព័រគំរូ:ទិន្នន័យប្រទេស អាមេនី	Predefinição:Country data Armênia
ទំព័រគំរូ:Infobox OS	Predefinição:Info/SO
ទំព័រគំរូ:ទិន្នន័យប្រទេស វៀតណាមខាងត្បូង	Predefinição:Country data Vietnã do Sul
ទំព័រគំរូ:ទិន្នន័យ នៃប្រទេសភូមា	Predefinição:Country data Myanmar
ទំព័រគំរូ:ទិន្នន័យ នៃប្រទេសឈីលី	Predefinição:Country data Chile
ទំព័រគំរូ:ទិន្នន័យប្រទេស លីបង់	Predefinição:Country data Líbano
ទំព័រគំរូ:ទិន្នន័យប្រទេស ចិនតៃប៉ិ	Predefinição:Country data Taipei chinesa
ទំព័រគំរូ:ប្រអប់ព័ត៌មាន សៀវភៅ	Predefinição:Info/Livro
ទំព័រគំរូ:ប្រអប់ព័ត៌មាន ភព	Predefinição:Info/Planeta
ទំព័រគំរូ:Compact periodic table	Predefinição:Tabela periódica compacta
ទំព័រគំរូ:Lang-fa	Predefinição:Lang-fa
ទំព័រគំរូ:ICD10	Predefinição:CID10
ទំព័រគំរូ:ទិន្នន័យ​នៃប្រទេសម៉ាឡេស៊ី	Predefinição:MYS
ទំព័រគំរូ:Infobox website	Predefinição:Info/Sítio
ទំព័រគំរូ:Globalize	Predefinição:Global
ទំព័រគំរូ:Image label end	Predefinição:Image label end
ទំព័រគំរូ:Navboxes	Predefinição:Navboxes
ទំព័រគំរូ:Documentation subpage	Predefinição:Subpágina de documentação
ទំព័រគំរូ:Uncategorized	Predefinição:Sem cat
ទំព័រគំរូ:ទិន្នន័យ​នៃប្រទេសឥណ្ឌូនេស៊ី	Predefinição:IDN
ទំព័រគំរូ:Talk header for guidelines	Predefinição:Página de discussão
ទំព័រគំរូ:Quote box	Predefinição:Quote box
ទំព័រគំរូ:Navbox years	Predefinição:NavboxAnos
ទំព័រគំរូ:CcTLD	Predefinição:CcTLD
ទំព័រគំរូ:Oldid	Predefinição:Oldid
ទំព័រគំរូ:List of Asian capitals by region	Predefinição:Lista de capitais da Ásia por região
ទំព័រគំរូ:Bquote	Predefinição:Bquote
ទំព័រគំរូ:ប្រអប់ព័ត៌មានទីកន្លែងកេរដំណែលពិភពលោក	Predefinição:Info/Património Mundial
ទំព័រគំរូ:Str len	Predefinição:Str len
ទំព័រគំរូ:Purge	Predefinição:Purgar
ទំព័រគំរូ:Lang-de	Predefinição:Lang-de
ទំព័រគំរូ:Empty category	Predefinição:Categoria vazia
ទំព័រគំរូ:Ifempty	Predefinição:Ifempty
ទំព័រគំរូ:Lang-la	Predefinição:Lang-la
ទំព័រគំរូ:ប្រអប់ព័ត៌មាន អាគារ	Predefinição:Info/Edifício
ទំព័រគំរូ:'	Predefinição:'
ទំព័រគំរូ:Location map USA	Predefinição:Mapa de localização/Estados Unidos
ទំព័រគំរូ:Lang-el	Predefinição:Lang-el
ទំព័រគំរូ:Chessgames player	Predefinição:Chessgames
ទំព័រគំរូ:ទិន្នន័យ​នៃប្រទេសអារ៉ាប៊ីសាអូឌីត	Predefinição:SAU
ទំព័រគំរូ:User page	Predefinição:Página de usuário
ទំព័រគំរូ:DE	Predefinição:DEU
ទំព័រគំរូ:Lang-my	Predefinição:Lang-my
ទំព័រគំរូ:Stack	Predefinição:Stack
ទំព័រគំរូ:ប្រអប់ព័ត៌មាន ព្រះវិហារគ្រិស្ដសាសនា	Predefinição:Info/Igreja
ទំព័រគំរូ:ផ្នែក និងទឹកដីនាយសមុទ្ររបស់បារាំង	Predefinição:Departamentos franceses ultramarinos e territórios
ទំព័រគំរូ:Infobox Christian leader	Predefinição:Info/Papa
ទំព័រគំរូ:User	Predefinição:Usuário2
ទំព័រគំរូ:Spoken Wikipedia	Predefinição:Wikipédia audível
ទំព័រគំរូ:វិគីភីឌាភាសា	Predefinição:Wikipédias
ទំព័រគំរូ:Clarify	Predefinição:Esclarecer
ទំព័រគំរូ:Refimprove	Predefinição:Sem-fontes
ទំព័រគំរូ:Lorem ipsum	Predefinição:Lorem ipsum
ទំព័រគំរូ:ស្នើសុំប្ដូរឈ្មោះ	Predefinição:Renomear
ទំព័រគំរូ:Image label small	Predefinição:Image label small
ទំព័រគំរូ:Featured article candidates	Predefinição:Candidato a destaque
ទំព័រគំរូ:អឺរ៉ុប និង សមុទ្រ	Predefinição:Mapa detalhado da Europa
ទំព័រគំរូ:Nihongo	Predefinição:Japonês
ទំព័រគំរូ:User fr-3	Predefinição:User fr-3
ទំព័រគំរូ:PD-because	Predefinição:DomínioPúblico
ទំព័រគំរូ:Th icon	Predefinição:((th))
ទំព័រគំរូ:Failed verification	Predefinição:Falha na verificação
ទំព័រគំរូ:Tag	Predefinição:Tag
ទំព័រគំរូ:Sec link auto	Predefinição:Sec link auto
ទំព័រគំរូ:Pp-meta	Predefinição:Pp-meta
ទំព័រគំរូ:Notelist	Predefinição:Notelist
ទំព័រគំរូ:S-ttl	Predefinição:S-ttl
ទំព័រគំរូ:Infobox former country	Predefinição:Info/Estado extinto
ទំព័រគំរូ:IPA-en	Predefinição:IPA-en
ទំព័រគំរូ:JPN	Predefinição:JPN
ទំព័រគំរូ:ភូមិភាគទាំង៩របស់ជប៉ុន	Predefinição:Regiões e divisões administrativas do Japão
ទំព័រគំរូ:Merge from	Predefinição:Fusão de
ទំព័រគំរូ:Cmbox	Predefinição:Cmbox
ជំនួយ:តារាង	Ajuda:Guia de edição/Usar tabelas
ទំព័រគំរូ:Precision	Predefinição:Precision
ទំព័រគំរូ:End date	Predefinição:Data de fim
ទំព័រគំរូ:Gbmapping	Predefinição:Gbmappingsmall
ទំព័រគំរូ:User wikipedia/Checkuser	Wikipédia:Userbox/CheckUser
ទំព័រគំរូ:ទិន្នន័យ​នៃប្រទេសប៉ាគីស្ថាន	Predefinição:PAK
ទំព័រគំរូ:Age in days nts	Predefinição:Anos em dias
ទំព័រគំរូ:S-bef	Predefinição:S-bef
ទំព័រគំរូ:Nations at the 2008 Summer Olympics	Predefinição:Países nos Jogos Olímpicos de Verão de 2008
ទំព័រគំរូ:Guideline	Predefinição:Recomendação
ទំព័រគំរូ:Mbox	Predefinição:Mbox
ទំព័រគំរូ:Disagree	Predefinição:Discordo
ទំព័រគំរូ:DNB portal	Predefinição:DNB-Portal
ទំព័រគំរូ:Talkarchive	Predefinição:Arquivo de discussão
ទំព័រគំរូ:Lt	Predefinição:((lt))
ទំព័រគំរូ:Pagetype	Predefinição:Tipo de página
ទំព័រគំរូ:ទិន្នន័យ​នៃប្រទេសអ៊ីរ៉ង់	Predefinição:IRN
ទំព័រគំរូ:ទិន្នន័យ​នៃប្រទេសហ្សកដង់	Predefinição:JOR
ទំព័រគំរូ:Bibleverse	Predefinição:Citar bíblia
ទំព័រគំរូ:Infobox historical event	Predefinição:Info/Evento histórico
ទំព័រគំរូ:ទិន្នន័យ​នៃប្រទេសហុងកុង	Predefinição:HKG
ទំព័រគំរូ:ទិន្នន័យ​នៃប្រទេសកូរ៉េខាងជើង	Predefinição:PRK
ទំព័រគំរូ:Infobox continent	Predefinição:Info/Território geográfico
ទំព័រគំរូ:Date	Predefinição:Data
ទំព័រគំរូ:BHU	Predefinição:BTN
ទំព័រគំរូ:ទិន្នន័យ​នៃប្រទេសសិង្ហបុរី	Predefinição:SGP
ទំព័រគំរូ:ទិន្នន័យ​នៃប្រទេសឥណ្ឌា	Predefinição:IND
ទំព័រគំរូ:ទិន្នន័យ​នៃប្រទេសម៉ាកាវ	Predefinição:MAC
ទំព័រគំរូ:សបា្ដហ៍	Predefinição:Dias da semana
ទំព័រគំរូ:To do	Predefinição:Por fazer (medicina)
ទំព័រគំរូ:Colors	Predefinição:Colors
ទំព័រគំរូ:Nobold	Predefinição:Nobold
ចំណាត់ថ្នាក់ក្រុម:User ja-N	Categoria:Usuário ja
ទំព័រគំរូ:Multicol-break	Predefinição:Multicol-break
ទំព័រគំរូ:Largest cities	Predefinição:Maiores cidades
ទំព័រគំរូ:PDFlink	Predefinição:PDFlink
ទំព័រគំរូ:Ca icon	Predefinição:((ca))
ទំព័រគំរូ:ទិន្នន័យ នៃប្រទេសអាល្លឺម៉ងខាងកើត	Predefinição:Country data Alemanha Ocidental
ទំព័រគំរូ:Region history	Predefinição:História do país
ទំព័រគំរូ:Lang-ru	Predefinição:Lang-ru
វិគីភីឌា:Welcoming committee	Wikipédia:Boas-vindas
ទំព័រគំរូ:Br separated entries	Predefinição:Br separated entries
ទំព័រគំរូ:Infobox saint	Predefinição:Info/Santo
ទំព័រគំរូ:FebruaryCalendar	Predefinição:Calendário de fevereiro
ទំព័រគំរូ:URL	Predefinição:URL
ទំព័រគំរូ:ណែនាំ	Predefinição:Desambiguação
ទំព័រគំរូ:Tlsp	Predefinição:Lpsp
ទំព័រគំរូ:ទិន្នន័យ នៃប្រទេសហុងកុង	Predefinição:Country data Hong Kong
ទំព័រគំរូ:Copy to Wiktionary	Predefinição:Movedic
ទំព័រគំរូ:No	Predefinição:Negado
ទំព័រគំរូ:Tick	Predefinição:Sim
ចំណាត់ថ្នាក់ក្រុម:ទំព័រគំរូ ប្រអប់ព័ត៌មាន	Categoria:!Predefinições de caixas de informação
ចំណាត់ថ្នាក់ក្រុម:Lists of flags	Categoria:Listas de bandeiras
ទំព័រគំរូ:ទិន្នន័យប្រទេស Nazi Germany	Predefinição:Country data Alemanha Nazi
ទំព័រគំរូ:Plainlist	Predefinição:Lista simples
ទំព័រគំរូ:Divbox	Predefinição:Caixa
ចំណាត់ថ្នាក់ក្រុម:អ្នកថតរូប	Categoria:Fotografia
ទំព័រគំរូ:Contains Japanese text	Predefinição:Contém texto em japonês
ទំព័រគំរូ:Para	Predefinição:Parâmetro
ទំព័រគំរូ:Partial	Predefinição:Partial
ចំណាត់ថ្នាក់ក្រុម:យន្តហោះយោធា	Categoria:Aviões militares
ទំព័រគំរូ:Legend inline	Predefinição:Legend inline
ទំព័រគំរូ:LAO	Predefinição:LAO
ទំព័រគំរូ:GRC	Predefinição:GRC
ទំព័រគំរូ:PRT	Predefinição:PRT
ទំព័រគំរូ:ទិន្នន័យ​នៃប្រទេសបង់ក្លាដែស្ស	Predefinição:BGD
ទំព័រគំរូ:States of Austria	Predefinição:Estados da Áustria
ទំព័រគំរូ:Order of magnitude	Predefinição:Ordem de magnitude
ទំព័រគំរូ:Category see also	Predefinição:Vercat
ទំព័រគំរូ:Tlf	Predefinição:Tlf
ទំព័រគំរូ:For	Predefinição:Para
ទំព័រគំរូ:Ifsubst	Predefinição:Sesubst
ទំព័រគំរូ:Sec link image	Predefinição:Sec link image
ទំព័រគំរូ:Lower	Predefinição:Lower
ទំព័រគំរូ:Caution	Predefinição:Atenção amarelo
ទំព័រគំរូ:Science	Predefinição:Ciências-vertical
ចំណាត់ថ្នាក់ក្រុម:អង្គការមិនរកប្រាក់កំរៃ	Categoria:Instituições sem fins lucrativos
ទំព័រគំរូ:High-risk	Predefinição:Alto risco
ទំព័រគំរូ:Lang-uk	Predefinição:Lang-uk
ទំព័រគំរូ:Contains Chinese text	Predefinição:Contém texto em chinês
ទំព័រគំរូ:KHM	Predefinição:KHM
ទំព័រគំរូ:ប្រអប់ព័ត៌មាន អង្គការ	Predefinição:Info/Organização
ទំព័រគំរូ:MNE	Predefinição:MNE
ទំព័រគំរូ:Category TOC	Predefinição:CategoriaTOC
ទំព័រគំរូ:Resize	Predefinição:Redimensionar
ទំព័រគំរូ:IPA-fr	Predefinição:IPA-fr
ទំព័រគំរូ:Fix	Predefinição:Fix
ទំព័រគំរូ:Lang-nl	Predefinição:Lang-nl
ទំព័រគំរូ:ទិន្នន័យ​នៃប្រទេសមីយ៉ាន់ម៉ា	Predefinição:MMR
ទំព័រគំរូ:Lang-id	Predefinição:Lang-id
ទំព័រគំរូ:ទិន្នន័យ​នៃប្រទេសកូរ៉េខាងត្បូង	Predefinição:KOR
ទំព័រគំរូ:EMedicine2	Predefinição:EMedicine2
ទំព័រគំរូ:Chinese name	Predefinição:Nome chinês
ទំព័រគំរូ:Tn	Predefinição:Tn
ទំព័រគំរូ:លំហឈ្មោះ	Predefinição:Domínios da Wikipédia
ចំណាត់ថ្នាក់ក្រុម:User gsw-1	Categoria:Usuário gsw-1
ទំព័រគំរូ:ទិន្នន័យប្រទេស កាតារ	Predefinição:Country data Qatar
ទំព័រគំរូ:User it-2	Predefinição:User it-2
ទំព័រគំរូ:Val	Predefinição:Val
ទំព័រគំរូ:Lang-fr	Predefinição:Lang-fr
ទំព័រគំរូ:មេកានិចក្លាស់សិច	Predefinição:Mecânica Clássica
ទំព័រគំរូ:Superimpose	Predefinição:Superimpose
ទំព័រគំរូ:FRA	Predefinição:FRA
ទំព័រគំរូ:Age	Predefinição:Idade
ទំព័រគំរូ:Wrap	Predefinição:Wrap
ទំព័រគំរូ:Flagicon image	Predefinição:Flagicon image
ទំព័រគំរូ:Pending	Predefinição:Pendente
ទំព័រគំរូ:Infobox person	Predefinição:Info/Biografia
ទំព័រគំរូ:?	Predefinição:?
ទំព័រគំរូ:ទិន្នន័យ នៃប្រទេសអ៊ីស្រាអែល	Predefinição:Country data Israel
ទំព័រគំរូ:ទិន្នន័យ នៃប្រទេសសាធារណរដ្ឋប្រជាមានិតចិន	Predefinição:Dados de país/República Popular da China
ទំព័រគំរូ:Number table sorting	Predefinição:Smn
ទំព័រគំរូ:List of European capitals by region	Predefinição:Lista de capitais da Europa por região
ទំព័រគំរូ:ទិន្នន័យប្រទេស កូឡុំប៊ី	Predefinição:Country data Colômbia
ទំព័រគំរូ:ទិន្នន័យ នៃប្រទេសប៉ាគីស្ថាន	Predefinição:Country data Paquistão
ទំព័រគំរូ:ទិន្នន័យប្រទេស Ghana	Predefinição:Country data Gana
ទំព័រគំរូ:ទិន្នន័យប្រទេស កូរ៉េខាងត្បូង	Predefinição:Country data Coreia do Sul
ទំព័រគំរូ:Legend-line	Predefinição:Linha de legenda
ចំណាត់ថ្នាក់ក្រុម:ព្រះមហាក្សត្រខ្មែរ	Categoria:Reis do Camboja
ទំព័រគំរូ:Election table	Predefinição:Eleição tabela
ទំព័រគំរូ:World Trade Organization	Predefinição:OMC
ទំព័រគំរូ:UF-coord-classes	Predefinição:UF-coord-classes
ទំព័រគំរូ:Coord	Predefinição:Coord
ទំព័រគំរូ:POV	Predefinição:Parcial
ចំណាត់ថ្នាក់ក្រុម:20th-century births	Categoria:Nascidos no século XX
ទំព័រគំរូ:Dmoz	Predefinição:Dmoz
ចំណាត់ថ្នាក់ក្រុម:ពហុកោណ	Categoria:Polígonos
ទំព័រគំរូ:Fide	Predefinição:Fide
ទំព័រគំរូ:User lb-1	Predefinição:User lb-1
ទំព័រគំរូ:Dated maintenance category	Predefinição:Categoria de manutenção datada
ទំព័រគំរូ:អាស៊ីហ្គេម	Predefinição:Eventos do Conselho Olímpico da Ásia
ទំព័រគំរូ:User la-1	Predefinição:User la-1
ទំព័រគំរូ:ទិន្នន័យប្រទេស បារ៉ែន	Predefinição:Country data Bahrain
ទំព័រគំរូ:ព្រះពុទ្ធសាសនា	Predefinição:Budismo
ទំព័រគំរូ:Biology-stub	Predefinição:Esboço-biologia
ទំព័រគំរូ:អេឡិចត្រូម៉ាញ៉េទិច	Predefinição:Eletromagnetismo
ចំណាត់ថ្នាក់ក្រុម:ឯកសារអំពី ទំព័រគំរូ	Categoria:!Instruções de predefinições
ចំណាត់ថ្នាក់ក្រុម:អត្ថបទខ្លីមិនពេញលេញ អំពីកម្ពុជា	Categoria:!Esboços sobre Camboja
ចំណាត់ថ្នាក់ក្រុម:User pdc	Categoria:Usuários pdc
ចំណាត់ថ្នាក់ក្រុម:User et	Categoria:Usuários et
ចំណាត់ថ្នាក់ក្រុម:User fr	Categoria:Usuários fr
ចំណាត់ថ្នាក់ក្រុម:User id	Categoria:Usuários id
ចំណាត់ថ្នាក់ក្រុម:User ja	Categoria:Usuários ja
ចំណាត់ថ្នាក់ក្រុម:User la	Categoria:Usuários la
ចំណាត់ថ្នាក់ក្រុម:User li	Categoria:Usuários li
ចំណាត់ថ្នាក់ក្រុម:User sv	Categoria:Usuários sv
ចំណាត់ថ្នាក់ក្រុម:User th	Categoria:Usuários th
ចំណាត់ថ្នាក់ក្រុម:User fr-3	Categoria:Usuário fr-3
ចំណាត់ថ្នាក់ក្រុម:User it-3	Categoria:Usuário it-3
ចំណាត់ថ្នាក់ក្រុម:User ja-3	Categoria:Usuário ja-3
ចំណាត់ថ្នាក់ក្រុម:User tr-3	Categoria:Usuário tr-3
ចំណាត់ថ្នាក់ក្រុម:User pdc-1	Categoria:Usuário pdc-1
ចំណាត់ថ្នាក់ក្រុម:User et-1	Categoria:Usuário et-1
ចំណាត់ថ្នាក់ក្រុម:User li-1	Categoria:Usuário li-1
ចំណាត់ថ្នាក់ក្រុម:User nl-1	Categoria:Usuário nl-1
ចំណាត់ថ្នាក់ក្រុម:User tr-1	Categoria:Usuário tr-1
ចំណាត់ថ្នាក់ក្រុម:User fr-2	Categoria:Usuário fr-2
ចំណាត់ថ្នាក់ក្រុម:User it-2	Categoria:Usuário it-2
ចំណាត់ថ្នាក់ក្រុម:User ja-2	Categoria:Usuário ja-2
ចំណាត់ថ្នាក់ក្រុម:User la-2	Categoria:Usuário la-2
ចំណាត់ថ្នាក់ក្រុម:User tr-2	Categoria:Usuário tr-2
ចំណាត់ថ្នាក់ក្រុម:User fr-N	Categoria:Usuário fr
ចំណាត់ថ្នាក់ក្រុម:User it-N	Categoria:Usuário it
ចំណាត់ថ្នាក់ក្រុម:User nl-N	Categoria:Usuário nl
ចំណាត់ថ្នាក់ក្រុម:User ru-N	Categoria:Usuário ru
ចំណាត់ថ្នាក់ក្រុម:កំសាន្ត	Categoria:Entretenimento
ទំព័រគំរូ:Sister-inline	Predefinição:Sister-inline
ចំណាត់ថ្នាក់ក្រុម:Image insertion templates	Categoria:!Predefinições de imagens
ទំព័រគំរូ:IncreaseNegative	Predefinição:Aumento negativo
ទំព័រគំរូ:Beta	Predefinição:Beta
ចំណាត់ថ្នាក់ក្រុម:User af	Categoria:Usuários af
ចំណាត់ថ្នាក់ក្រុម:User af-1	Categoria:Usuário af-1
ចំណាត់ថ្នាក់ក្រុម:User bar	Categoria:Usuários bar
ចំណាត់ថ្នាក់ក្រុម:User bar-1	Categoria:Usuário bar-1
ចំណាត់ថ្នាក់ក្រុម:កោះ	Categoria:Ilhas
ចំណាត់ថ្នាក់ក្រុម:User de	Categoria:Usuários de
ចំណាត់ថ្នាក់ក្រុម:User de-2	Categoria:Usuário de-2
ចំណាត់ថ្នាក់ក្រុម:User de-3	Categoria:Usuário de-3
ចំណាត់ថ្នាក់ក្រុម:User de-N	Categoria:Usuário de
ចំណាត់ថ្នាក់ក្រុម:User el	Categoria:Usuários el
ចំណាត់ថ្នាក់ក្រុម:User en-3	Categoria:Usuário en-3
ចំណាត់ថ្នាក់ក្រុម:User en-N	Categoria:Usuário en
ចំណាត់ថ្នាក់ក្រុម:User es	Categoria:Usuários es
ចំណាត់ថ្នាក់ក្រុម:User es-1	Categoria:Usuário es-1
ចំណាត់ថ្នាក់ក្រុម:User es-2	Categoria:Usuário es-2
ចំណាត់ថ្នាក់ក្រុម:User es-4	Categoria:Usuário es-4
ចំណាត់ថ្នាក់ក្រុម:User es-N	Categoria:Usuário es
ចំណាត់ថ្នាក់ក្រុម:User fi	Categoria:Usuários fi
ចំណាត់ថ្នាក់ក្រុម:User fi-N	Categoria:Usuário fi
ចំណាត់ថ្នាក់ក្រុម:User gsw	Categoria:Usuários gsw
ទំព័រគំរូ:N/a	Predefinição:N/a
ចំណាត់ថ្នាក់ក្រុម:User id-1	Categoria:Usuário id-1
ចំណាត់ថ្នាក់ក្រុម:User id-2	Categoria:Usuário id-2
ចំណាត់ថ្នាក់ក្រុម:User id-3	Categoria:Usuário id-3
ទំព័រគំរូ:ទិន្នន័យ នៃប្រទេសអាល្លឺម៉ង់	Predefinição:Country data Alemanha
ទំព័រគំរូ:Multiple image	Predefinição:Imagem múltipla
ទំព័រគំរូ:ទិន្នន័យប្រទេស ចក្រភពអង់គ្លេស	Predefinição:Country data Reino Unido
ចំណាត់ថ្នាក់ក្រុម:ធរណីមាត្រ	Categoria:Geometria
ទំព័រគំរូ:អង្គការសហប្រជាជាតិ	Predefinição:ONU
ទំព័រគំរូ:ប្រអប់ព័ត៌មាន រោគ-ជំងឺ	Predefinição:Info/Patologia
ទំព័រគំរូ:User wikipedia/Administrator	Wikipédia:Userbox/Administrador
ទំព័រគំរូ:Weather box	Predefinição:Tabela/Clima
វិគីភីឌា:អត្ថបទ​ប្រចាំ​ថ្ងៃ	Portal:Conteúdo destacado
ចំណាត់ថ្នាក់ក្រុម:User it	Categoria:Usuários it
ចំណាត់ថ្នាក់ក្រុម:User it-1	Categoria:Usuário it-1
ចំណាត់ថ្នាក់ក្រុម:User ja-1	Categoria:Usuário ja-1
ចំណាត់ថ្នាក់ក្រុម:User ko	Categoria:Usuários ko
ចំណាត់ថ្នាក់ក្រុម:User ko-1	Categoria:Usuário ko-1
ចំណាត់ថ្នាក់ក្រុម:User ko-2	Categoria:Usuário ko-2
ចំណាត់ថ្នាក់ក្រុម:User ko-3	Categoria:Usuário ko-3
ចំណាត់ថ្នាក់ក្រុម:User ksh	Categoria:Usuários ksh
ចំណាត់ថ្នាក់ក្រុម:User ksh-N	Categoria:Usuário ksh
ចំណាត់ថ្នាក់ក្រុម:User la-1	Categoria:Usuário la-1
ចំណាត់ថ្នាក់ក្រុម:User lb	Categoria:Usuários lb
ចំណាត់ថ្នាក់ក្រុម:User lb-1	Categoria:Usuário lb-1
ទំព័រគំរូ:Multiple issues	Predefinição:Multitag
ទំព័រគំរូ:Economics sidebar	Predefinição:Sidebar Economia
ទំព័រគំរូ:Cite doi	Predefinição:Cite doi
ទំព័រគំរូ:ប្រអប់ព័ត៌មាន រូបិយវត្ថុ	Predefinição:Info/Moeda
ទំព័រគំរូ:Sup	Predefinição:Exp
ទំព័រគំរូ:Current U.S. Senators	Predefinição:Senadores dos EUA
ទំព័រគំរូ:Lang-vi	Predefinição:Lang-vi
ទំព័រគំរូ:Translation	Predefinição:Em tradução
ទំព័រគំរូ:Protection templates	Predefinição:Proteções
ទំព័រគំរូ:Distinguish	Predefinição:Não confundir com
ទំព័រគំរូ:Infobox programming language	Predefinição:Info/Linguagem de computador
វិគីភីឌា:Maintenance	Wikipédia:Manutenção
ទំព័រគំរូ:Information	Predefinição:Information
ទំព័រគំរូ:Pp-protected	Predefinição:Pp-protegida
ចំណាត់ថ្នាក់ក្រុម:User ru-1	Categoria:Usuário ru-1
ទំព័រគំរូ:TOC limit	Predefinição:TOC-limitado
វិគីភីឌា:បាបេល	Wikipédia:Babel
ទំព័រគំរូ:Hilite	Predefinição:Destaque
ទំព័រគំរូ:High-use	Predefinição:Alto uso
ទំព័រគំរូ:Expand list	Predefinição:Deslista
ទំព័រគំរូ:Crystalball	Predefinição:Bola de cristal
ទំព័រគំរូ:Tdeprecated	Predefinição:Pdepreciada
ទំព័រគំរូ:Help pages header	Predefinição:WP páginas de ajuda (barra cabeçalho)
ទំព័រគំរូ:Infobox particle	Predefinição:Info/partícula
ទំព័រគំរូ:Sidebar with collapsible lists	Predefinição:Sidebar with collapsible lists
ទំព័រគំរូ:NovemberCalendar	Predefinição:Calendário de novembro
ចំណាត់ថ្នាក់ក្រុម:User ms-2	Categoria:Usuário ms-2
ចំណាត់ថ្នាក់ក្រុម:សមុទ្រ	Categoria:Mares
ទំព័រគំរូ:ISO standards	Predefinição:Normas ISO
ទំព័រគំរូ:MayCalendar	Predefinição:Calendário de maio
ទំព័រគំរូ:CSS3 multiple column layout	Predefinição:Layout de múltiplas colunas em CSS3
ទំព័រគំរូ:FishBase family	Predefinição:FishBase família
ទំព័រគំរូ:IPA-all	Predefinição:IPA-tudo
ទំព័រគំរូ:Lang-ko	Predefinição:Lang-ko
ទំព័រគំរូ:Lang-it	Predefinição:Lang-it
ចំណាត់ថ្នាក់ក្រុម:User nds	Categoria:Usuários nds
ទំព័រគំរូ:Sect1911	Predefinição:Britannica1911
ចំណាត់ថ្នាក់ក្រុម:User nds-1	Categoria:Usuário nds-1
ទំព័រគំរូ:Coord/dms2dec	Predefinição:Coord/dms2dec
ជំនួយ:Archiving a talk page	Ajuda:Guia de edição/Arquivar uma página de discussão
ទំព័រគំរូ:ទិន្នន័យ នៃប្រទេសប្រេស៊ីល	Predefinição:Country data Brasil
វិគីភីឌា:WikiProject Computing	Wikipédia:Projetos/Ciência da computação
ចំណាត់ថ្នាក់ក្រុម:អង្គការអន្តរជាតិ	Categoria:Organizações internacionais
ទំព័រគំរូ:មេកានិចកង់ទិច	Predefinição:Mecânica quântica
ទំព័រគំរូ:Sfn	Predefinição:HarvRef
ជំនួយ:សៀវភៅ	Ajuda:Livros
ទំព័រគំរូ:Infobox settlement/lengthdisp	Predefinição:Lengthdisp
ចំណាត់ថ្នាក់ក្រុម:សមីការឌីផេរ៉ង់ស្យែល	Categoria:Equações diferenciais
ចំណាត់ថ្នាក់ក្រុម:ខេត្តក្រុងខ្មែរ	Categoria:Províncias do Camboja
ទំព័រគំរូ:Lang-lo	Predefinição:Lang-lo
ទំព័រគំរូ:Release date and age	Predefinição:Data de lançamento
ទំព័រគំរូ:Omega Chess diagram	Predefinição:Diagrama de xadrez omega
ចំណាត់ថ្នាក់ក្រុម:ឧទ្ធម្ភាគចក្រ	Categoria:Helicópteros
ចំណាត់ថ្នាក់ក្រុម:នាយករដ្ឋមន្ត្រី	Categoria:Primeiros-ministros
ចំណាត់ថ្នាក់ក្រុម:វិទ្យាសាស្ត្រសង្គម	Categoria:Ciências sociais
ឈាន	Dhyana
ទំព័រគំរូ:ទិន្នន័យ នៃប្រទេសហុងគ្រី	Predefinição:Country data Hungria
ទំព័រគំរូ:JanuaryCalendar	Predefinição:Calendário de janeiro
ទំព័រគំរូ:Template reference list	Predefinição:Referências de predefinição
ចំណាត់ថ្នាក់ក្រុម:ឆ្នាំកំណើត ១៩៥១	Categoria:Nascidos em 1951
ទំព័រគំរូ:Mdash	Predefinição:Mdash
ទំព័រគំរូ:Zh icon	Predefinição:Zh icon
ទំព័រគំរូ:Advert	Predefinição:Publicidade
ទំព័រគំរូ:Infobox government agency	Predefinição:Info/Agência do governo
វិគីភីឌា:Tools	Wikipédia:Ferramentas
ទំព័រគំរូ:User ru-2	Predefinição:User ru-2
ទំព័រគំរូ:Footer ISO 639	Predefinição:ISO 639 rodapé
ចំណាត់ថ្នាក់ក្រុម:User ru	Categoria:Usuários ru
ចំណាត់ថ្នាក់ក្រុម:User ru-2	Categoria:Usuário ru-2
ចំណាត់ថ្នាក់ក្រុម:User ru-3	Categoria:Usuário ru-3
ចំណាត់ថ្នាក់ក្រុម:វត្តអារាមព្រះពុទ្ធសាសនា	Categoria:Templos budistas
ចំណាត់ថ្នាក់ក្រុម:User sxu	Categoria:Usuários sxu
ចំណាត់ថ្នាក់ក្រុម:User sxu-1	Categoria:Usuário sxu-1
ទំព័រគំរូ:Apollo program	Predefinição:Apollo
ចំណាត់ថ្នាក់ក្រុម:User th-1	Categoria:Usuário th-1
ចំណាត់ថ្នាក់ក្រុម:User th-N	Categoria:Usuário th
ចំណាត់ថ្នាក់ក្រុម:User tr	Categoria:Usuários tr
ចំណាត់ថ្នាក់ក្រុម:User tr-N	Categoria:Usuário tr
ទំព័រគំរូ:En icon	Predefinição:((en))
ទំព័រគំរូ:Nay	Predefinição:Não
ទំព័រគំរូ:Alice chess diagram	Predefinição:Diagrama de xadrez bughouse
ទំព័រគំរូ:Spaces	Predefinição:Espaços
ទំព័រគំរូ:ប្រអប់ភាសា	Predefinição:Lang
ទំព័រគំរូ:FishBase species alt	Predefinição:FishBase espécie
ទំព័រគំរូ:ទិន្នន័យប្រទេស Russian SFSR	Predefinição:Country data RSFS da Rússia
ទំព័រគំរូ:Infobox Olympics Cambodia	Predefinição:Info/Olympics Camboja
ទំព័រគំរូ:ទិន្នន័យប្រទេស តួកម៉េនីស្ថាន	Predefinição:Country data Turquemenistão
ទំព័រគំរូ:Str index	Predefinição:Str index
ទំព័រគំរូ:TakeNote	Predefinição:Nota-adm
ទំព័រគំរូ:Age in years, months, weeks and days	Predefinição:Tempo em anos, meses, semanas e dias
ទំព័រគំរូ:Alabama	Predefinição:Alabama
ទំព័រគំរូ:Any	Predefinição:Qualquer
ទំព័រគំរូ:កាលពី	Predefinição:Desde
ទំព័រគំរូ:Asbox/stubtree/3	Predefinição:Asbox/stubtree/3
ទំព័រគំរូ:Asbox/templatepage	Predefinição:Asbox/página da predefinição
ទំព័រគំរូ:ប្រធានបទអាស៊ី	Predefinição:Ásia tópico
ទំព័រគំរូ:IPAkeys	Predefinição:IPA keys horizontal
ទំព័រគំរូ:AugustCalendar	Predefinição:Calendário de agosto
ចំណាត់ថ្នាក់ក្រុម:ធរណីមាត្រត្រីកោណ	Categoria:Geometria do triângulo
ទំព័រគំរូ:BLP	Predefinição:BPV
ទំព័រគំរូ:BLACK	Predefinição:PRETO
ទំព័រគំរូ:Bar percent	Predefinição:Bar percent
ទំព័រគំរូ:Str find	Predefinição:Str find
ទំព័រគំរូ:Fr icon	Predefinição:Fr icon
ទំព័រគំរូ:Twitter	Predefinição:Twitter
ទំព័រគំរូ:Ko icon	Predefinição:((ko))
ទំព័រគំរូ:Lang-hi	Predefinição:Lang-hi
ទំព័រគំរូ:Chembox header	Predefinição:Chembox header
ទំព័រគំរូ:Convert/-/AoffSoff	Predefinição:Convert/-/AoffSoff
ទំព័រគំរូ:Convert/And0	Predefinição:Convert/And0
ទំព័រគំរូ:Convert/LoutAonDbSoff	Predefinição:Convert/LoutAonDbSoff
ទំព័រគំរូ:Convert/and/AoffSoff	Predefinição:Convert/and/AoffSoff
ទំព័រគំរូ:Convert/bar	Predefinição:Convert/bar
ទំព័រគំរូ:Convert/cm2	Predefinição:Convert/cm2
ទំព័រគំរូ:Convert/mm2	Predefinição:Convert/mm2
ទំព័រគំរូ:Convert/sqin	Predefinição:Convert/sqin
ទំព័រគំរូ:Convert/sqnmi	Predefinição:Convert/sqnmi
ទំព័រគំរូ:Convert/sqyd	Predefinição:Convert/sqyd
ទំព័រគំរូ:Convert/tsubo	Predefinição:Convert/tsubo
ទំព័រគំរូ:Convert/x/AoffSoff	Predefinição:Convert/x/AoffSoff
ទំព័រគំរូ:Convert/±/AoffSoff	Predefinição:Convert/±/AoffSoff
ទំព័រគំរូ:Convert/±/AonSoff	Predefinição:Convert/±/AonSoff
ទំព័រគំរូ:Coord/dec2dms/dm	Predefinição:Coord/dec2dms/dm
ចំណាត់ថ្នាក់ក្រុម:Image with comment templates	Categoria:!Predefinições de comentários
ខណ្ឌមានជ័យ	Meanchey
ចំណាត់ថ្នាក់ក្រុម:ទំព័រគំរូសំរាប់ចំនងជើង	Categoria:!Predefinições de título
ទំព័រគំរូ:Country flag IOC alias ZZX	Predefinição:Country flag IOC alias ZZX
ទំព័រគំរូ:EST	Predefinição:EST
ទំព័រគំរូ:Football squad end	Predefinição:Football squad end
ទំព័រគំរូ:IAFD name	Predefinição:IAFD nome
ទំព័រគំរូ:Weather box/cold	Predefinição:Infobox Weather/cold
ទំព័រគំរូ:ទិន្នន័យ​នៃប្រទេសរុស្ស៊ី	Predefinição:RUS
ទំព័រគំរូ:Importance/colour	Predefinição:Importância/cor
ទំព័រគំរូ:Fossil range/marker	Predefinição:Período fóssil/marcador
ទំព័រគំរូ:Five Oceans	Predefinição:Oceanos
ទំព័រគំរូ:Nasdaq2	Predefinição:NASDAQ2
ទំព័រគំរូ:ICD9	Predefinição:CID9
ទំព័រគំរូ:ប្រវត្តិសាស្ត្របារាំង	Predefinição:História da França
ទំព័រគំរូ:MONTH	Predefinição:MONTH
ទំព័រគំរូ:CHL	Predefinição:CHL
ទំព័រគំរូ:Campaign	Predefinição:Campaignbox
ទំព័រគំរូ:Category disambiguation	Predefinição:Categoria ambígua
ទំព័រគំរូ:ទិន្នន័យ​នៃប្រទេសស៊ីរី	Predefinição:SYR
ទំព័រគំរូ:Familytree/step2	Predefinição:Árvore genealógica/2
ទំព័រគំរូ:FCpages	Predefinição:ECD/Páginas
ទំព័រគំរូ:OctoberCalendar	Predefinição:Calendário de outubro
ទំព័រគំរូ:Yesno	Predefinição:Yesno
ទំព័រគំរូ:Side box	Predefinição:Side box
ទំព័រគំរូ:ENG	Predefinição:ENG
ទំព័រគំរូ:Copy to Wikibooks	Predefinição:Movelivros
ទំព័រគំរូ:Citation	Predefinição:Citation
ទំព័រគំរូ:Citation/core	Predefinição:Citation/core
ទំព័រគំរូ:Expert-subject	Predefinição:Revisão
ចំណាត់ថ្នាក់ក្រុម:ប្រទេសជាកោះ	Categoria:Países insulares
ទំព័រគំរូ:ប្រអប់ព័ត៌មាន ភាសា/family-color	Predefinição:Info/Língua/corfamília
ចំណាត់ថ្នាក់ក្រុម:Tracking categories	Categoria:!Categorias de monitoramento
ទំព័រគំរូ:Grey	Predefinição:Cinza
ទំព័រគំរូ:User la-2	Predefinição:User la-2
ទំព័រគំរូ:User ru-1	Predefinição:User ru-1
ទំព័រគំរូ:User tr-1	Predefinição:User tr-1
ទំព័រគំរូ:User zh-1	Predefinição:User zh-1
ទំព័រគំរូ:User zh-2	Predefinição:User zh-2
ទំព័រគំរូ:User zh-3	Predefinição:User zh-3
ចំណាត់ថ្នាក់ក្រុម:រូបវិទូ	Categoria:Físicos por país
ចំណាត់ថ្នាក់ក្រុម:គមនាគមន៍នៅប្រទេសជប៉ុន	Categoria:Transportes do Japão
ចំណាត់ថ្នាក់ក្រុម:ប្រទេសហ្សំប៊ី	Categoria:Zâmbia
ទំព័រគំរូ:ទិន្នន័យប្រទេស យូហ៊្គោស្លាវី	Predefinição:Country data Iugoslávia
ទំព័រគំរូ:Multi-listen end	Predefinição:Multi-escuta fim
ចំណាត់ថ្នាក់ក្រុម:ការអប់រំនៅប្រទេសជប៉ុន	Categoria:Educação no Japão
ចំណាត់ថ្នាក់ក្រុម:ការអប់រំនៅកម្ពុជា	Categoria:Educação no Camboja
ការពិភាក្សារបស់អ្នកប្រើប្រាស់:វ័ណថារិទ្ធ/រូបភាពប្រចាំថ្ងៃ	Wikipédia:Imagem em destaque
ចំណាត់ថ្នាក់ក្រុម:User nl	Categoria:Usuários nl
ទំព័រគំរូ:Unbulleted list	Predefinição:Lista sem marcas
ចំណាត់ថ្នាក់ក្រុម:User zh-1	Categoria:Usuário zh-1
ចំណាត់ថ្នាក់ក្រុម:User zh-3	Categoria:Usuário zh-3
ចំណាត់ថ្នាក់ក្រុម:User zh-2	Categoria:Usuário zh-2
ចំណាត់ថ្នាក់ក្រុម:មេកានិច	Categoria:Mecânica
ចំណាត់ថ្នាក់ក្រុម:អនុគមន៍សនិទាន	Categoria:Funções racionais
ចំណាត់ថ្នាក់ក្រុម:រូបវិទូអាល្លឺម៉ង់	Categoria:Físicos da Alemanha
ចំណាត់ថ្នាក់ក្រុម:រូបវិទូអ៊ីតាលី	Categoria:Físicos da Itália
ចំណាត់ថ្នាក់ក្រុម:រូបវិទូបារាំង	Categoria:Físicos da França
ចំណាត់ថ្នាក់ក្រុម:សេវាសាធារណៈ	Categoria:Serviços públicos
ទំព័រគំរូ:Tnavbar-header	Predefinição:Tnavbar-header
ចំណាត់ថ្នាក់ក្រុម:ព្រឹត្តិការណ៍កីឡាចំរុះ	Categoria:Eventos multidesportivos
ចំណាត់ថ្នាក់ក្រុម:គណិតវិទូអាល្លឺម៉ង់	Categoria:Matemáticos da Alemanha
ទំព័រគំរូ:User wikipedia/autopatrolled	Wikipédia:Userbox/Autorrevisor
ទំព័រគំរូ:ទិន្នន័យប្រទេស វៀតណាមខាងជើង	Predefinição:Country data Vietnã do Norte
ចំណាត់ថ្នាក់ក្រុម:ចំនួនគត់រឺឡាទីប	Categoria:Inteiros
ទំព័រគំរូ:V	Predefinição:V
ចំណាត់ថ្នាក់ក្រុម:ស៊ីហ្គេម	Categoria:Jogos do Sudeste Asiático
ចំណាត់ថ្នាក់ក្រុម:ត្រីកោណមាត្រ	Categoria:Trigonometria
ចំណាត់ថ្នាក់ក្រុម:ទ្រឹស្តីបទ	Categoria:Teoremas
ចំណាត់ថ្នាក់ក្រុម:ទ្រឹស្តីបទគណិតវិទ្យា	Categoria:Teoremas de matemática
ចំណាត់ថ្នាក់ក្រុម:អាកាសយានដ្ឋាន	Categoria:Aeroportos
ចំណាត់ថ្នាក់ក្រុម:រូបវិទូអាមេរិក	Categoria:Físicos dos Estados Unidos
ចំណាត់ថ្នាក់ក្រុម:រូបវិទូអង់គ្លេស	Categoria:Físicos da Inglaterra
ចំណាត់ថ្នាក់ក្រុម:នាយករដ្ឋមន្ត្រីសិង្ហបុរី	Categoria:Primeiros-ministros de Singapura
ចំណាត់ថ្នាក់ក្រុម:រង្វាន់ណូបែល	Categoria:Prémio Nobel
ទំព័រគំរូ:User pfl-1	Predefinição:User pfl-1
ចំណាត់ថ្នាក់ក្រុម:Wikipedia shortcut box first parameter needs fixing	Categoria:Wikipedia shortcut box first parameter needs fixing
ចំណាត់ថ្នាក់ក្រុម:ប្រទេសកម្ពុជា	Categoria:Camboja
ចំណាត់ថ្នាក់ក្រុម:អ្នកនយោបាយប៉ាគីស្ថាន	Categoria:Políticos do Paquistão
ទំព័រគំរូ:Lang-hy	Predefinição:Lang-hy
ទំព័រគំរូ:Tlu	Predefinição:Tlu
ចំណាត់ថ្នាក់ក្រុម:អ្នកនយោបាយខ្មែរ	Categoria:Políticos do Camboja
ចំណាត់ថ្នាក់ក្រុម:អ្នករុករកជនជាតិបារាំង	Categoria:Exploradores da França
ចំណាត់ថ្នាក់ក្រុម:ស្រីលង្កា	Categoria:Sri Lanka
ចំណាត់ថ្នាក់ក្រុម:ទំព័រគំរូឈ្មោះភាសា	Categoria:!Predefinições de apoio multilingue
ចំណាត់ថ្នាក់ក្រុម:ទំព័រគំរូក្នុងរូបវិទ្យា	Categoria:!Predefinições sobre física
ទំព័រគំរូ:ISO 639 name	Predefinição:ISO 639 nome
ទំព័រគំរូ:Ed	Predefinição:Ed
ទំព័រគំរូ:ទិន្នន័យប្រទេស Wales	Predefinição:Country data País de Gales
ទំព័រគំរូ:MONTHABBREV	Predefinição:MONTHABBREV
ចំណាត់ថ្នាក់ក្រុម:ពហុធា	Categoria:Polinómios
ចំណាត់ថ្នាក់ក្រុម:អនុគមន៍	Categoria:Funções matemáticas
ចំណាត់ថ្នាក់ក្រុម:ភាសាជប៉ុន	Categoria:Língua japonesa
ចំណាត់ថ្នាក់ក្រុម:មធ្យម	Categoria:Médias
ចំណាត់ថ្នាក់ក្រុម:ត្រីកោណ	Categoria:Triângulos
ចំណាត់ថ្នាក់ក្រុម:សំភារៈ​សំណង់	Categoria:Materiais de construção
ចំណាត់ថ្នាក់ក្រុម:សមីការ	Categoria:Equações
ចំណាត់ថ្នាក់ក្រុម:ស្ពាននៅប្រទេសជប៉ុន	Categoria:Pontes do Japão
ចំណាត់ថ្នាក់ក្រុម:សិទ្ធិ	Categoria:Direitos
ចំណាត់ថ្នាក់ក្រុម:User pfl-1	Categoria:Usuário pfl-1
ទំព័រគំរូ:Hexadecimal	Predefinição:Hexadecimal
ទំព័រគំរូ:Raise	Predefinição:Raise
ចំណាត់ថ្នាក់ក្រុម:វិភាគគណិតវិទ្យា	Categoria:Análise matemática
ទំព័រគំរូ:Stub documentation	Predefinição:Documentação de esboço
ទំព័រគំរូ:Contents pages (header bar)	Predefinição:Conteúdo-cabeçalho
ចំណាត់ថ្នាក់ក្រុម:វិសមភាព	Categoria:Desigualdades
ចំណាត់ថ្នាក់ក្រុម:ឧទ្យានជាតិ	Categoria:Parques nacionais
ចំណាត់ថ្នាក់ក្រុម:កោះស៊ូម៉ាត្រា	Categoria:Sumatra
ចំណាត់ថ្នាក់ក្រុម:មីក្រូសេដ្ឋកិច្ច	Categoria:Microeconomia
ចំណាត់ថ្នាក់ក្រុម:HTML	Categoria:HTML
ចំណាត់ថ្នាក់ក្រុម:អាស៊ីហ្គេម	Categoria:Jogos Asiáticos
ចំណាត់ថ្នាក់ក្រុម:អេឡិចត្រូស្តាទិច	Categoria:Electrostática
ចំណាត់ថ្នាក់ក្រុម:អ៊ីសាក់ ញូតុន	Categoria:Isaac Newton
ចំណាត់ថ្នាក់ក្រុម:អាកាសចរណ៍	Categoria:Transporte
ចំណាត់ថ្នាក់ក្រុម:ទ្រឹស្តីបទលេខ	Categoria:Teoria dos números
ទំព័រគំរូ:ប្រអប់ព័ត៌មាន ភាសា	Predefinição:Info/Língua
ទំព័រគំរូ:អត្ថបទខ្លី អំពីកូរ៉េខាងត្បូង	Predefinição:Esboço-Coreia do Sul
ទំព័រគំរូ:Wikiversity	Predefinição:Wikiversidade
ទំព័រគំរូ:Quickindexnav	Predefinição:Quickindexnav
ទំព័រគំរូ:Statistics	Predefinição:Estatística
ចំណាត់ថ្នាក់ក្រុម:ភាសាអ៊ីតាលី	Categoria:Língua italiana
ចំណាត់ថ្នាក់ក្រុម:ភាសាអេស្ប៉ាញ	Categoria:Língua espanhola
ចំណាត់ថ្នាក់ក្រុម:រថក្រោះ	Categoria:Tanques
ខណ្ឌប្រាំពីរមករា	Prampi Makara
ទំព័រគំរូ:Lists by country	Predefinição:Listas de países
ទំព័រគំរូ:Infobox polygon	Predefinição:Info/Polígono
ចំណាត់ថ្នាក់ក្រុម:កោះរបស់ឥណ្ឌូនេស៊ី	Categoria:Ilhas da Indonésia
ទំព័រគំរូ:WPBannerMeta	Predefinição:Marca de projeto
ទំព័រគំរូ:Cross	Predefinição:Cross
ខេត្តលង់ហោរ	Vinh Long
ចំណាត់ថ្នាក់ក្រុម:ភ្នំពេញ	Categoria:Phnom Penh
ចំណាត់ថ្នាក់ក្រុម:ទំព័រគំរូសំរាប់ទង់ជាតិ	Categoria:!Predefinições sobre bandeiras de países (com nome)
ចំណាត់ថ្នាក់ក្រុម:ឧទ្យានជាតិនៃព្រះរាជាណាចក្រកម្ពុជា	Categoria:Parques nacionais do Camboja
ទំព័រគំរូ:CountryAbbr	Predefinição:CountryAbbr
ខណ្ឌឫស្សីកែវ	Russei Keo
ទំព័រគំរូ:Split	Predefinição:Divisão
ទំព័រគំរូ:រូបវិទ្យា	Predefinição:Física
វិគីភីឌា:ឯកសារកម្មទំព័រគំរូ	Wikipédia:Documentação da predefinição
ទំព័រគំរូ:CompactTOC8	Predefinição:Peqind
ខណ្ឌសែនសុខ	Sen Sok
ទំព័រគំរូ:Template sandbox notice	Predefinição:Aviso para a página de testes de uma predefinição
ទំព័រគំរូ:Dmbox	Predefinição:Dmbox
ទំព័រគំរូ:Tnavbar-navframe	Predefinição:Tnavbar-navframe
ទំព័រគំរូ:Image frame	Predefinição:Imageframe
ទំព័រគំរូ:Latin Union	Predefinição:União Latina
ទំព័រគំរូ:Information page	Predefinição:Informativo
ទំព័រគំរូ:Subcat guideline	Predefinição:Subcat recomendação
ចំណាត់ថ្នាក់ក្រុម:ក្រលាផ្ទៃ	Categoria:Área
ទំព័រគំរូ:CURRENTMINUTE	Predefinição:CURRENTMINUTE
ទំព័រគំរូ:Substituted	Predefinição:Nota-subst
ទំព័រគំរូ:ទិន្នន័យ​នៃប្រទេសអ៊ូបេគីស្ថាន	Predefinição:UZB
ទំព័រគំរូ:Question	Predefinição:Pergunta
បញ្ជីរាយនាម ជ័យលាភីរង្វាន់ណូបែល ផ្នែកគីមីវិទ្យា	Laureados com o Nobel de Química
ទំព័រគំរូ:ខេត្ត-រាជធានីកម្ពុជា	Predefinição:Camboja/Divisões
ទំព័រគំរូ:ទិន្នន័យ នៃប្រទេសអេស្ប៉ាញ	Predefinição:Country data Espanha
ទំព័រគំរូ:Usage of IPA templates	Predefinição:Uso das predefinições IPA
ទំព័រគំរូ:Pad	Predefinição:Pad
ទំព័រគំរូ:If pagename	Predefinição:If pagename
ទំព័រគំរូ:ទិន្នន័យប្រទេស កាណាដា	Predefinição:Country data Canadá
ទំព័រគំរូ:Class	Predefinição:Class
ក្រុងសួង	Suong
ទំព័រគំរូ:Collapsible sections option	Predefinição:Collapsible sections option
ទំព័រគំរូ:Consensus	Predefinição:Consenso
ទំព័រគំរូ:Conservation status	Predefinição:Estado de conservação
ទំព័រគំរូ:Convert/BTU	Predefinição:Convert/BTU
ទំព័រគំរូ:Convert/Dual/LoffAoffDxSoffT	Predefinição:Convert/Dual/LoffAoffDxSoffT
ទំព័រគំរូ:Convert/LoffAoffDorSoff	Predefinição:Convert/LoffAoffDorSoff
ទំព័រគំរូ:Convert/LoffAonDsSoffT	Predefinição:Convert/LoffAonDsSoffT
ទំព័រគំរូ:Convert/and/AonSoff	Predefinição:Convert/and/AonSoff
ទំព័រគំរូ:Convert/list of units	Predefinição:Convert/lista de unidades
ទំព័រគំរូ:Convert/list of units/foot note	Predefinição:Convert/lista de unidades/pé notas
ទំព័រគំរូ:Convert/list of units/facdisp	Predefinição:Convert/lista de unidades/facdisp
ទំព័រគំរូ:Convert/list of units/rowNa	Predefinição:Convert/lista de unidades/rowNa
ទំព័រគំរូ:Convert/list of units/row	Predefinição:Convert/lista de unidades/row
ទំព័រគំរូ:Convert/list of units/rowbr	Predefinição:Convert/lista de unidades/rowbr
ទំព័រគំរូ:Convert/nm	Predefinição:Convert/nm
ទំព័រគំរូ:Convert/numdisp/frac1	Predefinição:Convert/numdisp/frac1
ទំព័រគំរូ:Convert/x/AonSoff	Predefinição:Convert/x/AonSoff
ទំព័រគំរូ:Cookbook	Predefinição:Livro de receitas
ទំព័រគំរូ:Coord/prec dec	Predefinição:Coord/prec dec
ទំព័រគំរូ:Flag	Predefinição:Flag
ទំព័រគំរូ:ទិន្នន័យប្រទេស ម៉ាល់ឌីវ	Predefinição:Country data Maldivas
ទំព័រគំរូ:ទិន្នន័យ នៃប្រទេសសិង្ហបុរី	Predefinição:Country data Singapura
ទំព័រគំរូ:ទិន្នន័យប្រទេស យេម៉ែន	Predefinição:Country data Iémen
ទំព័រគំរូ:Lang-pl	Predefinição:Lang-pl
ទំព័រគំរូ:Country flag IOC alias USA	Predefinição:Country flag IOC alias USA
ទំព័រគំរូ:Str right	Predefinição:Str right
ទំព័រគំរូ:Diff	Predefinição:Diff
ចំណាត់ថ្នាក់ក្រុម:Protection templates	Categoria:!Predefinições de proteção
វ៉ាន់ឌី កាអុន	Vandy Kaonn
ចំណាត់ថ្នាក់ក្រុម:ភាសាអង់គ្លេស	Categoria:Língua inglesa
ទំព័រគំរូ:FOSS	Predefinição:Software Livre
ទំព័រគំរូ:សង្គមនិយមតាមរដ្ឋ	Predefinição:Países socialistas
ទំព័រគំរូ:Scientists whose names are used as SI units	Predefinição:Cientistas cujos nomes são utilizados como unidades do SI
ទំព័រគំរូ:Monarchies	Predefinição:Monarquias
ទំព័រគំរូ:សំលៀកបំពាក់	Predefinição:Roupas
ទំព័រគំរូ:Fapages	Predefinição:PáginasAD
ទំព័រគំរូ:Guideline list	Predefinição:Lista de recomendações
ទំព័រគំរូ:Nature nav	Predefinição:Elementos da Natureza
ទំព័រគំរូ:Style	Predefinição:Wikipédia/Livro de estilo
ទំព័រគំរូ:ទីក្រុងធំៗបំផុតកម្ពុជា	Predefinição:Cidades mais populosas do Camboja
ទំព័រគំរូ:Natural sciences-footer	Predefinição:Ciências naturais
ទំព័រគំរូ:ឋានន្តរសក្ដិរាជវង្សនិងអភិជន	Predefinição:Classificação da Nobreza
ទំព័រគំរូ:Infobox country Olympics	Predefinição:Info/País nos Jogos Olímpicos
ទំព័រគំរូ:Number of portals	Predefinição:Número de portais
ទំព័រគំរូ:User vi-2	Predefinição:User vi-2
ទំព័រគំរូ:User vi-1	Predefinição:User vi-1
ទំព័រគំរូ:User id-2	Predefinição:User id-2
ទំព័រគំរូ:UF-hcard-geo	Predefinição:UF-hcard-geo
ទំព័រគំរូ:PDB	Predefinição:PDB
ទំព័រគំរូ:OMIM2	Predefinição:OMIM2
ទំព័រគំរូ:Nav book tool	Predefinição:Navegação do criador de livros
ទំព័រគំរូ:Likely	Predefinição:Provável
ទំព័រគំរូ:Lang-th	Predefinição:Lang-th
ទំព័រគំរូ:Lang-sq	Predefinição:Lang-sq
ទំព័រគំរូ:Lang-pi	Predefinição:Lang-pi
ទំព័រគំរូ:Lang-pa	Predefinição:Lang-pa
ទំព័រគំរូ:Lang-es	Predefinição:Lang-es
ទំព័រគំរូ:Lang-ca	Predefinição:Lang-ca
ទំព័រគំរូ:Lang-bo	Predefinição:Lang-bo
ទំព័រគំរូ:Lang-az	Predefinição:Lang-az
ទំព័រគំរូ:In5	Predefinição:In5
ទំព័រគំរូ:AprilCalendar	Predefinição:Calendário de abril
ទំព័រគំរូ:JuneCalendar	Predefinição:Calendário de junho
ទំព័រគំរូ:MarchCalendar	Predefinição:Calendário de março
ទំព័រគំរូ:ISO 639 name eo	Predefinição:ISO 639 nome eo
ទំព័រគំរូ:ISO 3166	Predefinição:ISO 3166
ទំព័រគំរូ:Getalias	Predefinição:Getalias
ចំណាត់ថ្នាក់ក្រុម:នាមត្រូលជនជាតិជប៉ុន	Categoria:Sobrenomes da língua japonesa
ចំណាត់ថ្នាក់ក្រុម:ពិជគណិត	Categoria:Álgebra
ចំណាត់ថ្នាក់ក្រុម:មុំ	Categoria:Ângulos
ចំណាត់ថ្នាក់ក្រុម:នព្វន្ធ	Categoria:Aritmética
ចំណាត់ថ្នាក់ក្រុម:ស្ពាននៅអាស៊ី	Categoria:Pontes da Ásia
ចំណាត់ថ្នាក់ក្រុម:ព្រះពុទ្ធសាសនានៅប្រទេសបារាំង	Categoria:Budismo na França
ទំព័រគំរូ:Multicol	Predefinição:Multicol
សិទ្ធិកុមារ	Direitos da criança
ចំណាត់ថ្នាក់ក្រុម:អាស៊ីខាងកើត	Categoria:Ásia Oriental
ទំព័រគំរូ:Chess diagram 6x6	Predefinição:Diagrama de xadrez 6x6
ចំណាត់ថ្នាក់ក្រុម:អេឡិចត្រូម៉ាញ៉េទិច	Categoria:Eletromagnetismo
ទំព័រគំរូ:Lang-mn	Predefinição:Lang-mn
ទំព័រគំរូ:Lang-sa	Predefinição:Lang-sa
ទំព័រគំរូ:Lang-sv	Predefinição:Lang-sv
វិគីភីឌា:វិគីគម្រោងប្រវត្តិសាស្ត្រ	Wikipédia:Projetos/História e sociedade
ទំព័រគំរូ:Precision/tz	Predefinição:Precision/tz
ទំព័រគំរូ:Precision/tz/1	Predefinição:Precision/tz/1
ទំព័រគំរូ:Lts	Predefinição:Lts
ចំណាត់ថ្នាក់ក្រុម:បណ្ណាល័យ	Categoria:Bibliotecas
ចំណាត់ថ្នាក់ក្រុម:មេរថក្រោះសមរភូមិ	Categoria:Tanques principais de batalha
ជំនួយ:Books/Frequently Asked Questions	Ajuda:Livros/Perguntas frequentes
ជំនួយ:Books/Printed books	Ajuda:Livros/Livros impressos
ចំណាត់ថ្នាក់ក្រុម:យន្តហោះយោធាគ្រូបណ្តុះបណ្តាល	Categoria:Aviões militares de instrução
ទំព័រគំរូ:ទិន្នន័យ​នៃប្រទេសម៉ុងហ្គោល	Predefinição:MNG
ទំព័រគំរូ:Pronunciation	Predefinição:Pronúncia
ចំណាត់ថ្នាក់ក្រុម:ចំនួនកុំផ្លិច	Categoria:Números complexos
ចំណាត់ថ្នាក់ក្រុម:គ្រោង​វិភាគ	Categoria:Análise de estruturas
ចំណាត់ថ្នាក់ក្រុម:Subtemplates of Template Convert	Categoria:Subtemplates da Predefinição Convert
ចំណាត់ថ្នាក់ក្រុម:User pfl	Categoria:Usuários pfl
ចំណាត់ថ្នាក់ក្រុម:ទំព័រគំរូTOC	Categoria:!Predefinições de tabela de conteúdo da Wikipédia
ទំព័រគំរូ:Image label begin	Predefinição:Image label begin
ចំណាត់ថ្នាក់ក្រុម:រង្វង់និងស៊្វែរ	Categoria:Círculos
ទំព័រគំរូ:Bg icon	Predefinição:((bg))
វិគីភីឌា:Requests	Wikipédia:Pedidos
ចំណាត់ថ្នាក់ក្រុម:កងកម្លាំងអាកាស	Categoria:Força aérea
ចំណាត់ថ្នាក់ក្រុម:សាកលវិទ្យាល័យនៅប្រទេសជប៉ុន	Categoria:Universidades do Japão
ចំណាត់ថ្នាក់ក្រុម:គ្រឹះស្ថានឧត្តមសិក្សានៅកម្ពុជា	Categoria:Universidades do Camboja
ទំព័រគំរូ:BirthsInCentury	Predefinição:Categoria de nascidos por século
ចំណាត់ថ្នាក់ក្រុម:វប្បធម៌ខ្មែរ	Categoria:Cultura do Camboja
ទំព័រគំរូ:Ombox/core	Predefinição:Ombox/core
ចំណាត់ថ្នាក់ក្រុម:User en-1	Categoria:Usuário en-1
ចំណាត់ថ្នាក់ក្រុម:Calendar templates	Categoria:!Predefinições de calendário
ចំណាត់ថ្នាក់ក្រុម:User de-1	Categoria:Usuário de-1
ទំព័រគំរូ:Asbox	Predefinição:Asbox
ទំព័រគំរូ:Nowrap begin	Predefinição:Nowrap begin
ទំព័រគំរូ:ខ្លីមិនពេញលេញ ព្រះពុទ្ធសាសនា	Predefinição:Esboço-budismo
ទំព័រគំរូ:Chaturanga diagram	Predefinição:Diagrama de chaturanga
ទំព័រគំរូ:សេរីភាព	Predefinição:Liberdade
ទំព័រគំរូ:ែដលកំពុងរឺកចំេរីន	Predefinição:Em construção
ទំព័រគំរូ:រដ្ឋ និងទឹកដីក្នុងមណ្ឌលឥទ្ធិពលជប៉ុនចក្រពត្តិកំឡុងសង្គ្រាមលោកលើកទី២	Predefinição:Esferas de influência do Japão durante a II Guerra Mundial
ទំព័រគំរូ:December calendar	Predefinição:Calendário de dezembro
ទំព័រគំរូ:JulyCalendar	Predefinição:Calendário de julho
ទំព័រគំរូ:Convert/AU	Predefinição:Convert/AU
ទំព័រគំរូ:Philippine Presidents	Predefinição:Presidentes das Filipinas
ទំព័រគំរូ:សង្គ្រាមត្រជាក់	Predefinição:Guerra Fria
ទំព័រគំរូ:ព្រះត្រៃបិដក	Predefinição:Cânonepali
ទំព័រគំរូ:Pipe	Predefinição:Pipe
វិគីភីឌា:WikiProject Council/Directory	Wikipédia:Projetos/Diretório
វិគីភីឌា:Tutorial/Keep in mind	Ajuda:Tutorial/A reter
ទំព័រគំរូ:Very large	Predefinição:Categoria grande
ទំព័រគំរូ:Organisation of Islamic Cooperation	Predefinição:OCI
ទំព័រគំរូ:Frac	Predefinição:Frac
ទំព័រគំរូ:Ntsh	Predefinição:Ntsh
ទំព័រគំរូ:Start date	Predefinição:Data de início
ទំព័រគំរូ:MediaWiki	Predefinição:MediaWiki
វិគីភីឌា:Contributing to Wikipedia	Wikipédia:Como contribuir para a Wikipédia
ទំព័រគំរូ:Law	Predefinição:Direito
ចំណាត់ថ្នាក់ក្រុម:ការធ្វើសេចក្ដីរាយការណ៏ពត៌មាន	Relatório
ទំព័រគំរូ:Mbox templates see also	Predefinição:Mbox/ver também
ទំព័រគំរូ:SMS	Predefinição:SMS
ទំព័រគំរូ:Religious text primary	Predefinição:Fonte primária religiosa
ទំព័រគំរូ:Unknown	Predefinição:Des
ទំព័រគំរូ:Terminated	Predefinição:Encerrado
ទំព័រគំរូ:Dropped	Predefinição:Caiu
ទំព័រគំរូ:Free	Predefinição:Livre
ទំព័រគំរូ:Bio-stub	Predefinição:Esboço-biografia
ទំព័រគំរូ:អតីតអាណានិគមបារាំងនៅអាស៊ី និងអូសេអានី	Predefinição:Antigas colónias francesas na Ásia e Oceania
ទំព័រគំរូ:Nonfree	Predefinição:Nãolivre
ទំព័រគំរូ:FPO number	Predefinição:Número de portais destacados
ទំព័រគំរូ:Isfdb name	Predefinição:Isfdb nome
ទំព័រគំរូ:Table-experimental	Predefinição:Tabela-experimental
ទំព័រគំរូ:Tim	Predefinição:Tim
ទំព័រគំរូ:Other category header templates	Predefinição:Domínio categoria
ទំព័រគំរូ:Andorra topics	Predefinição:Tópicos de Andorra
ទំព័រគំរូ:Incorrect	Predefinição:Incorreto
ទំព័រគំរូ:Last edited by	Predefinição:Última edição por
ទំព័រគំរូ:List navbox	Predefinição:Navbox Lista
ទំព័រគំរូ:ប្រវត្តិសាស្ត្រខ្មែរ	Predefinição:História do Camboja
ទំព័រគំរូ:La Francophonie	Predefinição:OIF
ទំព័រគំរូ:WikiProject Footer	Predefinição:Rodapé Wikiprojeto
ទំព័រគំរូ:Infobox ខេត្តក្រុងឡាវ	Predefinição:Info/Província do Laos
វិគីភីឌា:Tutorial/Wrap-up and more info	Ajuda:Tutorial/Sumário
វិគីភីឌា:Project namespace	Wikipédia:Domínio Wikipédia
ទំព័រគំរូ:Buddhism-Horizontal	Predefinição:Budismo2
ទំព័រគំរូ:ចក្រភពនាយសមុទ្ររបស់បារាំង	Predefinição:Império ultramarino francês
ទំព័រគំរូ:ព្រះពុទ្ធសាសនាថេរវាទ	Predefinição:Teravada
ទំព័រគំរូ:Possible	Predefinição:Possível
ទំព័រគំរូ:Specialpageslist	Predefinição:Wikipedia/Páginas especiais
ទំព័រគំរូ:National flags	Predefinição:Bandeiras nacionais
ទំព័រគំរូ:Loc	Predefinição:Loc
ទំព័រគំរូ:Infobox file format	Predefinição:Info/Formato de ficheiro
ទំព័រគំរូ:Elect	Predefinição:Eleito
ទំព័រគំរូ:អត្ថបទខ្លី អំពីកម្ពុជា	Predefinição:Esboço-Camboja
ទំព័រគំរូ:Images	Predefinição:Imagens
វិគីភីឌា:WikiProject Military history/Military navigation	Predefinição:Navegação militar
ទំព័រគំរូ:No result	Predefinição:Sem resultado
ទំព័រគំរូ:Multi-column numbered list	Predefinição:Multi-column numbered list
វិគីភីឌា:Version 1.0 Editorial Team	Wikipédia:Versão 1.0
ទំព័រគំរូ:Declined	Predefinição:Rejeitado
ទំព័រគំរូ:Sidebar with heading backgrounds	Predefinição:Sidebar with heading backgrounds
ទំព័រគំរូ:សមាជិកសហភាពអឺរ៉ុប	Predefinição:Membros da União Europeia
វិគីភីឌា:Birthday Committee	Wikipédia:Aniversário dos wikipedistas
ទំព័រគំរូ:EC number	Predefinição:Número EC
វិគីភីឌា:WikiProject Buddhism	Wikipédia:Projetos/Budismo
ទំព័រគំរូ:Portal nav footer	Predefinição:Portal nav footer
ទំព័រគំរូ:Unrelated	Predefinição:Sem relação
ទំព័រគំរូ:Thank	Predefinição:Obrigado
ទំព័រគំរូ:នយោបាយកម្ពុជា	Predefinição:Política do Camboja
ទំព័រគំរូ:User id-1	Predefinição:User id-1
ទំព័រគំរូ:វីគីភីឌា-សៀវភៅ	Predefinição:Livro
ទំព័រគំរូ:Denied	Predefinição:Recusado
ទំព័រគំរូ:Infobox Buddhist term	Predefinição:Infobox/Termo budista
ទំព័រគំរូ:Scientists whose names are used as non SI units	Predefinição:Cientistas cujos nomes são utilizados como unidades não SI
ទំព័រគំរូ:Nuttall	Predefinição:Nuttall
ទំព័រគំរូ:TVQ	Predefinição:TVQ
ទំព័រគំរូ:Subpages	Predefinição:Subpáginas
ទំព័រគំរូ:IPAlink	Predefinição:IPA link
ទំព័រគំរូ:UN document	Predefinição:Documento da ONU
ក្រសួងអប់រំ យុវជន និងកីឡា	Ministério da Educação, Juventude e Desporto (Camboja)
ទំព័រគំរូ:Outline footer	Predefinição:Outline footer
វិគីភីឌា:WikiProject Council	Wikipédia:Conselho de WikiProjetos
ទំព័រគំរូ:ForLoop/aux	Predefinição:ForLoop/aux
ទំព័រគំរូ:S-hou	Predefinição:S-hou
ទំព័រគំរូ:Journalism	Predefinição:Jornalismo
ទំព័រគំរូ:The Sun	Predefinição:O Sol
ទំព័រគំរូ:Mammals	Predefinição:Mamíferos
ទំព័រគំរូ:Importance	Predefinição:Importance
វិគីភីឌា:Help namespace	Wikipédia:Domínio de ajuda
ទំព័រគំរូ:Unnecessary	Predefinição:Desnecessário
ទំព័រគំរូ:Dynamic list	Predefinição:Lista dinâmica
ទំព័រគំរូ:Politics sidebar	Predefinição:Política
ទំព័រគំរូ:Infobox Chinese	Predefinição:Info/Chinês
ទំព័រគំរូ:Infobox Monarchy	Predefinição:Info/Monarquias
ទំព័រគំរូ:Location map many	Predefinição:Mapa de localização muitos
ទំព័រគំរូ:Worldcat id	Predefinição:Worldcat id
វិគីភីឌា:Tutorial/TabsHeader	Ajuda:Tutorial/AbasCabeçalho
ទំព័រគំរូ:Tltts	Predefinição:Tltts
ទំព័រគំរូ:Efn	Predefinição:Efn
ទំព័រគំរូ:Location map/decdeg	Predefinição:Mapa de localização/decdeg
ទំព័រគំរូ:FullURL Diff	Predefinição:FullURL Diff
ទំព័រគំរូ:S-ppo	Predefinição:S-ppo
ទំព័រគំរូ:Time	Predefinição:Tempo
ចំណាត់ថ្នាក់ក្រុម:យន្តហោះប្រដេញ	Categoria:Aviões militares de caça
ទំព័រគំរូ:Element color/Actinoids	Predefinição:Elemento/Cor actinídios
ទំព័រគំរូ:Element color/Alkaline earth metals	Predefinição:Elemento/Cor metais alcalino-terrosos
ទំព័រគំរូ:Sec link/text	Predefinição:Sec link/text
ទំព័រគំរូ:Weather box/colh	Predefinição:Infobox weather/colh
ទំព័រគំរូ:Convert/to(-)	Predefinição:Convert/to(-)
ទំព័រគំរូ:Convert/list of units/item	Predefinição:Convert/lista de unidades/item
ទំព័រគំរូ:Convert/list of units/rowtop	Predefinição:Convert/lista de unidades/rowtop
ទំព័រគំរូ:Convert/list of units/area/short list	Predefinição:Convert/lista de unidades/área/lista curta
ទំព័រគំរូ:Str len/core	Predefinição:Str len/core
ទំព័រគំរូ:Respell	Predefinição:Respell
ទំព័រគំរូ:Rnd/-	Predefinição:Rnd/-
ទំព័រគំរូ:Noitalic	Predefinição:Noitalic
ទំព័រគំរូ:Sun	Predefinição:Sol (estrela)
ទំព័រគំរូ:\	Predefinição:\
ទំព័រគំរូ:Google+	Predefinição:Google+
ទំព័រគំរូ:Divbox/style/green	Predefinição:Divstylegreen
ទំព័រគំរូ:Divbox/style/none	Predefinição:Divstylenone
ទំព័រគំរូ:Indian Rupee	Predefinição:Rupia indiana
ទំព័រគំរូ:IPAslink	Predefinição:IPAslink
ទំព័រគំរូ:Office-table	Predefinição:Cargo-tabela
ទំព័រគំរូ:Discreet abbreviation	Predefinição:Abreviatura discreta
ទំព័រគំរូ:Multi-listen item	Predefinição:Multi-escuta item
ទំព័រគំរូ:Element color/Alkali metals	Predefinição:Elemento/Cor metais alcalinos
ទំព័រគំរូ:Element color/Lanthanoids	Predefinição:Elemento/Cor lantanídios
ទំព័រគំរូ:Element color/Other nonmetals	Predefinição:Elemento/Cor não-metais
ទំព័រគំរូ:Infobox settlement/areadisp	Predefinição:Areadisp
ទំព័រគំរូ:Hidden sort key	Predefinição:Ord
ទំព័រគំរូ:សិទ្ធិ	Predefinição:Direitos
ទំព័រគំរូ:Numrec/Kosovo	Predefinição:Kosovorecognition
ទំព័រគំរូ:Collapsible lists option	Predefinição:Collapsible lists option
ទំព័រគំរូ:IUCN2011.2	Predefinição:IUCN2011.2
ទំព័រគំរូ:Cite comic	Predefinição:BDBibliografia
ទំព័រគំរូ:Infobox National Olympic Committee	Predefinição:Info/NOC
ទំព័រគំរូ:Infobox អាកាសធាតុ/line	Predefinição:Infobox weather/line
ទំព័រគំរូ:Weather box/colp	Predefinição:Infobox weather/colp
ទំព័រគំរូ:Weather box/colt	Predefinição:Infobox weather/colt
កំប្រុកព័ណ៌	Callosciurus prevosti
ជំនួយ:ការប្តូរទីតាំងទំព័រ	Ajuda:Guia de edição/Redirecionar páginas
ទំព័រគំរូ:ប្រអប់ព័ត៌មាន ភាសា/genetic2	Predefinição:Info/Língua/genetic2
ទំព័រគំរូ:Convert/Dual/LoffAnoneDbSoff	Predefinição:Convert/Dual/LoffAnoneDbSoff
ទំព័រគំរូ:Convert/list of units/rowtopNa	Predefinição:Convert/lista de unidades/rowtopNa
ទំព័រគំរូ:Class/colour	Predefinição:Classcol
ទំព័រគំរូ:MoreInfo	Predefinição:Mais info
ទំព័រគំរូ:Inprogress	Predefinição:Em progresso
ទំព័រគំរូ:Style/IPA	Predefinição:Style/IPA
ទំព័រគំរូ:Style/yid	Predefinição:Style/yid
ទំព័រគំរូ:Infobox comics location	Predefinição:Info/Lugar fictício
ទំព័រគំរូ:Project header	Predefinição:Projeto
ទំព័រគំរូ:Weather box/cols	Predefinição:Infobox weather/cols
ទំព័រគំរូ:Fishing	Predefinição:Pesca
ទំព័រគំរូ:Sec link/relative url	Predefinição:Sec link/relative url
ទំព័រគំរូ:Tmbox/core	Predefinição:Tmbox/core
ទំព័រគំរូ:Unlikely	Predefinição:Improvável
ទំព័រគំរូ:Inconclusive	Predefinição:Inconclusivo
ទំព័រគំរូ:Scinote/e	Predefinição:Scinote/e
ទំព័រគំរូ:Asbox/stubtree/2	Predefinição:Asbox/stubtree/2
ទំព័រគំរូ:Football kit/pattern list	Predefinição:Football kit/pattern list
ទំព័រគំរូ:Divbox/style/blue	Predefinição:Divstyleblue
ទំព័រគំរូ:Divbox/style/plain	Predefinição:Divstyleplain
ទំព័រគំរូ:Divbox/style/yellow	Predefinição:Divstyleyellow
ទំព័រគំរូ:Language icon/Notes	Predefinição:Languageicon/Notas
ទំព័រគំរូ:សេដ្ឋកិច្ច	Predefinição:Economia
ទំព័រគំរូ:ទិន្នន័យប្រទេស អូម៉ង់	Predefinição:Country data Omã
ទំព័រគំរូ:ទិន្នន័យប្រទេស កាមេរូន	Predefinição:Country data Camarões
វិគីភីឌា:Tutorial/Tabs	Ajuda:Tutorial/Abas
វិគីភីឌា:Tutorial/Tab1	Wikipédia:Tutorial/Aba1
វិគីភីឌា:Tutorial/Tab2	Ajuda:Tutorial/Aba2
វិគីភីឌា:Tutorial/TabsBottom	Ajuda:Tutorial/AbasFundo
សន្ធិសញ្ញាសន្តិភាពទីក្រុងប៉ារីស ឆ្នាំ១៩៩១	Acordos de Paz de Paris de 1991
ព្យុះហៃយ៉ាន	Tufão Haiyan (2013)
ពិសេស:បំលាស់ប្ដូរថ្មីៗ	Especial:Mudanças recentes
ខណ្ឌពោធិ៍សែនជ័យ	Porsenchey
Module:Citation/CS1	Módulo:Citation/CS1
ខេត្តត្បូងឃ្មុំ	Tbong Khmum
Module:HtmlBuilder	Módulo:HtmlBuilder
Module:Navbox	Módulo:Navbox
វិគីភីឌា:Barnstars 2.0/Awards by WikiProject	Wikipédia:Medalhas/Lista
Call of Duty: Advanced Warfare	Call of Duty: Advanced Warfare
បញ្ជីនៃទង់ជាតិអង្គភាពរដ្ឋបាលរាជវង្សង្វៀនរបស់	Bandeiras das unidades administrativas da dinastia Nguyen
