Noowe	Noruega
Amereka	Estados Unidos
Finilandi	Finlândia
Swiiden	Suécia
Denimaaka	Dinamarca
Bupoolo	Polónia
Lithueenia	Lituânia
Yitale	Itália
Buyonaani	Grécia
Buturuki	Turquia
Bulaaya	Europa
Wikipedia	Wikipédia
Berlin	Berlim
Paris	Paris
Gatonnya	Janeiro
Kenya	Quénia
Mbwa	Canis lupus familiaris
Rwasha	Rússia
Girimane	Alemanha
Isilandi	Islândia
Emu	Um
Bbiri	Dois
Ssatu	Três
Nnya	Quatro
Ttaano	Cinco
Zeero	0 (número)
Vilnius	Vilnius
Chile	Chile
Jesu Kristo	Jesus
Mathematics	Matemática
Napooleon Bonapat	Napoleão Bonaparte
Moosko	Moscovo
Ebimera	Plantae
Nepal	Nepal
Tanzania	Tanzânia
Yuganda	Uganda
Uetersen	Uetersen
Helsinki	Helsínquia
Baibuli	Bíblia
Ho Chi Minh City	Cidade de Ho Chi Minh
Kkanisa ya Yeso Eyannamaddala	Verdadeira Igreja de Jesus
Dong Hoi	Dong Hoi
Concepción	Concepción (Chile)
Kurów	Kurów
Santiago, Chile	Santiago (Chile)
Kampala	Kampala
Osasco	Osasco
Curitiba	Curitiba
Category:Okubala	Categoria:Matemática
Olupapula Olusooka	Wikipédia:Página principal
Saratov	Saratov
Category:Candidates for speedy deletion	Categoria:!Páginas para eliminação rápida
Kilimanjaro	Kilimanjaro
Ekiwandiiko Eky'abantu Bonna Ekifa ku Ddembe Ly'obunto	Declaração Universal dos Direitos Humanos
Ronald Reagan	Ronald Reagan
Fernando Alonso	Fernando Alonso
Ennamba	Número
Template:Link FA	Predefinição:Link FA
Wikipedia:Community Portal	Wikipédia:Esplanada
Mwenda	Nove
Bien Hoa	Bien Hoa
Nha Trang	Nha Trang
Breinigerberg	Breinigerberg
Vung Tau	Vũng Tàu
Musanvu	Sete
Munaana	Oito
Mukaaga	Seis
Moshchena	Mostchena
Paltoga	Paltoga
Entrena	Entrena
Las Vegas	Las Vegas
Kkumi	Dez
Nowy Dwór Królewski	Nowy Dwór Królewski
Ca Mau	Cà Mau (cidade)
Pichilemu	Pichilemu
Phan Thiet	Phan Thiet
Reverse transcriptase	Transcriptase reversa
Luganda	Língua luganda
Buon Ma Thuot	Buon Ma Thuot
Anastacia	Anastacia
Ben Tre	Ben Tre (cidade)
Kkumi na bbiri	Doze
Kkumi n'emu	Onze
Kkumi na ssatu	Treze
Kikumi	Cem
Kakadde kamu	Milhão
Kkumi na nnya	Catorze
Sekazzi	Melancia
Kkumi na ttaano	Quinze
Kkumi na munaana	Dezoito
Kkumi na mwenda	Dezanove
Kkumi na musanvu	17 (número)
Kkumi na mukaaga	Dezasseis
Amakumi abiri	Vinte
Amakumi ana	Quarenta
Amakumi asatu	Trinta
Lukumi	Mil
Lacuna Coil	Lacuna Coil
Amakumi abiri mu ssatu	Vinte e três
Ekirwadde ky’ebola	Doença por vírus Ébola
Amakumi abiri mu ttaano	Vinte e cinco
Amakumi abiri mu nnya	Vinte e quatro
Nkaaga	Sessenta
Coronel Fabriciano	Coronel Fabriciano
Amakumi abiri mu mukaaga	Vinte e seis
Caayi	Camellia sinensis
Mbogo	Búfalo-africano
Ntaulira	Ratel
Retrovirus	Retroviridae
Bikumi bitaano	Quinhentos
Kyenda	Noventa
Nkumi bbiri	Dois mil
Ntulege	Equus quagga
Lukaaga	Seiscentos
Enkima	Chlorocebus aethiops
Amakumi ana mu ssatu	Quarenta e três
Mutwalo gumu	Dez mil
Amakumi abiri mu musanvu	Vinte e sete
Amakumi asatu mu ttaano	Trinta e cinco
Jens Galschiøt	Jens Galschiøt
Paramore	Paramore
Buganda	Buganda
Amakumi abiri mu mwenda	Vinte e nove
Amakumi abiri mu munaana	Vinte e oito
Amakumi asatu mu munaana	Trinta e oito
Amakumi ana mu ttaano	Quarenta e cinco
Kinaana	Oitenta
Abiri mu emu	Vinte e um
Abiri mu bbiri	Vinte e dois
Nsanvu	Setenta
Amakumi ataano	Cinquenta
Amakumi ana mu emu	Quarenta e um
Amakumi asatu mu nnya	Trinta e quatro
Amakumi asatu mu ssatu	Trinta e três
Amakumi ana mu musanvu	Quarenta e sete
Amakumi asatu mu emu	Trinta e um
Amakumi asatu mu bbiri	Trinta e dois
Amakumi ana mu nnya	Quarenta e quatro
Amakumi ana mu mukaaga	Quarenta e seis
Amakumi asatu mu musanvu	Trinta e sete
Amakumi asatu mu mwenda	Trinta e nove
Amakumi asatu mu mukaaga	Trinta e seis
Bikumi bibiri	Duzentos
Lusanvu	Setecentos
Lwenda	Novecentos
Jonava	Jonava
Lunaana	Oitocentos
Klaipėda	Klaipėda
Amakumi ana mu bbiri	Quarenta e dois
Bikumi bisatu	Trezentos
Category:Girimane	Categoria:Alemanha
Category:Yitale	Categoria:Itália
Category:Rwasha	Categoria:Rússia
Category:Buturuki	Categoria:Turquia
Category:Bupoolo	Categoria:Polónia
Category:Vietnam	Categoria:Vietname
Category:Ebimera	Categoria:Plantas
Category:Okumanya	Categoria:Ciência
Bikumi bina	Quatrocentos
Pillar of shame (Empagi yo Buswavu)	A Coluna da Infâmia
Category:Stub	Categoria:!Esboços
Angolemi	Angolemi
Category:Ensi	Categoria:Países
Wikipedia:Administrators	Wikipédia:Administradores
Wikipedia:Vital 100	Wikipédia:Lista dos artigos que toda Wikipédia deve ter/Nível 2
Kaunas	Kaunas
Template:Bot	Predefinição:Robô
Category:Denimaaka	Categoria:Dinamarca
Category:Finilandi	Categoria:Finlândia
Category:Isilandi	Categoria:Islândia
Category:Lithueenia	Categoria:Lituânia
Category:Swiiden	Categoria:Suécia
Category:Bulaaya	Categoria:Europa
Template:Documentation	Predefinição:Documentação
Category:Wikipedians by language	Categoria:!Wikipedistas por idioma
Wikipedia:Userbox	Wikipédia:Userbox
Template:Softredirect	Predefinição:Pseudorredirecionamento
Template:Delete	Predefinição:ER
Category:Wikipedia	Categoria:Wikipédia
Wikipedia:Statistics	Wikipédia:Estatísticas
Template:Col-break	Predefinição:Col-break
Template:Col-begin	Predefinição:Col-begin
Wikipedia:Vital articles	Wikipédia:Artigos essenciais
Category:Aafrika	Categoria:África
Category:Ennamba	Categoria:Números
Template:Babel	Predefinição:Babel
Template:Stub	Predefinição:Esboço
Template:See also	Predefinição:VT
Template:User de	Predefinição:User de
Template:User de-1	Predefinição:User de-1
Template:User de-3	Predefinição:User de-3
Template:User en-3	Predefinição:User en-3
Template:User en-2	Predefinição:User en-2
Template:User lg-4	Predefinição:User en-4
Template:User en-0	Predefinição:User en-0
Template:User en	Predefinição:User en
Template:User tr	Predefinição:User tr
Category:Eezia	Categoria:Ásia
Template:Esoteric	Predefinição:Predefinição complexa
Template:Mod	Predefinição:Mod
Template:User sv	Predefinição:User sv
Template:SIL	Predefinição:ISO639-3Documentação
Template:Image label	Predefinição:Image label
Template:Done	Predefinição:Feito
Template:Documentation/docname	Predefinição:Documentação/nomedoc
Category:User en	Categoria:Usuários en
Category:User en-2	Categoria:Usuário en-2
Template:Infobox	Predefinição:Info
Template:User nl-2	Predefinição:User nl-2
Category:Byabulimi	Categoria:Agricultura
Category:Language user templates	Categoria:!Predefinições de babel
Template:User nl	Predefinição:User nl
Template:Image label end	Predefinição:Image label end
Template:POL	Predefinição:POL
Template:Image label small	Predefinição:Image label small
Template:Bulaaya	Predefinição:Mapa detalhado da Europa
Template:User lt	Predefinição:User lt
Template:User is	Predefinição:User is
Template:@	Predefinição:@
Category:Infobox templates	Categoria:!Predefinições de caixas de informação
Template:FRA	Predefinição:FRA
Category:User lt	Categoria:Usuários lt
Category:User lg	Categoria:Usuários lg
Template:User ru-2	Predefinição:User ru-2
Category:User sv-3	Categoria:Usuário sv-3
Category:User tr	Categoria:Usuários tr
Category:User tr-N	Categoria:Usuário tr
Template:Lang	Predefinição:Lang
Template:User sv-3	Predefinição:User sv-3
Template:User kk-2	Predefinição:User kk-2
Template:User lb-2	Predefinição:User lb-2
Template:User lg-2	Predefinição:User lg-2
Category:Yuganda	Categoria:Uganda
Category:Noowe	Categoria:Noruega
Category:Capitals of the World	Categoria:Capitais
Template:UGA	Predefinição:UGA
Template:Lang-pl	Predefinição:Lang-pl
Trojany	Trojany
Template:User sw	Predefinição:User sw
Template:Image label begin	Predefinição:Image label begin
Wikipedia:VisualEditor	Wikipédia:Editor Visual
Special:RecentChanges	Especial:Mudanças recentes
Kikajjo	Saccharum
