Naakaii Łizhiní Bikéyah	África
Binaʼadaałtzózí Dinéʼiʼ Bikéyah	Japão
Bitsiighaʼ Łichííʼí Bikéyah	República da Irlanda
Hángewii	Hungria
Dibé Diníí Bikéyah	Espanha
Wááshindoon Bikéyah Ałhidadiidzooígíí	Estados Unidos
Bélgii Bikéyah	Bélgica
Látsębooʼ	Luxemburgo
Yágháhookáán	Universo
Nahasdzáán	Terra
Nahoditsʼǫʼłání	Finlândia
Déinish Dineʼé Bikéyah	Dinamarca
Póolish Dineʼé Bikéyah	Polónia
Łitʼoowę́ęya	Lituânia
Ídelii	Itália
Swis Bikéyah	Suíça
Óóswiya	Áustria
Gwíík Dineʼé Bikéyah	Grécia
Tʼóok Bikéyah	Turquia
Béésh Bichʼahníí Bikéyah	Europa
(*@@@u0026asia")	Ásia
Shádiʼááhjí kéyah yistinígíí	Antártida
Kéyah Wóyahgo Siʼánígíí	Países Baixos
Béésh bee akʼeʼelchíhí tʼáá bí nitsékeesígíí	Computador
Hastiin alą́ąjįʼ dahsidáhígíí Barack Obama	Barack Obama
Táłtłʼááh Chʼosh Bitooh (Kéyah Dah Siʼánígíí)	Uruguai
Bilasáana	Maçã
Méhigo	México
Akééháshį́į́h Hahoodzo	Califórnia
Máaz	Marte (planeta)
Kénya	Quénia
Iithiyópya	Etiópia
Gáana	Gana
Náshdóítsoh bitsiijįʼ daditłʼooígíí	Leão
Dáághahii Dinéʼiʼ Bikéyah	França
Łééchąąʼí	Canis lupus familiaris
Tótaʼ Dinéʼiʼ Bikéyah	Reino Unido
Mósí	Gato
Dáághahii bizaad	Língua francesa
Łóóʼ	Peixe
Bwazííl	Brasil
Biʼééʼ Łichííʼí Bikéyah	Rússia
Łóóʼtsoh dóó Tééh hóyáanii	Cetáceos
Naakaii bichʼil łitsxooí	Manga (fruta)
Élábéemah Hahoodzo	Alabama
Béésh Bichʼahii Bikéyah	Alemanha
Bééshbichʼahii bizaad	Língua alemã
Tin Bikéyah	Islândia
Ééstii Bikéyah	Estónia
Séetin	Saturno (planeta)
Chidí naatʼaʼí	Avião
Hastiin alą́ąjįʼ dahsidáhígíí George W. Bush	George W. Bush
Létbiiya	Letónia
Yóókwein	Ucrânia
Chek Bikéyah	República Checa
Słóbaʼ Bikéyah	Eslováquia
Słobíín Bikéyah	Eslovénia
Wooméiniya	Roménia
Bálgaa Bikéyah	Bulgária
Dziłigaii Bikéyah	Albânia
Haʼaʼaahjí Hakʼaz Dineʼé Bikéyah	Gronelândia
Kwóóʼad Bikéyah	Croácia
Bosna dóó Hetsog Bikéyah	Bósnia e Herzegovina
Azééwii Bikéyah	Azerbaijão
Andówa	Andorra
Béésh Łichíiʼii Bikéyah	Chipre
Jóojah (Kéyah)	Geórgia
Kʼazah Bikéyah	Cazaquistão
Dziłizhin Bikéyah	Montenegro
Bádikin Sídii	Vaticano
San Mawínoo Bikéyah	San Marino
Kyóoba	Cuba
Hashkʼaan Bikéyah	Barbados
Indoníízha	Indonésia
Tʼóok bizaad	Língua turca
Kéyah Naakai Łizhinii Bikéyah Shádiʼááhjí Siʼánígíí	África do Sul
Aljííya	Argélia
Ózbeʼ Bikéyah	Uzbequistão
Tó	Água
Níłchʼi naalkidí	Televisão
Chíilii	Chile
Doodaatsaahii (Jíísas)	Jesus
Mókiwii	Mercúrio (planeta)
Ákáʼátʼįįł (béésh ntsékeesígíí álʼíní)	Apple
Biinis	Vénus (planeta)
Jíbitoo	Júpiter (planeta)
Yoowéinis	Urano (planeta)
Néʼtoon	Netuno (planeta)
Sį́ʼgaboo	Singapura
Tłóotoo	Plutão
Łííhtensain	Liechtenstein
Dágháilchįįh	Adolf Hitler
Naaltsoos biniiʼ	Facebook
Naaki góneʼ yéigo daʼahijoogą́ą́ʼ	Segunda Guerra Mundial
Ałhíʼayiiltááh	Matemática
Aooméénii Bikéyah	Arménia
Ooljééʼ	Lua
Nahatʼeʼiitsoh Bikéyah	Austrália
Béésh Łigaii Bikéyah	Argentina
Kolíya Bikéyah Náhookǫsjí Siʼánígíí	Coreia do Norte
Naayééʼ	Dinossauros
Bilasáana bitseeʼ nineezígíí	Pera
Naturalis Historia of Pliny the Elder	Naturalis Historia
Encyclopædia Britannica	Encyclopædia Britannica
Tó yaʼnidaʼaazgééd	Aqueduto
Chʼil łitsooí díkʼǫ́zhígíí	Limão
Hashkʼaan (łitsooígíí)	Banana
Sǫʼ	Estrela
Jóhonaaʼéí	Sol
Háájiʼjin	Hidrogénio
Níłchʼi Ászólí	Hélio
Haʼaʼaahjí Tíímow	Timor-Leste
Séwes	Ceres (planeta anão)
Haʼooméya	Haumea
Maakiimaakii	Makemake
Ééwis	Éris (planeta anão)
Káábin	Carbono
Níłchʼi Yáʼátʼéehii	Oxigénio
Hadoh dóó hakʼaz neiłkidígíí	Termômetro
Níłchʼi Łitsxooí	Néon
Chihuahua Hahoodzo	Chihuahua
Soodin	Sódio
Béésh Łikoní	Magnésio
Béésh Ászólí	Alumínio
Tó Wónaanídę́ę́ʼ Bitsįʼ Yishtłizhii Bikéyah	Índia
Tʼoobááloo	Tuvalu
Béésh (Fe)	Ferro
Tʼónga	Tonga
Łeetsoii	Enxofre
Samóa	Samoa
Sólomon Tó Bináhaazyínígíí	Ilhas Salomão
Banoʼáátʼoo	Vanuatu
Páápowa Bigíní Ániidí	Papua-Nova Guiné
Níłchʼi Dootłʼizhí	Árgon
Eʼeʼaahjí Tónteel bikáaʼgi Kéyah Yázhí dah Ndaaʼeełgo Ałhidadiidzooígíí	Estados Federados da Micronésia
Káálsiiyin	Cálcio
Dilyį́hí	Chumbo
Kílíbas	Kiribati
Chʼah Diʼilii Bikéyah	Mongólia
Fííjii	Fiji
Béésh doo Ńdiniichxíihii	Titânio
Táłkááʼ Bighan Dineʼé Bikéyah	Venezuela
Méíin Hahoodzo	Maine
Łį́į́ʼ	Equus ferus caballus
Naaldeehii	Animalia
Sówinam	Suriname
Kéyah Nahasdzáán Ałníiʼgi Siʼánígíí	Equador
Kolámbiya	Colômbia
Béésh Łibáhí	Cobalto
Bolíbiya	Bolívia
Béésh Łichíiʼii	Cobre
Niihémpshoo Hahoodzo	Nova Hampshire
Chʼosh doo yitʼíinii dláádí dóó Ábishjaaʼ	Fungi
Jaméíkʼa	Jamaica
Méésíchóoshish Hahoodzo	Massachusetts
Kanédikiʼ Hahoodzo	Connecticut
Naaʼahóóhai	Gallus gallus domesticus
Antíígwa dóó Hashkʼaan Bikéyah Yázhí	Antígua e Barbuda
Kéyah Ałkéé Nitį́įgo Dah Ndaaʼeełí	Havaí
Damóo Bikéyah	Dominica
Domingo Bikéyah	República Dominicana
Bisóodi	Sus domesticus
Héítii	Haiti
Iiwą́ą́	Irão
Iiwááʼ	Iraque
Hakʼaz Dineʼé Bikéyah Hahoodzo	Alasca
Ízrel Bikéyah	Israel
Shádiʼááhjí Ásáí Bikéyah	Iémen
Jóoʼdan	Jordânia
Gah Bikeeʼ Taahíʼahí	Flórida
Kíígiz Bikéyah	Quirguistão
Hoozdo Hahoodzo	Arizona
Kóóweiʼ	Kuwait
Lááʼos	Laos
Łíbanoo	Líbano
Óogin Hahoodzo	Oregon
Naakaii Dootłʼizhí Bikéyah Yázhí (Tó Bináhaazyínígíí)	Maldivas
Kéyah dah siʼánígíí	América
Áshįįh Biiʼtó Hahoodzo	Utah
Béégashii	Bos taurus
Maléízha	Malásia
Dziłgaiitsoh Honeezkʼazii Bikéyah	Nepal
Omą́ą́	Omã
Eʼeʼaahjí Naakaii Dootłʼizhí Bikéyah	Paquistão
Kʼatár	Catar
Ásáí Bikéyah Saʼoodí	Arábia Saudita
Swii Lankʼa	Sri Lanka
Sííwiya	Síria
Tʼajiʼ Bikéyah	Tajiquistão
Tʼáí Bikéyah	Tailândia
Kǫʼ naʼałbąąsii diné bee nágéhéʼ	Trem
Tʼóokmen Bikéyah	Turquemenistão
Ásáí Bikéyah Yázhí Ałhidadiidzooígíí	Emirados Árabes Unidos
Biʼednam	Vietname
Kolíya Bikéyah Shádiʼááhjí Siʼánígíí	Coreia do Sul
Óola	Ouro
Naʼałkaahí	Cientista
Bangla Bikéyah	Bangladesh
Angóola	Angola
Iiʼniʼ Tłʼiishtsoh Bikéyah	Butão
Bwoonéí	Brunei
Tʼanzanííya	Tanzânia
Béésh Tózháanii	Mercúrio (elemento químico)
Kéyah Dańlíinii	Filipinas
Naakaii Łizhinii Bikéyah Beʼałnííʼ	República Centro-Africana
Hastiin Albert Einstein	Albert Einstein
Tʼóogo	Togo
Hooghan Tsé Bee Ádaalyaaí Bikéyah	Zimbabwe
Shádiʼááhjí Soodą́ą	Sudão do Sul
Tswana Dineʼé Bikéyah	Botswana
Wóndii Dineʼé Bikéyah	Burundi
Ooljééʼ Bikéyah Yázhí	Comores
Kéyah Káango Náhookǫsjí Siʼánígíí	República do Congo
Kéyah Káango Shádiʼááhjí Siʼánígíí	República Democrática do Congo
Jibótii	Djibouti
Gíní Nahasdzáán Ałníiʼgi Siʼánígíí	Guiné Equatorial
Gabǫ́ǫ́ (Kéyah)	Gabão
Géémbiya	Gâmbia
Gíní	Guiné
Gíní Bisó	Guiné-Bissau
Chį́į́h Yee Adilohii Bideeʼ Tónteel Bibąąh	Costa do Marfim
Táłtłʼááh Chʼosh Daadánígíí Bitooh (Łizhinii Bikéyahdi)	Camarões
Tónteel Bibąąh Dootłʼizhí	Cabo Verde
Sotho Dineʼé Bikéyah	Lesoto
Łíbya	Líbia
Madaʼgéésgáá	Madagáscar
Malááwii	Malawi
Moowitéínya	Mauritânia
Moroko	Marrocos
Namííbya	Namíbia
Yogénda	Uganda
Wánda Dineʼé Bikéyah	Ruanda
Seishel	Seicheles
Náshdóítsoh Bitsiijįʼ Daditłʼooʼígíí Bidził	Serra Leoa
Soomáálii Bikéyah	Somália
Soodą́ą	Sudão
Swáazi Dineʼé Bikéyah	Suazilândia
Nahasdzáán Bikáaʼgi Kéyah Naaznilgo Ałhidadiidzooígíí	Organização das Nações Unidas
Nidaashchʼąąʼígíí	Cor
Béésh Łigaii	Prata
Béésh Dildǫʼí	Estanho
Łéétsoh	Urânio
Hastiin alą́ąjįʼ dahsidáhígíí Bill Clinton	Bill Clinton
Míshigin Hahoodzo	Michigan
Tó Nitsaa Nílį́bąąh Hahoodzo	Illinois
Náhookǫsjí Dzígaii	Dakota do Norte
Ałnííʼjí Dzígaii	Dakota do Sul
Ayání Naakaii Hahoodzo	Montana
Tóʼííbézhí	Wyoming
Nímasii Kʼidadilyéhé	Idaho
Ahééhałtį́į́h Hahoodzo	Washington
Naʼazhǫǫsh Hahoodzo	Nevada
Kayíbíyinsíí (tónteel)	Mar do Caribe
Dibé Nitsaa Hahoodzo	Colorado
Naakaii bizaad	Língua castelhana
Naʼashjéʼii	Aranha
Chʼosh bijáád tseebíhígíí	Aracnídeos
Chʼosh bideeʼ ádaadinígíí	Chelicerata
Chʼosh bijáád dahólónígíí	Artrópode
Béeso	Dinheiro
Bijíniyah Hahoodzo	Virgínia
Eʼeʼaahjí Bijiniyah Hahoodzo	Virgínia Ocidental
Kin Yótʼááh Deezʼá Hahoodzo	Nova Iorque (estado)
Wóód Áalin Hahoodzo	Rhode Island
Chʼosh bijáád hastání	Insetos
Méelin Hahoodzo	Maryland
Déláwee Hahoodzo	Delaware
Oohááyoo Hahoodzo	Ohio
Pénsówéíniyah Hahoodzo	Pensilvânia
Niijéízii Hahoodzo	Nova Jérsia
Índíʼyéenah Hahoodzo	Indiana
Chidí	Automóvel
Jóojah Hahoodzo	Geórgia (Estados Unidos)
Akałii Bikéyah	Texas
Náhookǫsjí Kééláanah Hahoodzo	Carolina do Norte
Shádiʼááhjí Kééláanah Hahoodzo	Carolina do Sul
Méhigoʼ sídii	Cidade do México
Bilasáana diwozhí	Ananás
Mísísípii Hahoodzo	Mississippi
Ténésii Hahoodzo	Tennessee
Yootó Hahoodzo	Novo México
Mínisóodah Hahoodzo	Minnesota
Wiskaansin Hahoodzo	Wisconsin
Haʼaʼaahjí Dzígaii	Iowa
Nabeeskah Hahoodzo	Nebraska
Shádiʼááhjí Dzígaii	Kansas
Tó Dzígaii Nílį́	Missouri
Tónteel Chʼínílį́	Luisiana
Kentákii Hahoodzo	Kentucky
Dził Biiʼ Dzígaii	Arkansas
Halgai Hóteel Hahoodzo	Oklahoma
Ho Chi Min Sídii	Cidade de Ho Chi Minh
Bilagáana bizaad	Língua inglesa
Náhookǫsjí Hakʼaz Dineʼé Bikéyah	Nunavut
1901 – 1950	1902
Tłʼiish	Serpente
1951 – 2000	1979
Pope Benedict XVI	Papa Bento XVI
Maʼii Ashkii	Gerônimo
Tsin naaʼeeł táłtłʼááh naagháhígíí	Submarino
Tahoniigááh	Gripe
Tłʼízí	Capra aegagrus hircus
Kǫʼ	Fogo
Tʼááłáhági átʼéego:Templates	Categoria:!Predefinições Wikipédia
Tʼááłáhági átʼéego:Naaldlooshii Bikéshgaan Dahólónígíí	Categoria:Ungulados
Dloziłchííʼ	Esquilo-vermelho
Tʼááłáhági átʼéego:Bideeʼtsʼinígíí	Categoria:Bovídeos
Tʼááłáhági átʼéego:Ndaaʼnaʼii	Categoria:Escamados
Tiníléítsoh	Dragão-de-komodo
Chʼosh bijáád neeznánígíí	Decapoda
Aymara bizaad	Língua aimará
Łeeyiʼ chʼoshtsoh binááʼ hólónígíí	Gimnofiono
Tʼááłáhági átʼéego:Dééł dóó Tóidoozohii	Categoria:Gruiformes
Médíwííyin Sii	Mar Mediterrâneo
Jóojah (Ałtsʼáʼáztiin)	Geórgia (desambiguação)
Alóós	Arroz
Tsídii	Aves
Kéłánii bikágí yilzhólígíí	Onychophora
Kéchwa bizaad	Língua quíchua
Ínsadoobíídiiya	Enciclopédia
Íiyisíí Naaltsoos	Wikipédia:Página principal
Dziłgaiitsoh Honeezkʼazii	Himalaia
Tʼááłáhági átʼéego:Candidates for speedy deletion	Categoria:!Páginas para eliminação rápida
Chʼil ahwééh	Chá
Kéyah Sahééwa Eʼeʼaahjí Siʼánígíí	Saara Ocidental
1801 – 1850	1815
Łį́į́ʼ Bideeʼłáaʼii	Unicórnio
Hastiin Hernán Cortés	Hernán Cortés
Tsʼíʼii daʼaneezí	Culicidae
Dibé	Ovis aries
Łóóʼ hashkéhé	Tubarão
Ghą́ą́ʼaskʼidii	Camelo
Bidił Daazdoígíí dóó Daʼałtʼoʼígíí	Mamíferos
Bíchį́į́h yee adilohii	Elefante
Mágí dóó Mágí Ndahalinígíí	Primatas
(*wálá-)	Formiga
Tsísʼná	Anthophila
Jiłtʼoʼí	Ruibarbo
Sęęschʼil	Couve-flor
Ayęęzhii yiltʼąąʼí	Beringela
Naalʼeełí	Anatidae
Yas	Neve
Jádí dághaaʼígíí	Gnu
1851 – 1900	1865
Biʼééʼ Łichííʼí bizaad	Língua russa
1751 – 1800	1784
Bááh	Pão
Bee Hazʼą́ą Ił Chʼétʼaah	Declaração Universal dos Direitos Humanos
Kéyah haʼdéísná	Sismo
Tó nitéél nitságoʼ atságáá	Tsunami
Níyoltsoh	Tornado
Saad bee alʼį́į́hni	Sistema de escrita
Tʼááłáhági átʼéego:Dáághahii	Categoria:França
Mąʼii łitsooí	Raposa-vermelha
Naaltéʼ	Escravidão
Ahwééh	Café
Abeʼ	Leite
Dził	Montanha
Doo Nidahałtingóó	Deserto
Cryptographic	Criptografia
Guadalajara	Guadalajara (México)
Tsídii naʼałkʼaiʼí	Pinguim
Kolíya Dineʼé bizaad	Língua coreana
Gah	Coelho
Tó niteel	Oceano
Hodíłchʼil Níłtsánígíí	Floresta húmida
HiTSʼezh	IPod
Hazéí	Esquilo
Hazéí naatʼáʼii	Esquilo-voador
Ééʼ néíshoodí	Igreja Católica
Kwį́į́n Elizabeth II	Isabel II do Reino Unido
Hastiin alą́ąjįʼ dahsidáhígíí Ronald Reagan	Ronald Reagan
Hastiin Emperor Yongle	Yongle
Naʼashjéʼiitsoh	Aranha-lobo
Naaldlooshii dadichʼízhii	Répteis
Tsin Deigházhígíí	Roedores
Hasbídí	Columbidae
Tééh hóyáanii	Phocoenidae
Biyáázh Tsʼǫʼasánígíí (Táyiʼ dóó Niʼkáágóó Ndaakaaígíí)	Anfíbios
Géeso	Queijo
Chʼil naʼatłʼoʼii (chʼiyáán)	Uva
Tsísʼná bitłʼizh	Mel
Atsįʼ	Carne
Naʼashjéʼii tsiizisí	Pholcidae
Nímasii	Batata
Áshįįh łikan	Açúcar
Haʼałtsédii	Noz
Wááshindoon bisiláołtsooí	Forças Armadas dos Estados Unidos
Naʼiiniʼ bá Hooghantsoh	World Trade Center
Áshįįh	Sal de cozinha
Wááshindoondi bee hazʼáanii ádeiłʼíní	Congresso dos Estados Unidos
Tsin naaʼeeł	Navio
Nidaʼąnyéézh	Irrigação
Naadą́ą́ʼ	Milho
Naʼashchʼąąʼ	Pintura
Wótáahgoo ałnaaʼáłtʼahiʼ	Astronauta
Azhish	Dança
Naʼashjéʼii nahachaʼígíí	Salticidae
Kéyah Daʼnaaznilígíí	Lista de Estados soberanos
Shash	Ursidae
Hastiin alą́ąjįʼ dahsidáhígíí John Adams	John Adams
Hastiin alą́ąjįʼ dahsidáhígíí Thomas Jefferson	Thomas Jefferson
Hastiin alą́ąjįʼ dahsidáhígíí Andrew Jackson	Andrew Jackson
Ńdíshchííʼ	Pinheiro
Tłʼoh naadą́ą́ʼ	Trigo
Naałniih yichʼą́ą́h naabaahígíí bąąh dahooʼaahgo	Síndrome da imunodeficiência adquirida
Abeʼ bee neezmasí	Crêpe
Jéíʼádįįh	Tuberculose
Łóódtsoh	Varíola
Zelda bahaneʼ	The Legend of Zelda (série)
Naakáí dinéʼiʼ biempire Méhigodi	Astecas
Łéétsoh bee atsiniltłʼish álʼį́	Energia nuclear
Łéétsoh beeʼeldǫǫhtsoh beeʼalį́į́h	Bomba nuclear
Chidí naaʼnaʼí beeʼeldǫǫh bikááʼ dah naaznilígíí	Carro de combate
Dah woozh	Morango
Jalisco Hahoodzo	Jalisco
Dzidzé łikaní dinilchííʼígíí	Framboesa
Mágí bichʼiyąʼ	Coqueiro
Dzidzétsoh	Pessegueiro
Chʼil łitsxooí	Citrus × sinensis
Chʼil dishooí	Quiuí
Chʼil dootłʼizhí díkʼǫ́zhígíí	Lima (fruto)
Abeʼ yistiní	Sorvete
Méhigo bizaad	Língua náuatle
Diné bizaad	Língua navaja
Jeeʼiighááh	Dermaptera
Tenochtitlan	Tenochtitlán
Ásáí Bizaad	Língua árabe
Honeezílígi	Clima subtropical
Atʼaʼ yiltʼąąʼí	Palmeira
Niłchiis	Glutão
Tsin yilátah ayání	Girafa
Naalʼeełídaaʼí	Ornitorrinco
Naʼashǫ́ʼii	Lagartos
Béésh bee akʼeʼelchí áłtsisígíí	Computador pessoal
Wikiibíídiiya:Naaltsoos nizhónígo ádaalyaaígíí	Wikipédia:Artigos destacados
Bee álnééhí:Link FA	Predefinição:Link FA
Bimááʼ Hahoodzo	Vermont
Hoozdoh	Phoenix (Arizona)
Táłkááʼ tsʼin bíchį́į́hnézí	Gavial
Tsin naaʼeeł chidí naatʼaʼí bee nágéhéʼ	Porta-aviões
Tsídiitsoh	Avestruz
Kolíya bikéyah (Ałtsʼáʼáztiin)	Coreia
Mąʼiitsoh	Lobo
Chʼídeeldlóohiitsoh	Cegonha-bico-de-sapato
Tóidoozohii bidaaʼ łichííʼígíí	Gallinula chloropus
Táłtłʼááh yilcháazhii	Porifera
Tónteel naʼashjéʼii	Aranha-do-mar
Séigoʼ bíláshgaanézí	Amblypygi
Naʼashjéʼii jáádnézí	Opilião
Séigoʼchilí bitseeʼ ádinígíí	Pseudoscorpionida
Séigoʼ	Escorpião
Zahalchíʼii	Solifugae
Hastiin Emperor Qianlong	Qianlong
Séigoʼ bitseeʼ áłtsʼózígíí	Escorpião-vinagre
Yaaʼ doo yitʼíinii	Ácaro
Hodíłchʼilgi naaʼahóóhai	Tinamiformes
Tłʼiishkʼosí (tsídii)	Anhingidae
Télii	Equus africanus asinus
Náshdóítsoh noodǫ́zígíí	Tigre
Kʼíneeshbízhiinééz	Espaguete
Tábąąhgi łeeyiʼ chʼosh	Arenicola marina
Táłkáaʼgi Tsídii	Anseriformes
Tązhii dóó Naaʼahóóhai Ndahalinígíí	Galliformes
Naalʼeełii keelóól	Podicipedidae
Tsídii Deílʼésígíí	Ciconiiformes
Daʼałtʼoʼígíí Biyęęzhii Deiłchíhígíí	Monotremata
Adijiłii bíchį́į́hnézí	Tachyglossidae
Biyázhí neiyéhé	Didelphidae
Hazéítsʼósii	Tâmia
Chidí bikʼah	Petróleo
Chéłchaaʼ	Besouro
Łį́į́ʼ ałchiní	Cavalo-de-przewalski
Naʼastsʼǫǫsíʼniiʼí	Peramelidae
Shash naʼazísí	Vombate
Nahatʼeʼiitsohchilí	Potoroidae
Náʼagéédí łichíiʼii	Chrysochloridae
Bįįh Danilínígíí	Cervidae
Tin	Gelo
Tłʼohchin díchʼííʼí	Alho
Taʼneeskʼání áłtsʼóózígíí	Pepino
Tłʼohchin (chʼil daadánígíí)	Cebola
Chʼil łichxíʼí	Tomate
Béésh Łichíiʼii Bikéyah Náhookǫsjígo Siʼanígíí	República Turca de Chipre do Norte
Naʼazhǫǫsh Hátsoh	Las Vegas
Náshdóí dilwoʼí	Acinonyx jubatus
Tsékǫʼ	Carvão mineral
Néʼéshjaaʼ	Strigiformes
Bíígháán Dahólónígíí	Vertebrados
Kʼishchííʼ	Bétula
Ǫǫbǫʼii	Poupa-eurasiática
Náshdóí Ndahalinígíí	Felidae
Yádiłhił yiiyídíʼ nahosdzáán yináádáłiʼ	Estação Espacial Internacional
Tó wónaanídę́ę́ʼ toohjįʼ noołnahii	Garça-real-europeia
Hashkʼaan dijéʼé	Tamareira
Wááshindoon (Ałtsʼáʼáztiin)	Washington (desambiguação)
Bidił Daazdoígíí dóó Daʼalghałígíí	Carnívoros
Chʼoshtsoh	Barata
Dlǫ́ʼii yázhí	Mustela nivalis
Tsʼíʼii dóó Tséʼédǫ́ʼii	Diptera
Biniiʼłigaii (néʼéshjaaʼ)	Coruja-das-torres
Mąʼii Ndahalinígíí	Canídeos
Bijáád Ádaadinígíí	Moluscos
Chʼosh łitsxooí dóó Chʼosh łichííʼí	Joaninha
Táłkááʼ naalzheehí	Pandion haliaetus
Bizaʼazis Dahólónígíí	Marsupiais
Dlǫ́ʼiiłgaii	Arminho
Naalʼeełí bitsiiʼ dootłʼizhí	Pato-real
Sǫʼ łóóʼ	Estrela-do-mar
Giníłbáhí	Açor
Tʼádootłʼizhii	Gaio-comum
Zhį́ʼii	Corvus corax
Táłkááʼ tsʼin Danilínígíí	Crocodylia
Chʼosh bikágí dantłʼizí	Crustáceo
Dééł	Grou
Chʼosh bitsʼaʼígíí	Bivalvia
Atsá dóó Giní Ndahalinígíí	Falconiformes
Łóóʼ ooshgę́ęzhii	Chondrichthyes
Tániilʼáí	Odonata
Wóláchííʼ yildeełí bikágí ntłʼizí	Pangolim
Gah Danilínígíí	Lagomorfos
Tsísʼnátsoh	Mamangaba
Hazéí yiltseeʼí	Milefólio
Chʼosh bikǫʼí	Vaga-lume
Zéédzísgaii	Faisão-comum
Dlǫ́ʼii Ndahalinígíí	Mustelídeos
Tsin yiłkaałii	Pica-pau
Bideeʼtsʼinígíí	Bovídeos
Dééł dóó Tóidoozohii Ndahalinígíí	Gruiformes
Gáagii dóó Joogii Ndahalinígíí	Corvidae
Chʼiltaatʼagii	Tartaranhão-azulado
Tsin naaʼeeł diné bee nágéhéʼ	Balsa
Gad	Juniperus
Jááłánii	Myriapoda
Biishchʼid Dahólónígíí	Placentários
Chʼosh Deildeełii	Insectívoros
Tó wónaanídę́ę́ʼ naalʼeełítsoh łibáhígíí	Ganso-bravo
Tónteel dóó Tábąąhgi Tsídii	Charadriiformes
Biyaatsʼiin Dahólónígíí	Gnatostomados
Tooh łéʼétsoh	Rato-almiscarado
Chaatʼíní	Rumex acetosa
Łóóʼ hashkéhé dootłʼizhígíí	Prionace glauca
Wóʼatsʼǫǫsii Ádaatʼéhígíí	Hemiptera
Atsáłgaii	Bútio-patudo
Béégashiiʼilí	Iaque
Tó wónaanídę́ę́ʼ dlǫ́ʼii	Tourão
Tsxį́į́łnaalkʼįhii	Andorinhão
Dziłditłʼoii Bił Hahoodzo	Condado de San Juan (Utah)
Hakʼaz naalʼeełí	Eider-edredão
Naalʼeełítsoh bitsiiʼ halzhinígíí	Ganso-do-canadá
Chʼó	Picea
Łóóʼtsoh łizhin dóó łigaígíí	Orca
Jáádtsʼósí	Recurvirostridae
Téél dzítsooii dóó Tsétah chʼosh	Carabidae
Naalʼeełítsoh diłhiłígíí	Ganso-de-faces-negras
Tábąąh dlǫ́ʼii	Vison-americano
Dlǫ́ʼii bitéél halgaií	Fuinha
Naakaii Łizhiní Bikéyahdi Hadahóólįįdígíí	Afrotheria
Diné Nááhódlóonii bizaad	Línguas atabascanas
Łį́į́ʼ bitsísʼná	Oestridae
Tónteel tsídii	Larídeos
Ałtį́į́ jikʼáshí (chʼil)	Cavalinha (planta)
Hazaʼaleehtsoh (dííshjį́ ááłjiní)	Apium graveolens
Kʼaalógii dóó Iichʼąhii	Lepidoptera
Díłdánii yił aheełtʼéhii	Codorniz-comum
Chʼałdą́ą́ʼ / Jádí nátʼoh (chʼil daadánígíí)	Asparagus officinalis
Tséʼédǫ́ʼii dootłʼizhí	Calliphoridae
Jaaʼabaní Danilínígíí	Morcego
Wóónałchídii	Elateridae
Tsídii bidaanézí	Ciconiidae
Dlǫ́ʼii	Mustela
Tsídiiłbáhí	Passeridae
Biłʼeʼeliníʼ	Levedura química
Táłtłʼááh chʼoshchilí	Krill
Tsiiʼyiishbizhí Dinéʼiʼ Bikéyah	China (civilização)
Tábąąstíín	Lontra-europeia
Jélii łóóʼ	Medusa (animal)
Náshdóíłgaii łikizhígíí	Leopardo-das-neves
Tábąąstííntsoh Danilínígíí	Pinípedes
Dlǫ́ǫ́ʼ	Cão-da-pradaria
Náshdóí bijaałizhiní	Caracal caracal
Chʼóhojilyééh	Datura stramonium
Chʼah Diʼilii Bikéyahdę́ę́ʼ naalʼeełítsoh	Ganso-africano
Tsídii yáłtiʼí	Psittaciformes
Tééh łį́į́ʼ	Zebra
Náshdóí łikizhígíí	Jaguatirica
Dííłdzid jeeshóóʼ	Abutre-do-egito
Tʼáadoo leʼé danílʼį́ bił hazʼą́	Museu
Shash łizhin dóó łigaígíí	Ailuropoda melanoleuca
Shash łigaígíí	Ursus maritimus
Gaantsʼosí	Crinoidea
Hastiin alą́ąjįʼ dahsidáhígíí Theodore Roosevelt	Theodore Roosevelt
Neeshchʼííłgai	Cajueiro
Dilní bee Nidaʼanéhígíí	Instrumento musical
Dééłgai	Cisne
Bikááʼ náʼoobałí	Helicóptero
Dziʼizítsoh	Motocicleta
Tééhoołtsódii	Hipopótamo-comum
Séí	Areia
Naakaii Łizhiní Bikéyahdę́ę́ʼ náshdóítsoh łikizhígíí	Leopardo
Déélgééd	Rhinocerotidae
Beeʼeldííl Dahsinil	Albuquerque
Hashkʼaan dootłʼizhí (babáayah)	Mamão
Chʼil łigaii (atʼééké bijish)	Repolho
Náshdóítsoh	Puma concolor
Ásáí dinéʼiʼ	Árabes
Deeteel	Alce
Shádiʼááhdę́ę́ʼ náshdóítsoh łikizhígíí	Onça-pintada
Lókʼaatsoh	Bambu
Káango (Ałtsʼáʼáztiin)	Congo
Kʼaiʼ	Salgueiro
Shash bizaʼazis hólóní	Coala
Náshdóí kʼos bee naashchʼąąʼígíí	Neofelis nebulosa
Shashtsoh	Ursus arctos
Łéʼétsoh	Rattus
Akʼáán	Farinha
Mágítsoh	Gorila
Bitsįʼ yishtłizhii	Povos ameríndios
Dáʼákaz łikaní	Cana-de-açúcar
Chʼil akʼahí	Persea americana
Neeshchʼííłbáhí	Amendoim
Dzidzétsoh díkʼǫ́ǫzhii	Damasqueiro
Naʼashǫ́ʼii łahgo ánééhé	Camaleão
Yootó	Santa Fé (Novo México)
Łééchąąłgaii	Galgo inglês
Nahatʼeʼiitsoh Bikéyahdę́ę́ʼ łééchąąʼí ałchiní	Dingo
Chʼééhjiyáán	Melancia
Teide	Teide
Naʼastsʼǫǫsí	Mus
Hakʼaz bįįh	Rena
Chʼosh doo yitʼínii	Micro-organismo
Táshchozhii	Andorinha
Neeshchʼííʼ hááheeshchiiʼí	Amendoeira
Łóóʼ bigaan tseebíí	Polvo
Chʼosh bikágí ntłʼizí	Caranguejo
Tábąąstííntsoh bideeʼ hólónígíí	Morsa
Mágí diʼilí	Orangotango
Atsátsoh	Águia-real
Łóóʼtʼą́hí atsiniltłʼish ííłʼínígíí	Torpediniformes
Chʼil łitsxooí ntsxaaígíí	Toranja
Kʼíníjíłʼahí (dííshjį́ ááłjiní)	Groselheira
Kʼaalógiiłgaígíí	Pieridae
Naʼastsʼǫǫsí binááʼ áłtsʼíísígíí	Soricidae
Dzaanééz	Mula
Tsinlátah shash łichíʼígíí	Panda-vermelho
Tsídii jáádnézí	Flamingo
Tééh łééchąąʼí	Hiena
Łóóʼtsoh dootłʼizhígíí	Baleia-azul
Sóól	Acer (botânica)
Aghaaʼ	Lã
Deesdoigi	Trópico
Shádiʼááhdę́ę́ʼ tłʼízí	Lhama
Mósíʼilí	Persa (gato)
Lókʼaatah mósí ałchiní	Gato-da-selva
Náátsʼózídę́ę́ʼ mósíłkizhii ałchinígíí	Gato-leopardo
Náshdóítʼą́ʼí łikizhígíí	Serval
Tábąąh béégashii	Búfalo-asiático
Béégashiitsoh naʼałkǫ́ǫ́ʼígíí	Peixe-boi
Hastiin Leiw Éíwiksson	Leif Ericson
Akágí yitsʼǫǫsii	Sanguessuga
Anáʼálwoʼ:TʼAN (FAQ)	Ajuda:FAQ
Táłkááʼ tsʼin	Crocodilo
Chidítsoh	Camião
Dlǫ́ʼiitsoh áłtsʼózígíí	Genetta
Gáagii	Corvo
Tó wónaanídę́ę́ʼ náshdóí	Lince-euroasiático
Jááłánii (bitsiitsʼiin nteelígíí)	Quilópode
Giní	Falcão
Dahiitį́hii	Beija-flor
Tązhii	Peru (ave)
Chʼosh (Bíígháán Ádaadinígíí)	Invertebrados
Gáagii naashchʼąąʼígíí	Coraciidae
Mąʼii	Coiote
Dah Naatʼaʼí Sǫʼ bił Sinil	The Star-Spangled Banner
Akʼah sisíʼí tsin	Eucalipto
Mááya dinéʼiʼ	Povos maias
Gahtsoh	Lebre
Bisóodi bíchį́į́h nineezí	Orictéropo
Sonora Hahoodzo	Sonora
Nahakʼízii	Grilo
Chaaʼ	Castor
Chʼilzooł	Brócolis
Kááʼtsʼiní	Dasypodidae
Atsʼiis naałdzid	Câncer de pulmão
Yágháhoníkáángóó ałánátʼahí	Ônibus espacial
Béésh náábałí atsiniltłʼish ííłʼínígíí	Aerogerador
Méhigo tééh	Vale do México
Shą́ą́ʼnahalghałí (naaldeehii)	Hyracoidea
Nahatʼeʼiitsoh łichíiʼii	Canguru-vermelho
Azeeniłchin	Lamiaceae
Chʼał	Anura
Tsxilghááh	Caudados
Shádiʼááhdę́ę́ʼ atsátsoh	Harpia
Shádiʼááhdę́ę́ʼ chʼał kʼaasdáhígíí	Dendrobatidae
Chʼał niłtólí	Centrolenidae
Chʼał dichʼízhí	Bufonidae
Tónteel tsídiitsoh	Diomedeidae
Chidí nadlééh	Conversível
Chʼał atʼąąʼ nahalinii	Megophryidae
Bisóodi ałchiní	Javali
Naʼastsʼǫǫsí dóó Łéʼétsoh Danilínígíí	Muroidea
Mariner 10	Mariner 10
Sǫʼ łóóʼ bigaanézí	Ophiuroidea
Dághaałóóʼ	Siluriformes
Łóóʼtʼą́hí	Pleuronectiformes
Toohjįʼ ndiigaii	Garça-branca-pequena
Kʼaalógii bitseeʼ hólóní	Papilionidae
Mágí binááʼtsohígíí	Tarsius
Ndoochííʼ	Pterospora
Díłdánii	Odontophoridae
Táłtłʼááh łį́į́ʼ	Cavalo-marinho
Łóóʼ bíígháántsiighąąʼ ádaadinígíí	Peixe-bruxa
Béésh Sinil	Winslow (Arizona)
Achʼįʼ Náhiłtį́į́	Safford
Tó wónaanídę́ę́ʼ dzeeh	Cervus elaphus
Tsézhin Deezʼáhí	St. Johns (Arizona)
Béésh Bá Hooghan	Globe (Arizona)
Kinłání (Hoozdoh Hahoodzo)	Flagstaff
Michoacán Hahoodzo	Michoacán
Tʼiisyaakin	Holbrook (Arizona)
Naʼníʼá Hótsaa	Page (Arizona)
Táłtłʼááh chʼosh daadánígíí	Caridea
Mágíshzhin	Chimpanzé
Łóóʼntsxaaí łikizhígíí	Tubarão-baleia
Dlǫ́ʼii yił Aheedaałtʼéhígíí	Herpestidae
Béésh Bichʼahníí Bikéyahdę́ę́ʼ ayání	Bisonte-europeu
Łóóʼtsoh bitsiiʼ dikʼání	Cachalote
Waaʼ (dííshjį́ ááłjiní)	Espinafre
Néʼéshjaatsoh	Corujão-orelhudo
Shádiʼááhdę́ę́ʼ tłʼízíʼilí	Alpaca
Chʼosh ditłʼooí	Lagarta
Łóóʼ bigaan neeznání	Lula
Bijáád noodǫ́ǫzii	Ocapi
Méhigo Hahoodzo	México (estado)
Ayání	Bisão-americano
Mąʼiiłgaii	Alopex lagopus
Gólízhii Danilínígíí	Mephitidae
Táłtłʼááh adijiłii	Echinoidea
Nahachagii	Gafanhoto
Tsídiitsoh ditsʼozígíí	Emu
Ałhaʼdeetʼaah	Contrato
Naayééʼ tsídii	Archaeopteryx lithographica
Tsísʼná (bitłʼizh ííłʼínígíí)	Apis
Chééwokii dinéʼiʼ	Cherokees
Tsin naaʼeeł hééł bee nágéhéʼ	Navio cargueiro
Yéigo ałhoshii	Gliridae
Naʼashjéʼii bijéí dah łichíiʼii	Viúva-negra
Mágí dághaaʼígíí	Saguinus imperator
Didzéłchííʼ	Ilex
Naałání	Comanches
Oozéí / Ayahkinii	Hopis
Bidááʼ Haʼaztʼiʼ Tsékooh	Grand Canyon
Táłtłʼááh naʼashjéʼii	Argyroneta aquatica
Táłtłʼááh tsisteełtsoh	Tartaruga-de-couro
Nahatʼeʼii	Dipodomys
Tsídii yáłtiʼí yázhí	Periquito-australiano
Tábąąh mąʼii	Procyon lotor
Hołchʼíʼí	Urtica
Dáághahii dinéʼiʼ	Franceses
Shash łizhinígíí	Ursus americanus
Náshdóí bizaʼazis hólóní	Tilacino
Łeeyiʼ chʼosh	Minhoca
Shash bitéélgaígíí	Urso-negro-asiático
Chʼoshtʼą́hí	Platelmintos
Hashtłʼish jeeshóóʼ	Abutre-barbudo
Jádí bíchį́į́htsohígíí	Saiga
Táłtłʼááh chʼoshtsoh chʼééh digháhii	Pepino-do-mar
Tsísʼná bizǫ́ǫ́z ádinígíí	Meliponini
Chidí naatʼaʼí dilwoʼí	Caça (avião)
Bíchį́į́h naatsʼǫǫdí	Tapirus
Tó wónaanídę́ę́ʼ mąʼii	Chacal-dourado
Chʼóshgai (tsin)	Pinheiro-do-canadá
Łóóʼ Bigaan Dahólónígíí	Cefalópodes
Naʼashǫ́ʼii łóóʼ	Anguilliformes
Dahbaʼ (tsin)	Fraxinus
Łóóʼ hashkéhétsoh	Tubarão-branco
Neeshchʼííłchííʼ	Castanea
Chį́į́hnézí nahatʼeʼígíí	Macroscelidea
Táłtłʼááh ayání	Dugongo
Dibé Diníí Bikéyahdę́ę́ʼ náshdóí	Lince-ibérico
Maadíséloo	Monticello (Utah)
Kʼaiʼ Bił Hahazteel	Kanab
Toohjįʼ ndiigaiitsoh	Garça-branca-grande
Wóóneeshchʼįįdii	Cigarra
Dééshzhiin	Cisne-negro
Naakaii náásééł	Louva-a-deus
Dlǫ́ǫ́ʼ ntsxaaígíí	Capivara
Mąʼii bijaaʼtsohí	Feneco
Dilchaʼ	Marmota
Díwózhii	Sarcobatus
Náshdóí łibáhígíí	Lynx rufus
Chʼilhaatʼaʼii	Esmerilhão
Tééh hóyáaniitsoh	Baleia-branca
Jádí bideeʼ yisdizígíí	Impala
Náátsʼózídę́ę́ʼ mąʼiiłchííʼ	Cão-selvagem-asiático
Łóóʼtsoh bighą́ą́ʼ yílkʼidígíí	Baleia-jubarte
Ghą́ą́ʼnaakiskʼidii	Camelo-bactriano
Tábąąh mąʼiiniiʼí	Cão-guaxinim
Naʼazhǫǫsh (ndajiné dóó adazhdikaʼgi)	Casino
Ndikʼąʼ	Gossypium hirsutum
Dlǫ́tʼą́ʼí	Suricata suricatta
Azeeʼ hókániitsoh (chʼil daadánígíí)	Alcachofra
Kéchwa dinéʼiʼ	Quíchuas
Mąʼii bizaʼazis hólóní	Diabo-da-tasmânia
Shash bítááʼłgaígíí	Tremarctos ornatus
Jádítsoh	Tragelaphus strepsiceros
Naatʼáanii Moctezuma II	Moctezuma II
Biwooʼ Ádaałtsʼíísígíí	Pilosa
Ásáí dinéʼiʼ bikéyah	Mundo árabe
Shash yázhí	Helarctos malayanus
Shash ndilnaʼii	Urso-beiçudo
Łéʼétsoh yiljaaʼí	Ranunculus
Hakʼaz náshdóí	Lince-do-canadá
Mąʼii yił Ałhidanoolinígíí Yázhí	Procionídeos
Nahooyéí (chʼil naʼatłʼoʼii)	Convolvulus
Tłʼoh waaʼí nahalinígíí	Trifolium repens
Tábąąstííntsoh dághaaʼígíí	Foca-barbuda
Naakáí łizhiní	Cultura da África
Hoshdódii chʼil	Lepidium densiflorum
Atʼééké bijish yázhí	Couve-de-bruxelas
Tsékooh	Cânion
Noodah	Agave
Łeeʼdoolʼeezí	Orobanchaceae
Kinteel Bił Hahoodzo	Condado de San Juan (Novo México)
Beeʼeldííl Dahsinil Bił Hahoodzo	Condado de Bernalillo
Aniłtʼánii	Neuroptera
Kʼaalógii bijáád dį́įʼii	Nymphalidae
Nímasii yiyání	Besouro-da-batata
Awééʼchíʼí (chʼil)	Campanula
Taʼaghálii	Astragalus
Naaʼołí yiltʼąąʼí	Lathyrus
Hastóí tsiiyéélí	Clematis
Chʼilátah atsʼos	Epilobium
Kʼish	Alnus incana
Shį́náldzidí (chʼil bilátah hózhóón)	Antirrhinum
Kʼįįʼ	Rhus
Naaztání	Gleditsia triacanthos
Táłkááʼbéésh	Sagittaria
Tsinyaa tłʼoh	Poa
Tłʼééʼ yiigáhii	Oenothera
Tłʼoh deeskʼidí	Amaranthus retroflexus
Ndootʼeezhí	Monarda
Wóóseekʼidii	Sphingidae
Dzílí bíláshgaan	Erodium cicutarium
Díkʼǫ́ǫ́zhí (chʼil)	Atriplex
Tséghániłchʼi	Portulaca oleracea
Zééʼiilwoʼii	Alopecurus
Tłʼohtsʼózí	Juncus
Tłʼoh dichʼíízh	Carex
Shashdą́ą́ʼ	Berberis
Díkʼǫ́ǫ́zhí yiltʼąąʼí	Chenopodium album
Bįįh yildeeʼí	Physalis
Kʼaalógii bitʼaʼ ndikʼąʼ nahalinígíí	Lycaenidae
Hosh niteelí	Opuntia
Teeł bitʼąąʼłánígíí	Scirpus
Chʼał nineezí	Rã-touro-americana
Tééh hóyáanii bíchį́į́htsahí	Narval
Mágí bíchį́į́htsohígíí	Babuíno
Bįįh łikizhígíí (Béésh Bichʼahníí Bikéyahdę́ę́ʼígíí)	Dama dama
Tábąąh ayání	Búfalo-africano
Nátʼostsoh	Verbascum thapsus
Tólchiin (chʼil)	Mentha arvensis
Dibé diníí dinéʼiʼ	Espanhóis
Binaʼadaałtzózí	Japoneses
Chʼil awoshí	Salsola kali
Chʼil naamaasii	Amaranthus albus
Naazkaadí	Amaranthus blitoides
Gad yił aheełtʼéhígíí	Tamarix
Łóóʼ bíchį́į́h nineezí	Espadarte
Łį́į́ʼ Ndahalinígíí	Equidae
Kolíya Tááʼ Bikéyahą́ą	Três Reinos da Coreia
Hashkʼaantsoh yiltʼeesígíí	Musa × paradisiaca
Iiʼnótʼį́į́	Infecção
Chʼah Diʼilii Bikéyahdę́ę́ʼ mósí ałchinígíí	Felis manul
Jááłánii (bikágí ntłʼizígíí)	Diplópode
Iichʼąhii ntsxaaígíí	Attacus atlas
Łóóʼ ńdídzihígíí	Dipnoicos
Chʼíshiibeezhii	Paridae
Giní jáádnézí	Sagittarius serpentarius
Hakʼaz néʼéshjaaʼ	Coruja-das-neves
Shádiʼááhdę́ę́ʼ jeeshóóʼ	Condor-dos-andes
Chidí naatʼaʼítsoh beeʼeldǫǫh bikǫʼ neiyéhé	Bombardeiro
Shash bighą́ąʼgi hadzíbáhí	Urso-cinzento
Kǫʼ naʼałbąąsii	Locomotiva a vapor
Ndíyíliitsoh	Girassol
Naaʼahóóhaiłkizhígíí	Numididae
Tłʼiish yighání	Ratel
Dadilhóni aheltłʼidígíí	Granada de mão
Naakaii Łizhiní Bikéyahdę́ę́ʼ łééchąąʼí ałchiní	Mabeco
Aniłtʼánii (tʼááłaʼajínígoʼígíí)	Ephemeroptera
Ayánítsoh bighą́ą́ʼaskʼidígíí	Gauro
Niinahnízaad	Nenahnezad (Novo México)
Máaz yikááʼ nandahí Spirit	Spirit (sonda)
Hakʼaz giníłgaii	Falcão-gerifalte
Tsétah jeeshóóʼ łibáhí	Abutre-fouveiro
Tééh łééchąąʼí łikizhígíí	Hiena-malhada
Tłʼízí ałchiní	Cabra-selvagem
Yaaʼ dóó chʼosh bíchį́į́h dadichʼízhí	Acanthocephala
Beeʼeldǫǫh	Mosquete
Chʼosh bitsʼaʼígíí bigaan dahólónígíí	Brachiopoda
Tʼąąʼdoolghasí (daadánígíí)	Endívia
Dlǫ́ʼii (bílaʼashdlaʼii bilį́į́ʼ)	Furão
Łóóʼtsoh łibáhígíí	Baleia-cinzenta
Chʼah Diʼilii Bikéyahdę́ę́ʼ atsátsoh	Águia-das-estepes
Yiisnááh	Prisioneiro de guerra
Dzeeh	Cervus canadensis
Tsé Nitsaa Deezʼáhí	Rock Point
Tsin naaʼeeł bee daʼahijighánígíí	Couraçado
Tsísʼná yiyání	Abelharuco
Bisóodi bizęęs dį́įʼii	Phacochoerus africanus
Dlǫ́ʼiitsoh naalzheehígíí	Fossa (animal)
Nahachagii biyázhí	Afídio
Naalkʼįhiitsoh	Dermoptera
Łóóʼ naatʼaʼí	Peixe-voador
Hakʼaz ayání	Boi-almiscarado
Tsétah gah	Ochotona
Mąʼiitsoh bikʼos bineʼdę́ę́ʼ łizhinígíí	Lobo-guará
Iichʼąhiitsʼósí	Trichoptera
Kéyah Dańlínídę́ę́ʼ atsátsoh	Pithecophaga jefferyi
Tábąąstííntsoh bíchį́į́htsohígíí	Elefante-marinho
Łóóʼntsxaaí díníchʼahii	Cetorhinus maximus
Chʼosh yighání	Lobo-da-terra
Mágí bitseeʼ noodǫ́zígíí	Lémure-de-cauda-anelada
Táyiʼ chʼoshnézí	Nemertea
Tó naagoʼ	Gota (líquido)
Dlǫ́ʼiitsoh Danilínígíí	Viverridae
Mágí bigaanézí	Gibão
Bílaneezii	Aie-aie
Séí mąʼii	Raposa-das-estepes
Tłʼízí bideeʼ yisdizígíí	Capra falconeri
Jádí	Antilocapra
Wónikǫsí	Phasmatodea
Tééh łééchąąʼí noodǫ́zígíí	Hiena-riscada
Tsídiiłchxoní	Jacu-cigano
Táłtłʼááh chʼoshtʼą́hí bikááʼtsʼinígíí	Polyplacophora
Mąʼii bighą́ąʼgi hadzíjiní	Chacal-de-dorso-negro
Naakaii Łizhiní Bikéyahdę́ę́ʼ mąʼiiłchííʼ	Lobo-etíope
Tsétah dibé	Carneiro-selvagem
Dibé dóó Tłʼízí Ndahalinígíí	Caprinae
Mágí bíchį́į́h dootłʼizhígíí	Mandril
Tsiighájíłchí	Cuscuta
Bįįhyázhí biwooʼnézí	Cervo-almiscarado-siberiano
Tábąąh mósí ałchiní	Prionailurus viverrinus
Chį́į́h yee achʼiishíhii	Pristidae
Shádiʼááhdę́ę́ʼ hodíłchʼil mąʼii	Speothos venaticus
Hakʼaz mágí	Macaco-japonês
Tsé Biiʼ Ndzisgaii	Monument Valley
Mágí bíchį́į́h niilyoolígíí	Macaco-narigudo
Shádiʼááhdę́ę́ʼ tsídiitsoh	Ema
Dáádílí łibáhígí	Epinephelus marginatus
Náátsʼózídę́ę́ʼ mósíłtsxooí ałchinígíí	Gato-bravo-dourado-da-ásia
Łóóʼnteeltsoh	Peixe-lua
Gaanłáníchilí dóó Gaanłání doo yitʼíinii	Hydra (género)
Atłʼóóh	Tecelagem
Chʼoshkʼaaʼ	Chaetognatha
Tábąąh bįįh	Hydropotes inermis
Hodíłchʼil jeeshóóʼ	Urubu-rei
Dlǫ́ǫ́ʼ bitseetłʼooígíí	Chinchila
Achʼąąʼ adáʼatsʼiʼ	Vacinação
Néʼéshjaaʼ bíńdáhii	Coruja-gavião
Bitseeʼ yee adiłhałii	Aligátor americano
Jádítsoh noodǫ́zígíí	Tragelaphus eurycerus
Níyolgi naatʼaʼígíí (tónteel tsídii)	Painho
Tádídíín yiyání	Chrysomelidae
Tsídiidaashiyishí	Íbis
Yílnoodii (łóóʼ)	Barracuda
Shádiʼááhdę́ę́ʼ łéʼétsoh bitseeʼ ádinígíí	Dasyprocta
Chʼosh bitsʼaʼłáaʼii	Monoplacophora
Naʼashǫ́ʼii łóóʼ hashkéhé	Tubarão-cobra
Jeeshóóʼ	Condor-da-califórnia
Chʼosh dilwoʼígíí	Cicindela
Chʼosh doo yitʼíinii bee nílʼíní	Microscópio
Tsin ditʼinii	Spermophilus
Joogii	Gaio-azul
Łeeyiʼ nahakʼízii	Gryllotalpidae
Náátsʼózídę́ę́ʼ naalʼeełí	Aix galericulata
Mąʼii bijaaʼabanígíí	Otócion
Tsídiitsoh bikʼos dootłʼizhí	Casuar
Atsiniltłʼish ííłʼíinii (naʼashǫ́ʼii łóóʼ)	Poraquê
Dįʼ	Tetraz
Łeeyiʼ tłʼiish áłtsʼíísígíí	Scolecophidia
Niicháadii (łóóʼ)	Tetraodontidae
Tééhoołtsódiichilí	Hipopótamo-pigmeu
Kʼiiznoodǫ́ǫzii (tsin yigházhígíí)	Cuniculidae
Wóláchííʼ yildeełítsoh	Myrmecophaga tridactyla
Bináʼadaałtsózí bitsin naaʼeeł	Junco (barco)
Níłtsą́goʼ (bideeneezígíí)	Cerambycidae
Tséʼédǫ́ʼii bitsiinézí	Mecoptera
Tłʼohtahgi díłdánii yił aheełtʼéhii	Turnicidae
Łóóʼyiniʼįįhí (tónteel tsídii)	Mandrião
Shádiʼááhdę́ę́ʼ tó hóyáanii	Boto-cor-de-rosa
Naʼashǫ́ʼiitsoh	Iguana
Binaʼadaałtsózí dinéʼi	Oriente
Łóóʼ adishishí	Dasyatidae
Tsin yąąh dzootʼihí	Sittidae
Atʼaʼ yiltʼąąʼí dah sidáhígíí (chʼosh ntsxaaígíí)	Caranguejo-dos-coqueiros
Yółeehii	Lophiiformes
Tiníléí	Monstro-de-gila
Dinas	Uva-de-urso
Mąʼii bikʼiizgi hadzíjiní	Canis adustus
Yadiizį́įgo ayání	Gazela-girafa
Télii bijáád noodǫ́zí	Asno-selvagem-africano
Bitsʼáá bidaʼhodiʼniil	Terra queimada
Mágíłchííʼ	Mico-leão-dourado
Dááʼadeeʼii	Colhereiro
Taahilnoodii	Sulídeos
Kʼíneedlíshii adiłhashígíí	Lucanidae
Łééh yidi tóʼígíí	Aquífero
Naʼashǫ́ʼiitsoh naʼałkǫ́ʼígíí	Iguana-marinha
Tsídiisháshii	Bombycillidae
Naakétłʼáhí	Pima
Yaaʼ bitsʼaʼígíí	Coccoidea
Daateel	Arapapá
Tééh łééchąąʼí ditsʼozígíí	Hiena-castanha
Tsétaʼ łį́į́ʼ	Mustangue
Kénézí	Jacanidae
Neeshchʼííʼ	Pinhão
Naalʼeełítsoh yił aheełtʼéhii łizhin dóó łigaiígíí	Anseranas semipalmata
Mąʼii chʼil	Solidago
Yaadaaʼnézí (tónteel tsídii)	Bico-de-tesoura
Tsídii disxǫsígíí	Galbulidae
Náátsʼózídę́ę́ʼ mósíłchíiʼii ałchinígíí	Gato-vermelho-de-bornéu
Shádiʼááhdę́ę́ʼ tsétah mósí ałchinígíí	Leopardus jacobita
Tsinlátahgi dlǫ́ʼiitsoh	Arctictis binturong
Jeeshóóʼ łizhinígíí	Urubu-de-cabeça-preta
Naałʼashí	Tarântula
Dééłdą́ą́ʼ	Pteridium aquilinum
Hashkʼaan yildeełígíí (tsídii)	Musophagiformes
Daakʼį́į́ʼ	Numenius
Mąʼiiłtsooí łibáhígíí	Raposa-cinzenta
Naʼashǫ́ʼiitsoh dootłʼizhígíí	Iguana iguana
Chidí bikéíjį́ʼ adeizʼááhígíí	Pickup
Bįįh bitseełgaiígíí	Cariacu
Wónitłʼizí	Oniscidea
Hakʼaz mąʼiitsoh	Lobo-do-ártico
Dark Ages	Idade das trevas
Ndikʼąʼ biyaʼ	Bicudo-do-algodoeiro
Tłʼoh naadą́ą́ʼ biyaʼ	Sitophilus granarius
Łeeyiʼ jááłániichilí	Pauropoda
Dlóóʼ binaalniih	Peste bubônica
Tséʼédǫ́ʼii dishooí	Syrphidae
Tsáʼásziʼ dóó Noodah	Agavaceae
Bichʼah Dootłʼizhii	Forças de manutenção da paz das Nações Unidas
Chʼosh ałchozhii (chéłchaaʼ)	Dermestidae
Łeʼesoołii (bitseeʼ naakiígíí)	Diplura
Chʼééh digháhii dóó Tsisteeł	Testudinata
Tááʼyaʼniiltʼóshii	Cardinalidae
Łóóʼ bigaanłánígo bitsʼaʼígíí	Nautilidae
Łeʼesoołii (bitseeʼ tááʼígíí)	Thysanura
Tłʼézhii	Tabanidae
Tániilʼáítsʼóóz	Zygoptera
Naashtʼézhí	Zuni
Aniłtʼániitsʼóóz	Formiga-leão
Tó wónaanídę́ę́ʼ hazéí bíchį́į́hnézí	Scandentia
Hakʼaz gah	Lebre-ártica
Bįįh łikizhígíí (Naakaii Dootłʼizhii Bikéyahdę́ę́ʼígíí)	Axis axis
Nahashchʼidí (naaldeehii)	Texugo-americano
Bisóodi bideeʼ názhahígíí	Babyrousa
Tsídii bichʼahtsooígíí	Buceros bicornis
Shádiʼááhdę́ę́ʼ bisóodi diʼilígíí	Tayassuidae
Náʼagéédí bizaʼazis hólóní	Notoryctemorphia
Bilagáana	Brancos
Tłʼézhiiłbáhí	Tachinidae
Shash nátʼoh	Tribulus terrestris
Jádítsoh diłhiłígíí	Niala
Jádítsoh bideeʼ shiyishígíí	Palanca-negra
Dlǫ́ʼiitsoh łikizhígíí	Civeta-africana
Tsinaʼayąʼii yildeełí	Numbat
Tsétah tłʼízí	Oreamnos americanus
Jááłániichilí bighádzígaiígíí	Symphyla
Gahchilí	Brachylagus idahoensis
Cháʼoł bidahtsʼaaʼ	Arceuthobium
Dééłgai bitsiiʼ halzhinígíí	Cisne-de-pescoço-preto
Chʼosh nahachagii	Cicadellidae
Hóółtseiigi naʼastsʼǫǫsí	Gerbilo
Gaanłání	Ceriantharia
Dibédą́ą́ʼ	Shepherdia
Laanaa Yáʼátʼéehgo Késhmish	We Wish You a Merry Christmas
Jáád neishoodí (naʼashjéʼii haalzheehígíí)	Pompilidae
Naalʼeełí bidaatsʼózí	Mergus
Dahsánítsoh	Hystrix cristata
Naʼastsʼǫǫsí bitseeʼ dichʼízhí	Acomys
Tsétah nahatʼeʼiitsoh	Petrogale
Táłkááʼ dilwoʼí	Gerridae
Akáshtʼóózh biyaʼ	Psocoptera
Łeʼesoołii (bideeʼ ádinígíí)	Protura
Ąąʼąʼii	Pica (gênero)
Jádí bideeʼ dį́įʼii	Tetracerus quadricornis
Táłtłʼááh chʼosh ntsxaaígíí	Macrocheira kaempferi
Mósí ałchiní bitsiiʼtʼąhígíí	Gato-de-cabeça-chata
Naakaii Łizhiní Bikéyahdę́ę́ʼ naalʼeełítsoh dibéłchíʼígíí	Ganso-do-egito
Hosh aditsahiitsoh	Saguaro
Tʼáá łichíʼígo náʼagéédí	Rato-toupeira-pelado
Tsisteeł łizhinígíí	Jabuti
Iichʼąhii noodǫ́zí	Hyles lineata
Atʼąąʼ nahalinii	Phylliidae
Ghą́ą́ʼnoodǫ́ǫzii (tsin yigházhígíí)	Dinomys branickii
Łéʼétsoh beeniʼíhoniitaahígíí	Cavia
Ásaaʼ neiyéhii	Meloidae
Naʼashǫ́ʼiitsoh łitsooígíí	Iguana-terrestre-das-galápagos
Shádiʼááhdę́ę́ʼ tiníléí	Lagarto-de-contas
Sahdii Bisí (Tsé Nástánii)	Parque Nacional da Floresta Petrificada
Tsé Bighánílíní	Antelope Canyon
Naakaii Dootłʼizhii bimósí ałchinígíí	Prionailurus rubiginosus
Naʼashǫ́ʼiiłchííʼ dootłʼizhígíí	Agama mwanzae
Kʼaabizhii	Mammillaria
Dahiitį́hídą́ą́ʼtsoh	Castilleja
Wálázhini	Messor
Dlǫ́ʼbéʼézhóóʼ	Aristida
Chʼįdą́ą́ʼ	Ceanothus
Jáád neishoodí (łeyiʼdi bighanígíí)	Sphex
Dáʼághálii	Crotalaria
Chʼał bikʼos ádinígíí	Nasikabatrachus sahyadrensis
Jéí náyoogisii	Echinocereus
Tłʼohtah náshdóí	Gato-dos-pampas
Tsídii naʼałkǫ́ʼígíí	Papagaio-do-mar
Tsisteeł diyogí	Mata-mata
Łóóʼ adishishí ntsxaaígíí	Jamanta
Tónteel bibąąh hóyáanii	Boto-do-índico
Naakaii Łizhiní Bikéyahdę́ę́ʼ tsétah dibé	Ammotragus lervia
Naalʼeełí naashchʼąąʼígíí	Pato-carolino
Tsinlátah nahatʼeʼiitsoh	Canguru-arborícola
Tsin naaʼeeł łóó beeʼháʼhaalʼééłiʼ	Arrastão (pesca)
Chʼosh biyaʼ	Strepsiptera
Táłtłʼááh chʼosh	Dytiscidae
Gáagii dinéʼiʼ	Crows
Shádiʼááhdę́ę́ʼ tábąąstííntsoh	Leão-marinho-da-patagônia
Táłtłʼááh álééh	Garça-azul-grande
Táłtłʼááh naakaii náásééł yił aheełtʼéhii	Stomatopoda
Náátsʼózídę́ę́ʼ tsiiłtsooí	Faisão-dourado
Bisóodi Danilínígíí	Suina
Gólízhii noodǫ́zígíí	Cangambá
Naʼastsʼǫǫsí bijaaʼntsxaaígíí	Macrotis lagotis
Chʼééh digháhii bitsʼaʼ yilzhólí	Trionychidae
Chį́į́shghą́ʼiiłgaii	Sitta carolinensis
Hastiin Diego de Landa	Diego de Landa
Hastiin Biʼééʼ Łichíiʼii	Kit Carson
Mósí bizaʼazis hólóní	Dasyurus
Tségad	Selaginella
Tsįyaalzhahí	Gavião-miúdo
Hashtłʼishdi chʼééh digháhii	Kinosternidae
Yaaʼ nahachagiígíí	Siphonaptera
Kéʼ łizhiní	Blackfoot
Tábąąsdísí áłtsʼíísí	Maçarico-maculado
Dlǫ́ʼii łizhiní	Doninha-de-patas-pretas
Wóláchííʼ yildeełí łizhin dóó łigaígíí	Tamandua
Lókʼaatah bisóodi	Potamochoerus larvatus
Hakʼaz Dineʼé Bikéyahdę́ę́ʼ tábąąstííntsoh	Leão-marinho-de-steller
Dziłtah dlǫ́ʼii	Mustela altaica
Naayééʼ tsídiitsoh	Moa
Aghaałą́	El Capitan (Arizona)
Atseełtsoii	Búteo-de-cauda-vermelha
Tóniłhę́ęshii (dééł)	Grou-americano
Naaltsoos Mormon Wolyéhígíí	Livro de Mórmon
Dlǫ́ʼátah néʼéshjaaʼ	Coruja-buraqueira
Naʼashǫ́ʼii bijáád ádinígíí	Anfisbena
Naʼatłʼoʼii (chʼosh)	Embioptera
Dííłdzid yiyání	Staphylinidae
Tsintah łéʼétsoh	Neotoma
Kʼiishzhinii (tsin)	Carpinus caroliniana
Tʼiisbáí	Populus tremuloides
Yáhashjool yázhí	Socoí-vermelho
Tłʼéeʼgo mágí	Macaco-da-noite
Náʼagéédíchilí	Neurotrichus gibbsii
Chʼil ditsʼozíłchííʼ	Rambutão
Mágíłtsooí bináázhiní	Saimiri sciureus
Taʼneeskʼání	Meloa
Tsídiiłtsooí bitʼaʼ łizhinígíí	Carduelis tristis
Tsʼíʼii noodǫ́zí	Aedes albopictus
Anaasází	Anasazi
Chʼééh digháhiitsoh	Tartaruga-das-galápagos
Yeenaʼałkǫ́ʼíłániichilí	Remipedia
Naʼnízhoozhí Bił Hahoodzo	Condado de McKinley
Mąʼii Deeshgiizh Bił Hahoodzo	Condado de Sandoval
Naatoohí Bił Hahoodzo	Condado de Cibola
Ooljééʼ yiikááʼ nandahí	Alunissagem
Báshdo	Barstow (Califórnia)
Łóóʼ hashkéhé bíchį́į́hnézí	Tubarão-duende
Tłʼiishtsiiʼí (łóóʼ)	Channidae
Chéłchaaʼ bideeneezígíí	Besouro-hércules
Déłí	Grou-canadiano
Ąąʼąʼiiłbáhí	Pega-azul
Tsétah chaaʼ	Aplodontia rufa
Sighóla	Socorro (Novo México)
Chéłchaaʼ disxǫsígíí	Buprestidae
Naalʼeełí dootłʼizhí	Pato-d'asa-azul
Béíyózhin	Paiutes
Tsin naabąąs	Carroça coberta
Tó Hasłeeh	Mancos (Colorado)
2010 yihahígíí bílaʼashdlaʼii náóltahígíí	Censo dos Estados Unidos de 2010
Jádídlǫ́ʼii	Curruíra
Tłʼohchintó	Hotevilla-Bacavi
Tséʼédǫ́ʼii	Muscidae
Dahsání dah Yikahjí Tsin Deigházhígíí	Hystricomorpha
Níyolgi naʼałkǫ́ʼígíí (tónteel tsídii)	Petrel-mergulhador
Tsinaʼayąʼii biyázhí	Zoraptera
Sóól dichʼíizhii	Acer glabrum
Tseekʼi nástánii	Ammospermophilus
Naatooh Sikʼaiʼí	Grants (Novo México)
Tsooʼtsʼiní (łóóʼ)	Aruanã
Tsinaʼayąʼii	Isoptera
Náʼagéédí bíchį́į́h sǫʼ nahalinígíí	Condylura cristata
Tsįyaatsiiłchííʼ	Pyrocephalus rubinus
Náhookǫsdę́ę́ʼ tsétah dibé	Carneiro-de-dall
Naʼnízhoozhí	Gallup (Novo México)
Łóóʼ binááʼtsohí	Priacanthidae
Tsisteeł bikʼosneezígíí	Chelidae
Kilim	Kilim
Naatsisʼáán bińdíshchííʼ	Pinus flexilis
Chąąneiłhizii	Histeridae
Nákʼeʼnáʼijiní	Trepadeira-azul-do-canadá
Ałtaʼneetsʼéhii	Xanthium
Yáhashjool yił aheełtʼéhii	Eurypyga helias
Tsintah bisóoditsoh	Hylochoerus meinertzhageni
Zééjíjinii	Chauna torquata
Naʼníʼá Hayázhí	Cameron (Arizona)
Kááʼtsʼiní ditłʼooígíí	Chaetophractus
Naalkʼįhíchilí (bizaʼazis hólónígíí)	Acrobates pygmaeus
Adijiłii yił aheełtʼéhí	Echinops telfairi
Chį́į́shłigaií dóó Naalʼeełítsoh	Anserinae
Jádí biniiʼtsʼózí	Búbalu
Tábąąh jádí	Cob-untuoso
Jádí binááʼ dį́įʼii	Beatragus hunteri
Tó wónaanídę́ę́ʼ dlǫ́ʼáyázhí	Spermophilus citellus
Ásáí Dineʼé Bikéyahdę́ę́ʼ mąʼiitsoh	Lobo-árabe
Aniłtʼánii yázhí	Psyllidae
Chʼał mágí nahalinii	Phyllomedusa sauvagii
Nahatʼeʼiitsoh Bikéyahdę́ę́ʼ tązhii	Peru-do-mato
Mąʼii dootłʼizhí	Bassarisco
Chʼoshtsoh bíláshgaantsohí łikizhígíí	Enoplometopus
Łeʼesoołii (nahachaʼígíí)	Archaeognatha
Tóidoozohii bidaaʼ łigaiígíí	Fulica
Chéłchaaʼtsoh	Dynastinae
Wódisxǫsí	Scutelleridae
Kʼaalógiitsoh disxǫsígíí	Morpho (género)
Mąʼii Deeshgiizh	Jemez Springs (Novo México)
Tsisteeł hashkéhé	Chelydridae
Naʼastsʼǫǫsí bizaʼazis hólóní	Rato-marsupial-australiano
Tsídiidą́ą́ʼ	Phlox
Wóniłchxoní	Pentatomidae
Tsiikʼánii (tsídii)	Cabeça-de-martelo
Nahatʼeʼii niłchxoní	Hypsiprymnodon moschatus
Ábishjaaʼ (daadánígíí)	Cogumelo comestível
Tábąąh bisóodiłchíiʼii	Potamochoerus porcus
Tiníléítsoh naʼałkǫ́ʼígíí	Varano-malaio
Kézhoozhʼilí (tsin yigházhígíí)	Ctenodactylidae
Jádí bideeneezígíí	Oryx
Dáádílí łikizhígíí	Cromileptes altivelis
Tsísʼná náʼagéédígíí	Anthophorini
Mágíłbáhí	Cercopithecus mitis
Jaaʼditłʼoʼí naalkʼįhígíí (bizaʼazis hólónígíí)	Petauroides volans
Nahatʼeʼiitsoh yázhí	Thylogale
Sisnaajiní	Pico Blanca
Tółání	Laguna (Novo México)
Łóóʼ bigháhootʼíní	Ambassidae
Tónhidigaii	Silverton (Colorado)
Dééłtsoh	Abetarda-gigante
Shádiʼááhdę́ę́ʼ dahsání	Coendou prehensilis
Nahatʼeʼiitsoh Danilínígíí	Macropodiformes
Dlǫ́ʼii bitseenézí	Mustela frenata
Tsénáhádzoh	Twin Lakes (Novo México)
Kéyahígíí nidineesdzaʼ	Dust Bowl
Nahachagii dootłʼizhí	Tettigoniidae
Tsé Bíyah Aniiʼáhí	Parque Nacional Histórico da Cultura Chaco
Nahatʼeʼiitsoh Bikéyahdę́ę́ʼ biyázhí neiyéhé	Trichosurus vulpecula
Naaʼahóóhaiłbáhí	Perdix
Tsísʼnádą́ą́ʼ	Gaillardia
Jeeshóóʼ ałchozhígíí	Abutre-do-coconote
Łóóʼ adiłdoní	Toxotidae
Naakaii Łizhiní Bikéyahdę́ę́ʼ nahatʼeʼii	Pedetes capensis
Táłtłʼááh chʼosh chʼééh digháhii bitsʼaʼ ádinígíí	Nudibrânquios
Tiníléítsoh noodǫ́zígíí	Lagarto-do-nilo
Chʼał ntsxaaígíí	Conraua goliath
Tééh naaʼahóóhaitʼą́ʼí	Francolim
Halchíítah (Áshįįh Biiʼtó Hahoodzo)	Halchita
Nahatʼeʼiitsoh Bikéyahdę́ę́ʼ tábąąstííntsoh	Leão-marinho-australiano
Gałbáhí	Sylvilagus
Naʼazísí Toʼí	Cuba (Novo México)
Tsékááʼgóó naagháhii (chʼosh)	Mantophasmatodea
Tłʼohtahilzhahí	Seriema
Táłtłʼááh tsxilghááhtsoh	Cryptobranchidae
Chʼééh digháhii bitsiiʼntsxaaígíí	Platysternon megacephalum
Tsékʼi naʼałkǫ́ʼii	Toupeira-da-água
Naʼastsʼǫǫsítsoh (chʼosh yildeełígíí)	Solenodon paradoxus
Tsídiiłtsooí	Mariquita-amarela
Chʼagii	Agelaius phoeniceus
Łéʼétsoh diwozhí	Echinosorex gymnura
Łéʼétsoh bizaʼazis hólóní	Dasyuroides byrnei
Jeeshóóʼ bitsiiłgaiígíí	Abutre-de-cabeça-branca
Tábąądijádí	Borrelho-de-dupla-coleira
Naʼazísí	Geomyidae
Łeeyiʼ chʼał dichʼízhí	Rhinophrynus dorsalis
Táłtłʼááh naatʼáʼii	Dactylopteridae
Naakaii Dootłʼizhí Dabikéyah	Ásia Meridional
Ńdaʼatʼaałii bideeʼ dahólónígíí	Pecora
Naaldlooshii	Quadrupedalismo
Naaʼahóóhai bikeetsohígíí	Megapodius
Naʼashǫ́ʼii kááʼtsʼinígíí	Cordylus cataphractus
Kinteel (Yootó Hahoodzo)	Aztec (Novo México)
Naʼastsʼǫǫsí bitsʼohígíí	Hemicentetes
Bisóodi dághaaʼígíí	Sus barbatus
Iichʼąhii biyázhí	Aleyrodidae
Kin Noodǫ́ǫ́z	Bernalillo (Novo México)
Tsiikʼánii (łóóʼ ooshgę́ęzhii)	Rhinobatidae
Biniiʼdootłʼizh	Glaucidium
Mágí biniiłgaígíí	Pithecia pithecia
Tłʼoh azihii	Ephedrales
Kʼaalógii bitʼaʼ disxǫsgo łikizhígíí	Riodinidae
Tiníléítsoh bikʼosnézí	Varanus griseus
Shádiʼááhdę́ę́ʼ gahniiʼí ntsxaaígíí	Dolichotis
Łéʼétsoh bitseetłʼooígíí	Petromus typicus
Mágí naashchʼąąʼígíí	Pygathrix nemaeus
Łeeyiʼ bitiiní	Arvicolinae
Dáádílítsoh	Garoupa-gigante
Tsétah bįįhchilí	Pudu
Tsʼánídílzhiʼí	Aphelocoma californica
Iichʼąh	Convulsão
Jeeshóóʼ bitsiiłtsooí	Urubu-de-cabeça-amarela
Dlǫ́ʼii noodǫ́zígíí	Doninha-de-nuca-branca
Tiníléítsoh dootłʼizhígíí	Varanus prasinus
Yáázhłání (naaldlooshii)	Tenrec ecaudatus
Łéʼétsoh yił aheełtʼéhii	Octodontidae
Tábąąh łéʼétsoh	Hydromys chrysogaster
Ghą́ą́ʼdiʼilii (tsin yigházhígíí)	Lophiomys imhausi
Lókʼaaʼ yigházhígíí	Thryonomys
Dichin	Inanição
Dilchʼóshii	Junco (gênero)
Chį́į́hʼadeeʼii (łóóʼ)	Polyodontidae
Hazéíntsxaaígíí	Ratufa
Kéyah Dańlínídę́ę́ʼ bisóodi bizęęs hastání	Sus cebifrons
Dzílí	Falcão-do-tanoeiro
Dah Naatʼaʼí Bééhoʼdílzin	Juramento de bandeira
Tónteel táshchozhii	Sternidae
Naʼastsʼǫǫsí noodǫ́zígíí	Lemniscomys
Tówoł	Taos (Novo México)
Díchʼíító	Bitter Springs
Łóóʼ binááʼ ádiní	Bagre-cego
Naabiʼání	Bloomfield (Novo México)
Tséłgaii Deezʼáhí	Bluff
Aniłtʼánii łizhinígíí	Sialidae
Mágí bichį́į́łgaígíí	Cercopithecus ascanius
Naakaii Bikéyahdę́ę́ʼ bįįh yázhí	Mazama
Naʼashǫ́ʼii dootłʼizhí (naaldeehii)	Crotaphytus collaris
Łéʼétsoh gahjaaʼígíí	Hypogeomys antimena
Chʼoshtsoh bíláshgaanʼilí	Kiwa hirsuta
Anáʼálwoʼ:Bee hadítʼéhígíí	Ajuda:Página principal
Deinihootso	Dennehotso
Táłtłʼááh chʼoshtsoh bideeneezí	Lagosta
Moháábii dinéʼiʼ	Mohave (etnia)
Hodíílid	Dolores (Colorado)
Néʼéshjaaʼkálii	Mocho-duende
Chaaʼ Bitoʼ	McNary (Arizona)
Tiníléítsoh łikizhígíí	Varano-gigante
Tsé noolchʼóshiiłbáhí	Salpinctes
Chʼiyíítʼogii	Tyrannus
Dloziłgaii	Tamiasciurus
Tsísʼná dootłʼizhí	Vespa-cuco
Halchíítah	Deserto Pintado (Estados Unidos)
Tsʼahchʼil	Sphaeralcea
Wóósitsʼílí	Cimicidae
Tsé Nikání	Round Rock (Arizona)
Biizhii	Bacurau-norte-americano
Tsidiłdǫǫhii	Megascops
Tsʼááhbįįh	Physaria
Dághaaʼ Łichííʼ	Kirtland (Novo México)
Jaaʼabaní	Microchiroptera
Chʼosh chʼééh digháhii bideeʼ dį́įʼii	Stylommatophora
Wóláchííʼ yildeełí	Vermilingua
Niłchʼiʼ bee naalkaahiʼ	Geostationary Operational Environmental Satellite
Hastiin Chʼil Haajiní (Manuelito)	Manuelito
Tó Sido Háálį́	Pagosa Springs
Tsisteeł naʼazísí	Tartaruga-do-deserto
Tó Diłhił Biih Yílį́	Snowflake (Arizona)
Yoołgai (Hoozdoh Hahoodzo)	Superior (Arizona)
Tsé Noodǫ́ǫ́z	Springerville
Kin Łání (Dibé Nitsaa Hahoodzo)	Durango (Colorado)
Tségháhoodzání	Window Rock
Tsé Yaatóhí	Cortez (Colorado)
Tótaʼ	Farmington (Novo México)
Tó Naneesdizí	Tuba City
Táłtłʼááh chʼoshtsoh bideeteelí	Scyllaridae
Tséhootsooí	Fort Defiance
Chʼínílį́	Chinle
Lókʼaaʼdeeshjin	Keams Canyon
Chʼoshtsoh bíláshgaantsohí (tónteelgiʼígíí)	Nephropidae
Tsʼímah	Chama (Novo México)
Nihookááʼ tsídii bichʼahígíí	Bucorvus
Azeeʼ hókánii łibáhígíí	Sonchus asper
Jélii łóóʼ daʼhólzhaʼígíí	Salpa
Nahatʼeʼii jáádnézí	Jaculus
Tsiiłchin Biiʼ Tó	Chilchinbito
Bikétłʼááh Hoolzhólígíí	Tylopoda
Deeschííʼ Bikooh	Cibecue
Tǫ́ʼgaaʼ	Cochiti (Novo México)
Táłtłʼááh séigoʼ bitsʼaʼígíí	Límulo
Nááʼnoodǫ́ǫzii	Thlaspi
Tóidoozohii dootłʼizhígíí	Porphyrio
Chʼagiiłbáhí	Molothrus
Jáád neishoodítsʼóóz	Ichneumonidae
Bitsiichįįshgahí	Nucifraga columbiana
Naʼashǫ́ʼii naatʼaʼí	Draco (género)
Łeeyiʼ chʼosh bikágí ntłʼizí	Hippoidea
Gólízhii bíchį́į́h tʼáá łichíiʼii	Conepatus
Iichʼąhii naashchʼąąʼígíí	Chrysiridia rhipheus
Ałchʼįʼ beʼastłʼóní	Tamal
Biniiʼnoodǫ́zí (tsin yigázhígíí)	Lagostomus maximus
Shádiʼááhdę́ę́ʼ chʼoshtsoh bíláshgaantsohí	Parastacidae
Gahjaaʼí bitseeneezígíí	Lagidium
Tsézhin Dilkǫǫh	Dilkon
Naaldlooshii Bikéshgaan Dahólónígíí	Ungulados
Tółání Biyáázh	North Acomita Village (Novo México)
Tó Dínéeshzheeʼ	Kayenta
Beehai (Kintah)	Dulce (Novo México)
Hasbídí Áshįįhí	East Fork
Chʼééh digháhii bitsʼaʼ dah deezʼáhí	Graptemys
Gadtsagí	Juniperus monosperma
Hashkʼaan bichʼosh	Prodoxidae
Chaatʼíní bichʼosh	Gastrophysa viridula
Niʼbéshjah	Amorpha
Tsídii bidaatsoh naashchʼąąʼí	Tucano
Kʼaiʼbiiʼtó	Kaibito
Chʼał bikéshgaan hólóní	Xenopus
Bidił Daazdoígíí dóó Daʼałtʼoʼígíí ałkééʼ daasdzoh	Lista de mamíferos
Dáánézí (łóóʼ)	Centriscidae
Tłʼiish bichóhí	Cascavel-chifruda
Tsékʼi yaʼiiʼáhii	Manduca sexta
Táłkááʼ sikaadí	Cerastium arvense
Dahtooʼ yinooghałii	Cistothorus palustris
Tsédááʼii	Oribatida
Hastiin Pavao Skalić	Skalić
Tʼááłáhági átʼéego:Bééshbichʼahí	Categoria:Alemanha
Tʼááłáhági átʼéego:Wááshindoon bikéyah ałhidadiidzooígíí	Categoria:Estados Unidos
Táłtłʼááh kʼaaʼ (łóóʼ)	Fistulariidae
Tʼááłáhági átʼéego:Dibé diníí bikéyah	Categoria:Espanha
Tʼááłáhági átʼéego:Naakaii Bikéyah	Categoria:México
Naalkʼįhí bizaʼazis hólóní	Petaurus
Wóódeʼełchíhii	Coreidae
Naʼashǫ́ʼii diwozhígíí	Cordylus giganteus
Choozhghalii	Icterus
Tsinlátah mąʼii	Olingo
Chʼosh dichiłí bitsʼaʼígíí	Mytiloida
Naatsédlózii	Geococcyx
Tʼááłáhági átʼéego:Bidił daazdoígíí dóó daʼałtʼoʼígíí	Categoria:Mamíferos
Tʼááłáhági átʼéego:Naaldlooshii dadichʼízhii	Categoria:Répteis
Tʼááłáhági átʼéego:Biyáázh Tsʼǫʼasánígíí	Categoria:Anfíbios
Tʼááłáhági átʼéego:Tsídii	Categoria:Aves
Tʼááłáhági átʼéego:Chʼosh doo yitʼíinii dláádí dóó Ábishjaaʼ	Categoria:Fungos
Tʼááłáhági átʼéego:Chʼil	Categoria:Plantas
Tʼááłáhági átʼéego:Nátʼą́ą́ʼ náháneʼ	Categoria:História
Tʼááłáhági átʼéego:Naʼalkaah	Categoria:Ciência
Tséchʼízhí	Rough Rock
Tsétaʼkin	San Ildefonso Pueblo (Novo México)
Niʼiijíhí	Navajo (Novo México)
Lókʼaahnteel	Ganado (Arizona)
Tsísʼná disxǫsígíí	Euglossini
Łóóʼtsoh bizábąąh shiyishí	Eubalaena
Tʼiis Názbąs	Teec Nos Pos
Díwózhii Biiʼ Tó	Greasewood
Tó hájiiloh	Santo Domingo Pueblo (Novo México)
Naashashí (Yootó Hahoodzo)	Santa Clara Pueblo (Novo México)
Táshchozhii ndiilkʼísii	Andorinha-de-dorso-acanelado
Hanáádlį́	Huerfano
Wóótsʼóóz	Alydidae
Tséʼałnáoztʼiʼí	Sanostee (Novo México)
Jádító	Jeddito
Iichʼąhii	Mariposa
Chʼoshtsoh yázhí bíláshgaantsohí	Galatheidae
Roman dinéʼiʼ	Roma Antiga
Tóyééʼ	Steamboat
Tsééhílį́	Tsaile
Shádiʼááhdę́ę́ʼ tsékʼi dlǫ́ǫ́ʼ	Mocó
Chʼílwozh	Whiteriver
Shą́ą́ʼtóhí	Shonto
Tó Nehelį́į́h	Tonalea
Kin Náztʼįʼ	Shongopovi
Tó Hałtsooí	Sheep Springs (Novo México)
Lókʼaʼchʼégai	Lukachukai
Tsé Binííʼtóhí	Tse Bonito (Novo México)
Tsiizizii	Leupp
Chʼoshtsoh bikágí diwozhí	Lithodidae
Yaʼniilzhiin	Torreon (Novo México)
Náhodeeshgiizh Chʼínílíní	Pueblo Pintado (Novo México)
Ooljééʼ Tó dóó Tsé Deelghasii	Oljato-Monument Valley (Arizona)
Dáʼákʼeh Halání	Many Farms
Názlíní	Nazlini
Niʼiijííh Hasání	Sawmill
Tsé Łichííʼ Dahazkání (Hoozdoh Hahoodzo)	Red Mesa
Maʼiitoʼí	Houck (Arizona)
Tó Niłtsʼílí	Crystal (Novo México)
Tábąąh béégashii ałchiní	Bubalus arnee
Dáádílí ntsxaaígíí	Mero
Naakaii Chʼah	Mexican Hat
Chʼosh ałchozhii (iichʼąhii)	Traça-das-roupas
Tʼááłáhági átʼéego:Ałtsʼáʼáztiin	Categoria:Desambiguação
Bis Deezʼáhí	Newcomb (Novo México)
Tʼiistsʼóóz	Populus angustifolia
Naatʼáanii Nééz	Shiprock (Novo México)
Tsékʼi naʼazólii	Sauromalus
Juan de Oñate	Juan de Oñate
Kʼish Chʼínítʼiʼ	Paguate (Novo México)
Sengaa	San Carlos (Arizona)
Ńdíshchííʼ Dah Shizhóód	Pinehill (Novo México)
Naatoohó (Kintah)	Isleta Village Proper (Novo México)
Atsá	Águia
Séíbéʼézhóóʼ	Muhlenbergia
Tłʼoh Łikizhí	Tesuque (Novo México)
Dibé łizhiní dinéʼiʼ	San Felipe Pueblo (Novo México)
Maʼii Tééh Yitłizhí	Brimhall Nizhoni (Novo México)
Tsé Chʼééchiiʼ	Mesita (Novo México)
Doo Alkʼahii	Upper Fruitland (Novo México)
Łichíiʼii	Lechee
Tsé Bitʼaʼí	Shiprock
Tʼiistsʼóóz Ńdeeshgizh	Crownpoint (Novo México)
Naashtʼézhí (Yootó Hahoodzo)	Zuni Pueblo (Novo México)
Ndilnaʼii	Folivora
Hashtłʼish Tó	Claypool (Arizona)
Oozéí Hayázhí	Moenkopi
Bíina	Ignacio (Colorado)
Tsé Dootłʼizh (Hoozdoh Hahoodzo)	Peridot (Arizona)
Chʼałtʼą́hí	Pipa (gênero)
Dą́ʼáchaan	Ustilago
Kinłitsosinil	Church Rock (Novo México)
Chʼil dilyésii	Gutierrezia
Iichʼąhiiłgai bitʼaʼnézí	Mariposa-imperador
Tsézhįįh Deezlį́	Black Rock (Novo México)
Séí nahachagiichilí (chʼosh bikágí ntłʼizí)	Talitridae
Naakaii Bitoʼ	Nakaibito (Novo México)
Wóláchííʼ azeeʼ	Dyssodia
Dólii Dził	Los Cerrillos (Novo México)
Tłʼohchiní	Ramah (Novo México)
Beʼekʼid Baa Ahoodzání	Pinon (Arizona)
Kin Dootłʼizhí	Towaoc
Wóótʼą́hí	Aradidae
Woodiniih azeeʼ (chʼil)	Thelesperma
Íijeehí	Lappula
Chéchʼízhí	Rock Springs (Novo México)
Naayízí (Yootó Hahoodzo)	Nageezi
Tsą́ą́haltsʼaaʼ	Lepidium montanum
Chʼil łizhiní	Coleogyne
Tó Haachʼiʼ	Tohatchi (Novo México)
Biʼééʼ dootłʼizhgo disxǫsígíí	Quetzal
Tʼáá Bííchʼį́įdii (Áshįįh Biiʼtó Hahoodzo)	Aneth
Kʼaiʼ Chʼíneeltłʼǫ́	La Jara (Novo México)
Dlǫ́ʼí Yázhí (Yootó Hahoodzo)	Thoreau (Novo México)
Tʼááłáhági átʼéego:Stubs	Categoria:!Esboços
Naayééʼ łóóʼ	Peixe pré-histórico
Bitłʼááh Bitoʼ	Beclabito (Novo México)
Bee álnééhí:User uk-2	Predefinição:User uk-2
Kin Łichííʼ (Yootó Hahoodzo)	San Juan (Novo México)
Naadą́ą́ʼ biyaʼ	Gorgulho-do-milho
Tʼiistsoh	Alamo (Novo México)
Nahashchʼidí (Yootó Hahoodzo)	Naschitti (Novo México)
Tʼáá Bííchʼį́įdii (Yootó Hahoodzo)	Yah-ta-hey (Novo México)
Hosh Dikʼání	Estação Anderson Mesa
Dinétah	Dinétah
Tʼááłáhági átʼéego:Wikipedia bots	Categoria:!Robôs
Niłtsínii bikétłʼóól dijoolí (daadánígíí)	Nabo
Bee álnééhí:Tl	Predefinição:Ligação para predefinição
Tʼááłáhági átʼéego:Bee Hazʼáanii	Categoria:Direito
Tʼááłáhági átʼéego:Kéyah daʼnaaznilígíí dóó kéyah biłhaʼdaʼhaasdzoígíí	Categoria:Países
Wikiibíídiiya:Dahwéetʼaahígíí	Wikipédia:Administradores
Wikiibíídiiya:Botígíí beehazʼą́ąnii	Wikipédia:Robôs
Ííjip	Egito
Bee álnééhí:Bot	Predefinição:Robô
Deeteel Bikéyah	Canadá
Wikiibíídiiya:Baa haneʼ	Wikipédia:Sobre a Wikipédia
Tʼááłáhági átʼéego:Béésh bichʼahníí bikéyah	Categoria:Países da Europa
Tʼááłáhági átʼéego:Wikiibíídiiya yee Hadítʼéhígíí	Categoria:Classificações dos tópicos principais
Tʼááłáhági átʼéego:Choyoołʼįįhí Bizaad	Categoria:!Wikipedistas por idioma
Anáʼálwoʼ:Wikiibíídiiya beehazʼą́ąnii	Wikipédia:Políticas e recomendações
Tséłnííʼjí (chʼil)	Adiantum capillus-veneris
Bee álnééhí:Softredirect	Predefinição:Pseudorredirecionamento
Chʼosh chʼééh digháhii	Gastrópodes
Diné Bizaad yee Nidaazbaaʼígíí	Códigos Navajos
Tʼááłáhági átʼéego:Saad	Categoria:Línguas
Wikiibíídiiya:General disclaimer	Wikipédia:Aviso geral
Tʼááłáhági átʼéego:Noindexed pages	Categoria:!Páginas não indexadas
Wikiibíídiiya:Statistics	Wikipédia:Estatísticas
Nahatʼeʼiitsoh	Canguru
Ayání bichʼil	Ratibida
Bikéétsíín ditłʼooí	Tetraneuris
Chʼil hochʼid	Dithyrea
Łóóʼ hashkéhéchilí	Chimaeriformes
Tʼááłáhági átʼéego:Living people	Categoria:Pessoas vivas
Tʼááłáhági átʼéego:Béésh bee akʼeʼelchíhí tʼáá bí nitsékeesígíí	Categoria:Computação
Bee álnééhí:Bots	Predefinição:Bots
Tʼááłáhági átʼéego:Naaltsoos	Categoria:Livros
Bee álnééhí:Wikisource	Predefinição:Wikisource
Bee álnééhí:Babel	Predefinição:Babel
Bee álnééhí:Commons	Predefinição:Commons
Bee álnééhí:Reflist	Predefinição:Referências
Bee álnééhí:Stub	Predefinição:Esboço
Bee álnééhí:User af-1	Predefinição:User af-1
Bee álnééhí:User ar-1	Predefinição:User ar-1
Bee álnééhí:User az	Predefinição:User az
Bee álnééhí:User bar-1	Predefinição:User bar-1
Bee álnééhí:User eo-1	Predefinição:User eo-1
Bee álnééhí:See also	Predefinição:VT
Bee álnééhí:User da-2	Predefinição:User da-2
Bee álnééhí:User da	Predefinição:User da
Bee álnééhí:User ca-1	Predefinição:User ca-1
Bee álnééhí:User be-2	Predefinição:User be-2
Bee álnééhí:User da-1	Predefinição:User da-1
Bee álnééhí:User cs-1	Predefinição:User cs-1
Bee álnééhí:User bg-1	Predefinição:User bg-1
Bee álnééhí:User eo-3	Predefinição:User eo-3
Bee álnééhí:User de	Predefinição:User de
Bee álnééhí:User de-1	Predefinição:User de-1
Bee álnééhí:User eu	Predefinição:User eu
Bee álnééhí:User et-1	Predefinição:User et-1
Bee álnééhí:User el	Predefinição:User el
Bee álnééhí:User es	Predefinição:User es
Bee álnééhí:User de-3	Predefinição:User de-3
Bee álnééhí:User en-3	Predefinição:User en-3
Bee álnééhí:User el-1	Predefinição:User el-1
Bee álnééhí:User en-1	Predefinição:User en-1
Bee álnééhí:User en-2	Predefinição:User en-2
Bee álnééhí:User fa-1	Predefinição:User fa-1
Bee álnééhí:User eo-2	Predefinição:User eo-2
Bee álnééhí:User en-4	Predefinição:User en-4
Bee álnééhí:User fi	Predefinição:User fi
Bee álnééhí:User en-0	Predefinição:User en-0
Bee álnééhí:User en	Predefinição:User en
Bee álnééhí:User de-2	Predefinição:User de-2
Bee álnééhí:User es-1	Predefinição:User es-1
Bee álnééhí:User fa	Predefinição:User fa
Bee álnééhí:User fi-1	Predefinição:User fi-1
Bee álnééhí:User fr-1	Predefinição:User fr-1
Bee álnééhí:User ia-2	Predefinição:User ia-2
Bee álnééhí:User hi-1	Predefinição:User hi-1
Bee álnééhí:User hr	Predefinição:User hr
Bee álnééhí:User he-2	Predefinição:User he-2
Bee álnééhí:User he-1	Predefinição:User he-1
Bee álnééhí:User hu	Predefinição:User hu
Bee álnééhí:User id-3	Predefinição:User id-3
Bee álnééhí:User io-3	Predefinição:User io-3
Bee álnééhí:User it-3	Predefinição:User it-3
Bee álnééhí:User grc-1	Predefinição:User grc-1
Bee álnééhí:User sk	Predefinição:User sk
Bee álnééhí:User tr-2	Predefinição:User tr-2
Bee álnééhí:User fr-2	Predefinição:User fr-2
Bee álnééhí:User tr	Predefinição:User tr
Bee álnééhí:User ja	Predefinição:User ja
Bee álnééhí:User ja-1	Predefinição:User ja-1
Bee álnééhí:User it-1	Predefinição:User it-1
Bee álnééhí:User hr-1	Predefinição:User hr-1
Bee álnééhí:User fr	Predefinição:User fr
Bee álnééhí:User gsw-1	Predefinição:User gsw-1
Bee álnééhí:User he	Predefinição:User he
Tʼááłáhági átʼéego:Chʼosh bijáád hastánígíí	Categoria:Insectos
Tʼááłáhági átʼéego:Choyoołʼįįhí uk	Categoria:Usuários uk
Tʼááłáhági átʼéego:Choyoołʼįįhí uk-N	Categoria:Usuário uk
Tʼááłáhági átʼéego:Chʼiyáán	Categoria:Alimentos
Bee álnééhí:User sv	Predefinição:User sv
Bee álnééhí:SIL	Predefinição:ISO639-3Documentação
Bee álnééhí:User it	Predefinição:User it
Bee álnééhí:User uk	Predefinição:User uk
Bee álnééhí:User es-2	Predefinição:User es-2
Tʼááłáhági átʼéego:Choyoołʼįįhí ms	Categoria:Usuários ms
Tʼááłáhági átʼéego:Choyoołʼįįhí fr-1	Categoria:Usuário fr-1
Bee álnééhí:Image label	Predefinição:Image label
Bee álnééhí:User ms	Predefinição:User ms
Tʼááłáhági átʼéego:Atsá dóó Giní Ndahalinígíí	Categoria:Falconiformes
Bee álnééhí:User hi-3	Predefinição:User hi-3
Tʼááłáhági átʼéego:Choyoołʼįįhí en-4	Categoria:Utilizador en-4
Tʼááłáhági átʼéego:Choyoołʼįįhí en	Categoria:Usuários en
Tʼááłáhági átʼéego:Choyoołʼįįhí zh	Categoria:Usuários zh
Tʼááłáhági átʼéego:Choyoołʼįįhí zh-N	Categoria:Usuário zh
Tʼááłáhági átʼéego:Choyoołʼįįhí en-2	Categoria:Usuário en-2
Bee álnééhí:User eo	Predefinição:User eo
Bee álnééhí:User zh	Predefinição:User zh
Bee álnééhí:User ru-4	Predefinição:User ru-4
Bee álnééhí:User sr	Predefinição:User sr
Bee álnééhí:GeoTemplate	Predefinição:GeoTemplate
Bee álnééhí:User nl-1	Predefinição:User nl-1
Bee álnééhí:User nl-2	Predefinição:User nl-2
Tʼááłáhági átʼéego:Néʼéshjaaʼ	Categoria:Corujas
Tʼááłáhági átʼéego:Choyoołʼįįhí hi	Categoria:Usuários hi
Tʼááłáhági átʼéego:Choyoołʼįįhí ms-N	Categoria:Usuário ms
Tʼááłáhági átʼéego:Dził	Categoria:Montanhas
Bee álnééhí:User ru	Predefinição:User ru
Tʼááłáhági átʼéego:Kéyah dah siʼánígíí	Categoria:América
Tʼááłáhági átʼéego:Choyoołʼįįhí bizaad-Templates	Categoria:!Predefinições de babel
Bee álnééhí:Archive	Predefinição:Arquivo-índice
Tʼááłáhági átʼéego:Siláołtsooí	Categoria:Tópicos militares
Tʼááłáhági átʼéego:Naʼashǫ́ʼii	Categoria:Lagartos
Bee álnééhí:User pt-1	Predefinição:User pt-1
Bee álnééhí:Tb	Predefinição:Resposta
Bee álnééhí:Pt elements	Predefinição:Tabela periódica compacta
Bee álnééhí:User pl	Predefinição:User pl
Bee álnééhí:User nl	Predefinição:User nl
Bee álnééhí:User no-2	Predefinição:User no-2
Bee álnééhí:Image label end	Predefinição:Image label end
Bee álnééhí:Userpage	Predefinição:Página de usuário
Bee álnééhí:Emergency-bot-shutoff	Predefinição:Botão de emergência
Bee álnééhí:User pl-1	Predefinição:User pl-1
Bee álnééhí:Image label small	Predefinição:Image label small
Bee álnééhí:Béésh Bich’ahníí Bikéyah	Predefinição:Mapa detalhado da Europa
Bee álnééhí:User fr-3	Predefinição:User fr-3
Bee álnééhí:User lt	Predefinição:User lt
Bee álnééhí:User nds-1	Predefinição:User nds-1
Tʼááłáhági átʼéego:Hosh	Categoria:Cactaceae
Bee álnééhí:User is-1	Predefinição:User is-1
Bee álnééhí:User is-2	Predefinição:User is-2
Bee álnééhí:User ar-2	Predefinição:User ar-2
Bee álnééhí:User ar-3	Predefinição:User ar-3
Bee álnééhí:User is	Predefinição:User is
Bee álnééhí:User ar	Predefinição:User ar
Bee álnééhí:User az-3	Predefinição:User az-3
Tʼááłáhági átʼéego:Choyoołʼįįhí ja-N	Categoria:Usuário ja
Bee álnééhí:@	Predefinição:@
Tʼááłáhági átʼéego:Tłʼoh	Categoria:Poaceae
Bee álnééhí:Ałtsʼáʼáztiin	Predefinição:Desambiguação
Bee álnééhí:User no-3	Predefinição:User no-3
Bee álnééhí:User ksh	Predefinição:User ksh
Bee álnééhí:User no	Predefinição:User no
Bee álnééhí:Chʼiyáánbiiʼ	Predefinição:Info/Valor nutricional
Bee álnééhí:Naʼalkaah	Predefinição:Ciências-vertical
Bee álnééhí:User sv-2	Predefinição:User sv-2
Tʼááłáhági átʼéego:Choyoołʼįįhí gsw-1	Categoria:Usuário gsw-1
Bee álnééhí:User it-2	Predefinição:User it-2
Tʼááłáhági átʼéego:Kǫʼ naʼałbąąsii	Categoria:Transporte ferroviário
Tʼááłáhági átʼéego:Choyoołʼįįhí gsw-2	Categoria:Usuário gsw-2
Bee álnééhí:User pt-3	Predefinição:User pt-3
Bee álnééhí:User pt-2	Predefinição:User pt-2
Bee álnééhí:User th-1	Predefinição:User th-1
Bee álnééhí:User lb-1	Predefinição:User lb-1
Bee álnééhí:User ro	Predefinição:User ro
Bee álnééhí:User lv	Predefinição:User lv
Bee álnééhí:User bg	Predefinição:User bg
Tʼááłáhági átʼéego:Choyoołʼįįhí vi-3	Categoria:Usuário vi-3
Bee álnééhí:User la-1	Predefinição:User la-1
Bee álnééhí:User ay-3	Predefinição:User ay-3
Tʼááłáhági átʼéego:Templates/doc	Categoria:!Instruções de predefinições
Tʼááłáhági átʼéego:Choyoołʼįįhí pdc	Categoria:Usuários pdc
Tʼááłáhági átʼéego:Choyoołʼįįhí az	Categoria:Usuários az
Tʼááłáhági átʼéego:Choyoołʼįįhí be	Categoria:Usuários be
Tʼááłáhági átʼéego:Choyoołʼįįhí nb-N	Categoria:Usuário nb
Tʼááłáhági átʼéego:Choyoołʼįįhí bs	Categoria:Usuários bs
Tʼááłáhági átʼéego:Choyoołʼįįhí hr	Categoria:Usuários hr
Tʼááłáhági átʼéego:Choyoołʼįįhí sk	Categoria:Usuários sk
Tʼááłáhági átʼéego:Choyoołʼįįhí sl	Categoria:Usuários sl
Tʼááłáhági átʼéego:Choyoołʼįįhí eo	Categoria:Usuários eo
Tʼááłáhági átʼéego:Choyoołʼįįhí et	Categoria:Usuários et
Tʼááłáhági átʼéego:Choyoołʼįįhí fr	Categoria:Usuários fr
Tʼááłáhági átʼéego:Choyoołʼįįhí gl	Categoria:Usuários gl
Tʼááłáhági átʼéego:Choyoołʼįįhí cy	Categoria:Usuários cy
Tʼááłáhági átʼéego:Choyoołʼįįhí hu-N	Categoria:Usuário hu
Tʼááłáhági átʼéego:Choyoołʼįįhí id	Categoria:Usuários id
Tʼááłáhági átʼéego:Choyoołʼįįhí ia	Categoria:Usuários ia
Tʼááłáhági átʼéego:Choyoołʼįįhí ga	Categoria:Usuário ga
Tʼááłáhági átʼéego:Choyoołʼįįhí ja	Categoria:Usuários ja
Tʼááłáhági átʼéego:Choyoołʼįįhí la	Categoria:Usuários la
Tʼááłáhági átʼéego:Choyoołʼįįhí li	Categoria:Usuários li
Tʼááłáhági átʼéego:Choyoołʼįįhí lt	Categoria:Usuários lt
Tʼááłáhági átʼéego:Choyoołʼįįhí mk	Categoria:Usuários mk
Tʼááłáhági átʼéego:Choyoołʼįįhí mg	Categoria:Usuários mg
Tʼááłáhági átʼéego:Choyoołʼįįhí mwl	Categoria:Usuários mwl
Tʼááłáhági átʼéego:Choyoołʼįįhí mn	Categoria:Usuário mn
Tʼááłáhági átʼéego:Choyoołʼįįhí nn	Categoria:Usuários nn
Tʼááłáhági átʼéego:Choyoołʼįįhí nah	Categoria:Usuários nah
Tʼááłáhági átʼéego:Choyoołʼįįhí oc	Categoria:Usuários oc
Tʼááłáhági átʼéego:Choyoołʼįįhí pt	Categoria:Usuários pt
Tʼááłáhági átʼéego:Choyoołʼįįhí ro	Categoria:Usuários ro
Tʼááłáhági átʼéego:Choyoołʼįįhí sc	Categoria:Usuários sc
Tʼááłáhági átʼéego:Choyoołʼįįhí sh	Categoria:Usuários sh
Tʼááłáhági átʼéego:Choyoołʼįįhí sv	Categoria:Usuários sv
Tʼááłáhági átʼéego:Choyoołʼįįhí sw	Categoria:Usuários sw
Tʼááłáhági átʼéego:Choyoołʼįįhí sa	Categoria:Usuários sa
Tʼááłáhági átʼéego:Choyoołʼįįhí th	Categoria:Usuários th
Tʼááłáhági átʼéego:Choyoołʼįįhí ta	Categoria:Usuários ta
Tʼááłáhági átʼéego:Choyoołʼįįhí vo	Categoria:Usuários vo
Tʼááłáhági átʼéego:Choyoołʼįįhí bar-3	Categoria:Usuário bar-3
Tʼááłáhági átʼéego:Choyoołʼįįhí az-3	Categoria:Usuário az-3
Tʼááłáhági átʼéego:Choyoołʼįįhí be-3	Categoria:Usuário be-3
Tʼááłáhági átʼéego:Choyoołʼįįhí cs-3	Categoria:Usuário cs-3
Tʼááłáhági átʼéego:Choyoołʼįįhí sl-3	Categoria:Usuário sl-3
Tʼááłáhági átʼéego:Choyoołʼįįhí et-3	Categoria:Usuário et-3
Tʼááłáhági átʼéego:Choyoołʼįįhí fr-3	Categoria:Usuário fr-3
Tʼááłáhági átʼéego:Choyoołʼįįhí cy-3	Categoria:Usuário cy-3
Tʼááłáhági átʼéego:Choyoołʼįįhí hi-3	Categoria:Usuário hi-3
Tʼááłáhági átʼéego:Choyoołʼįįhí ia-3	Categoria:Usuário ia-3
Tʼááłáhági átʼéego:Choyoołʼįįhí it-3	Categoria:Usuário it-3
Tʼááłáhági átʼéego:Choyoołʼįįhí ja-3	Categoria:Usuário ja-3
Tʼááłáhági átʼéego:Choyoołʼįįhí li-3	Categoria:Usuário li-3
Tʼááłáhági átʼéego:Choyoołʼįįhí lt-3	Categoria:Usuário lt-3
Tʼááłáhági átʼéego:Choyoołʼįįhí mk-3	Categoria:Usuário mk-3
Tʼááłáhági átʼéego:Choyoołʼįįhí nl-3	Categoria:Usuário nl-3
Tʼááłáhági átʼéego:Choyoołʼįįhí no-3	Categoria:Usuário no-3
Tʼááłáhági átʼéego:Choyoołʼįįhí nah-3	Categoria:Usuário nah-3
Tʼááłáhági átʼéego:Choyoołʼįįhí oc-3	Categoria:Usuário oc-3
Tʼááłáhági átʼéego:Choyoołʼįįhí pl-3	Categoria:Usuário pl-3
Tʼááłáhági átʼéego:Choyoołʼįįhí sh-3	Categoria:Usuário sh-3
Tʼááłáhági átʼéego:Choyoołʼįįhí sa-3	Categoria:Usuário sa-3
Tʼááłáhági átʼéego:Choyoołʼįįhí ta-3	Categoria:Usuário ta-3
Tʼááłáhági átʼéego:Choyoołʼįįhí tr-3	Categoria:Usuário tr-3
Tʼááłáhági átʼéego:Choyoołʼįįhí ar-3	Categoria:Usuário ar-3
Tʼááłáhági átʼéego:Choyoołʼįįhí pdc-1	Categoria:Usuário pdc-1
Tʼááłáhági átʼéego:Choyoołʼįįhí an-1	Categoria:Usuário an-1
Tʼááłáhági átʼéego:Choyoołʼįįhí be-1	Categoria:Usuário be-1
Tʼááłáhági átʼéego:Choyoołʼįįhí cs-1	Categoria:Usuário cs-1
Tʼááłáhági átʼéego:Choyoołʼįįhí da-1	Categoria:Usuário da-1
Tʼááłáhági átʼéego:Choyoołʼįįhí sl-1	Categoria:Usuário sl-1
Tʼááłáhági átʼéego:Choyoołʼįįhí et-1	Categoria:Usuário et-1
Tʼááłáhági átʼéego:Choyoołʼįįhí fi-1	Categoria:Usuário fi-1
Tʼááłáhági átʼéego:Choyoołʼįįhí cy-1	Categoria:Usuário cy-1
Tʼááłáhági átʼéego:Choyoołʼįįhí hi-1	Categoria:Usuário hi-1
Tʼááłáhági átʼéego:Choyoołʼįįhí ia-1	Categoria:Usuário ia-1
Tʼááłáhági átʼéego:Choyoołʼįįhí ga-1	Categoria:Usuário ga-1
Tʼááłáhági átʼéego:Choyoołʼįįhí jv-1	Categoria:Usuário jv-1
Tʼááłáhági átʼéego:Choyoołʼįįhí lv-1	Categoria:Usuário lv-1
Tʼááłáhági átʼéego:Choyoołʼįįhí li-1	Categoria:Usuário li-1
Tʼááłáhági átʼéego:Choyoołʼįįhí lt-1	Categoria:Usuário lt-1
Tʼááłáhági átʼéego:Choyoołʼįįhí mk-1	Categoria:Usuário mk-1
Tʼááłáhági átʼéego:Choyoołʼįįhí nl-1	Categoria:Usuário nl-1
Tʼááłáhági átʼéego:Choyoołʼįįhí nah-1	Categoria:Usuário nah-1
Tʼááłáhági átʼéego:Choyoołʼįįhí oc-1	Categoria:Usuário oc-1
Tʼááłáhági átʼéego:Choyoołʼįįhí pl-1	Categoria:Usuário pl-1
Tʼááłáhági átʼéego:Choyoołʼįįhí ro-1	Categoria:Usuário ro-1
Tʼááłáhági átʼéego:Choyoołʼįįhí sc-1	Categoria:Usuário sc-1
Tʼááłáhági átʼéego:Choyoołʼįįhí sh-1	Categoria:Usuário sh-1
Tʼááłáhági átʼéego:Choyoołʼįįhí sa-1	Categoria:Usuário sa-1
Tʼááłáhági átʼéego:Choyoołʼįįhí tr-1	Categoria:Usuário tr-1
Tʼááłáhági átʼéego:Choyoołʼįįhí vo-1	Categoria:Usuário vo-1
Tʼááłáhági átʼéego:Choyoołʼįįhí ar-1	Categoria:Usuário ar-1
Tʼááłáhági átʼéego:Choyoołʼįįhí be-2	Categoria:Usuário be-2
Tʼááłáhági átʼéego:Choyoołʼįįhí bs-2	Categoria:Usuário bs-2
Tʼááłáhági átʼéego:Choyoołʼįįhí cs-2	Categoria:Usuário cs-2
Tʼááłáhági átʼéego:Choyoołʼįįhí da-2	Categoria:Usuário da-2
Tʼááłáhági átʼéego:Choyoołʼįįhí sk-2	Categoria:Usuário sk-2
Tʼááłáhági átʼéego:Choyoołʼįįhí sl-2	Categoria:Usuário sl-2
Tʼááłáhági átʼéego:Choyoołʼįįhí et-2	Categoria:Usuário et-2
Tʼááłáhági átʼéego:Choyoołʼįįhí fr-2	Categoria:Usuário fr-2
Tʼááłáhági átʼéego:Choyoołʼįįhí cy-2	Categoria:Usuário cy-2
Tʼááłáhági átʼéego:Choyoołʼįįhí hi-2	Categoria:Usuário hi-2
Tʼááłáhági átʼéego:Choyoołʼįįhí hu-2	Categoria:Usuário hu-2
Tʼááłáhági átʼéego:Choyoołʼįįhí ia-2	Categoria:Usuário ia-2
Tʼááłáhági átʼéego:Choyoołʼįįhí it-2	Categoria:Usuário it-2
Tʼááłáhági átʼéego:Choyoołʼįįhí ja-2	Categoria:Usuário ja-2
Tʼááłáhági átʼéego:Choyoołʼįįhí la-2	Categoria:Usuário la-2
Tʼááłáhági átʼéego:Choyoołʼįįhí li-2	Categoria:Usuário li-2
Tʼááłáhági átʼéego:Choyoołʼįįhí lt-2	Categoria:Usuário lt-2
Tʼááłáhági átʼéego:Choyoołʼįįhí mk-2	Categoria:Usuário mk-2
Tʼááłáhági átʼéego:Choyoołʼįįhí mwl-2	Categoria:Usuário mwl-2
Tʼááłáhági átʼéego:Choyoołʼįįhí nl-2	Categoria:Usuário nl-2
Tʼááłáhági átʼéego:Choyoołʼįįhí nah-2	Categoria:Usuário nah-2
Tʼááłáhági átʼéego:Choyoołʼįįhí oc-2	Categoria:Usuário oc-2
Tʼááłáhági átʼéego:Choyoołʼįįhí pl-2	Categoria:Usuário pl-2
Tʼááłáhági átʼéego:Choyoołʼįįhí sh-2	Categoria:Usuário sh-2
Tʼááłáhági átʼéego:Choyoołʼįįhí sv-2	Categoria:Usuário sv-2
Tʼááłáhági átʼéego:Choyoołʼįįhí sw-2	Categoria:Usuário sw-2
Tʼááłáhági átʼéego:Choyoołʼįįhí sa-2	Categoria:Usuário sa-2
Tʼááłáhági átʼéego:Choyoołʼįįhí tr-2	Categoria:Usuário tr-2
Tʼááłáhági átʼéego:Choyoołʼįįhí vo-2	Categoria:Usuário vo-2
Tʼááłáhági átʼéego:Choyoołʼįįhí ar-2	Categoria:Usuário ar-2
Tʼááłáhági átʼéego:Choyoołʼįįhí an-N	Categoria:Usuário an
Tʼááłáhági átʼéego:Choyoołʼįįhí hy-N	Categoria:Usuário hy
Tʼááłáhági átʼéego:Choyoołʼįįhí ast-N	Categoria:Usuário ast
Tʼááłáhági átʼéego:Choyoołʼįįhí be-N	Categoria:Usuário be
Tʼááłáhági átʼéego:Choyoołʼįįhí cs-N	Categoria:Usuário cs
Tʼááłáhági átʼéego:Choyoołʼįįhí ko-N	Categoria:Usuário ko
Tʼááłáhági átʼéego:Choyoołʼįįhí hr-N	Categoria:Usuário hr
Tʼááłáhági átʼéego:Choyoołʼįįhí sl-N	Categoria:Usuário sl
Tʼááłáhági átʼéego:Choyoołʼįįhí et-N	Categoria:Usuário et
Tʼááłáhági átʼéego:Choyoołʼįįhí fr-N	Categoria:Usuário fr
Tʼááłáhági átʼéego:Choyoołʼįįhí fy-N	Categoria:Usuário fy
Tʼááłáhági átʼéego:Choyoołʼįįhí gl-N	Categoria:Usuário gl
Tʼááłáhági átʼéego:Choyoołʼįįhí cy-N	Categoria:Usuário cy
Tʼááłáhági átʼéego:Choyoołʼįįhí hi-N	Categoria:Usuário hi
Tʼááłáhági átʼéego:Choyoołʼįįhí id-N	Categoria:Usuário id
Tʼááłáhági átʼéego:Choyoołʼįįhí ia-N	Categoria:Usuário ia
Tʼááłáhági átʼéego:Choyoołʼįįhí is-N	Categoria:Usuário is
Tʼááłáhági átʼéego:Choyoołʼįįhí it-N	Categoria:Usuário it
Tʼááłáhági átʼéego:Choyoołʼįįhí lv-N	Categoria:Usuário lv
Tʼááłáhági átʼéego:Choyoołʼįįhí li-N	Categoria:Usuário li
Tʼááłáhági átʼéego:Choyoołʼįįhí lt-N	Categoria:Usuário lt
Tʼááłáhági átʼéego:Choyoołʼįįhí lb-N	Categoria:Usuário lb
Tʼááłáhági átʼéego:Choyoołʼįįhí mk-N	Categoria:Usuário mk
Tʼááłáhági átʼéego:Choyoołʼįįhí mg-N	Categoria:Usuário mg
Tʼááłáhági átʼéego:Choyoołʼįįhí mwl-N	Categoria:Usuário mwl
Tʼááłáhági átʼéego:Choyoołʼįįhí nl-N	Categoria:Usuário nl
Tʼááłáhági átʼéego:Choyoołʼįįhí no-N	Categoria:Usuário no
Tʼááłáhági átʼéego:Choyoołʼįįhí nn-N	Categoria:Usuário nn
Tʼááłáhági átʼéego:Choyoołʼįįhí nah-N	Categoria:Usuário nah
Tʼááłáhági átʼéego:Choyoołʼįįhí oc-N	Categoria:Usuário oc
Tʼááłáhági átʼéego:Choyoołʼįįhí ru-N	Categoria:Usuário ru
Tʼááłáhági átʼéego:Choyoołʼįįhí sh-N	Categoria:Usuário sh
Tʼááłáhági átʼéego:Choyoołʼįįhí sa-N	Categoria:Usuário sa
Tʼááłáhági átʼéego:Choyoołʼįįhí ta-N	Categoria:Usuário ta
Tʼááłáhági átʼéego:Choyoołʼįįhí ar-N	Categoria:Usuário ar
Bee álnééhí:User pdc-1	Predefinição:User pdc-1
Tʼááłáhági átʼéego:Choyoołʼįįhí eu-3	Categoria:Usuário eu-3
Tʼááłáhági átʼéego:Choyoołʼįįhí eu-N	Categoria:Usuário eu
Tʼááłáhági átʼéego:Choyoołʼįįhí af	Categoria:Usuários af
Tʼááłáhági átʼéego:Choyoołʼįįhí af-1	Categoria:Usuário af-1
Tʼááłáhági átʼéego:Choyoołʼįįhí af-2	Categoria:Usuário af-2
Tʼááłáhági átʼéego:Choyoołʼįįhí af-3	Categoria:Usuário af-3
Tʼááłáhági átʼéego:Choyoołʼįįhí af-N	Categoria:Usuário af
Tʼááłáhági átʼéego:Choyoołʼįįhí als	Categoria:Usuários als
Tʼááłáhági átʼéego:Choyoołʼįįhí als-1	Categoria:Usuário als-1
Tʼááłáhági átʼéego:Choyoołʼįįhí an	Categoria:Usuários an
Tʼááłáhági átʼéego:Choyoołʼįįhí ar	Categoria:Usuários ar
Tʼááłáhági átʼéego:Choyoołʼįįhí ast	Categoria:Usuários ast
Tʼááłáhági átʼéego:Choyoołʼįįhí az-1	Categoria:Usuário az-1
Tʼááłáhági átʼéego:Choyoołʼįįhí az-2	Categoria:Usuário az-2
Tʼááłáhági átʼéego:Choyoołʼįįhí az-N	Categoria:Usuário az
Tʼááłáhági átʼéego:Choyoołʼįįhí bar	Categoria:Usuários bar
Tʼááłáhági átʼéego:Choyoołʼįįhí bar-1	Categoria:Usuário bar-1
Tʼááłáhági átʼéego:Choyoołʼįįhí bar-2	Categoria:Usuário bar-2
Tʼááłáhági átʼéego:Choyoołʼįįhí bar-N	Categoria:Usuário bar
Tʼááłáhági átʼéego:Choyoołʼįįhí bg	Categoria:Usuários bg
Tʼááłáhági átʼéego:Choyoołʼįįhí bg-1	Categoria:Usuário bg-1
Tʼááłáhági átʼéego:Choyoołʼįįhí bg-2	Categoria:Usuário bg-2
Tʼááłáhági átʼéego:Choyoołʼįįhí bg-3	Categoria:Usuário bg-3
Tʼááłáhági átʼéego:Choyoołʼįįhí bg-N	Categoria:Usuário bg
Tʼááłáhági átʼéego:Choyoołʼįįhí ca	Categoria:Usuários ca
Tʼááłáhági átʼéego:Choyoołʼįįhí ca-1	Categoria:Usuário ca-1
Tʼááłáhági átʼéego:Choyoołʼįįhí ca-2	Categoria:Usuário ca-2
Tʼááłáhági átʼéego:Choyoołʼįįhí ca-3	Categoria:Usuário ca-3
Tʼááłáhági átʼéego:Choyoołʼįįhí ca-N	Categoria:Usuário ca
Tʼááłáhági átʼéego:Choyoołʼįįhí cr	Categoria:Usuários cr
Tʼááłáhági átʼéego:Choyoołʼįįhí cr-1	Categoria:Usuário cr-1
Tʼááłáhági átʼéego:Choyoołʼįįhí cs	Categoria:Usuários cs
Tʼááłáhági átʼéego:Choyoołʼįįhí da	Categoria:Usuários da
Tʼááłáhági átʼéego:Choyoołʼįįhí sk-N	Categoria:Usuário sk
Tʼááłáhági átʼéego:Choyoołʼįįhí da-3	Categoria:Usuário da-3
Tʼááłáhági átʼéego:Choyoołʼįįhí de	Categoria:Usuários de
Tʼááłáhági átʼéego:Choyoołʼįįhí de-2	Categoria:Usuário de-2
Tʼááłáhági átʼéego:Choyoołʼįįhí de-3	Categoria:Usuário de-3
Tʼááłáhági átʼéego:Choyoołʼįįhí de-N	Categoria:Usuário de
Tʼááłáhági átʼéego:Choyoołʼįįhí dsb	Categoria:Usuários dsb
Tʼááłáhági átʼéego:Choyoołʼįįhí dsb-1	Categoria:Usuário dsb-1
Tʼááłáhági átʼéego:Choyoołʼįįhí dsb-2	Categoria:Usuário dsb-2
Tʼááłáhági átʼéego:Choyoołʼįįhí dsb-N	Categoria:Usuário dsb
Tʼááłáhági átʼéego:Choyoołʼįįhí el	Categoria:Usuários el
Tʼááłáhági átʼéego:Choyoołʼįįhí el-1	Categoria:Usuário el-1
Tʼááłáhági átʼéego:Choyoołʼįįhí el-2	Categoria:Usuário el-2
Tʼááłáhági átʼéego:Choyoołʼįįhí el-3	Categoria:Usuário el-3
Tʼááłáhági átʼéego:Choyoołʼįįhí el-N	Categoria:Usuário el
Tʼááłáhági átʼéego:Choyoołʼįįhí en-3	Categoria:Usuário en-3
Tʼááłáhági átʼéego:Choyoołʼįįhí en-N	Categoria:Usuário en
Tʼááłáhági átʼéego:Choyoołʼįįhí eo-1	Categoria:Usuário eo-1
Tʼááłáhági átʼéego:Choyoołʼįįhí eo-2	Categoria:Usuário eo-2
Tʼááłáhági átʼéego:Choyoołʼįįhí eo-3	Categoria:Usuário eo-3
Tʼááłáhági átʼéego:Choyoołʼįįhí eo-N	Categoria:Usuário eo
Tʼááłáhági átʼéego:Choyoołʼįįhí es	Categoria:Usuários es
Tʼááłáhági átʼéego:Choyoołʼįįhí es-1	Categoria:Usuário es-1
Tʼááłáhági átʼéego:Choyoołʼįįhí es-2	Categoria:Usuário es-2
Tʼááłáhági átʼéego:Choyoołʼįįhí es-3	Categoria:Usuário es-3
Tʼááłáhági átʼéego:Choyoołʼįįhí es-4	Categoria:Usuário es-4
Tʼááłáhági átʼéego:Choyoołʼįįhí es-N	Categoria:Usuário es
Tʼááłáhági átʼéego:Choyoołʼįįhí eu	Categoria:Usuários eu
Tʼááłáhági átʼéego:Choyoołʼįįhí eu-1	Categoria:Usuário eu-1
Tʼááłáhági átʼéego:Choyoołʼįįhí eu-2	Categoria:Usuário eu-2
Tʼááłáhági átʼéego:Choyoołʼįįhí fa	Categoria:Usuários fa
Tʼááłáhági átʼéego:Choyoołʼįįhí fa-1	Categoria:Usuário fa-1
Tʼááłáhági átʼéego:Choyoołʼįįhí fa-2	Categoria:Usuário fa-2
Tʼááłáhági átʼéego:Choyoołʼįįhí fa-3	Categoria:Usuário fa-3
Tʼááłáhági átʼéego:Choyoołʼįįhí fa-N	Categoria:Usuário fa
Tʼááłáhági átʼéego:Choyoołʼįįhí fi	Categoria:Usuários fi
Tʼááłáhági átʼéego:Choyoołʼįįhí fi-2	Categoria:Usuário fi-2
Tʼááłáhági átʼéego:Choyoołʼįįhí fi-3	Categoria:Usuário fi-3
Tʼááłáhági átʼéego:Choyoołʼįįhí fi-N	Categoria:Usuário fi
Tʼááłáhági átʼéego:Choyoołʼįįhí fy	Categoria:Usuários fy
Tʼááłáhági átʼéego:Choyoołʼįįhí fy-1	Categoria:Usuário fy-1
Tʼááłáhági átʼéego:Choyoołʼįįhí ga-2	Categoria:Usuário ga-2
Tʼááłáhági átʼéego:Choyoołʼįįhí ga-3	Categoria:Usuário ga-3
Tʼááłáhági átʼéego:Choyoołʼįįhí grc	Categoria:Usuários grc
Tʼááłáhági átʼéego:Choyoołʼįįhí grc-1	Categoria:Usuário grc-1
Tʼááłáhági átʼéego:Choyoołʼįįhí grc-2	Categoria:Usuário grc-2
Tʼááłáhági átʼéego:Choyoołʼįįhí grc-3	Categoria:Usuário grc-3
Tʼááłáhági átʼéego:Choyoołʼįįhí grc-N	Categoria:Usuário grc
Tʼááłáhági átʼéego:Choyoołʼįįhí gsw	Categoria:Usuários gsw
Tʼááłáhági átʼéego:Choyoołʼįįhí gsw-3	Categoria:Usuário gsw-3
Tʼááłáhági átʼéego:Choyoołʼįįhí gsw-N	Categoria:Usuário gsw
Tʼááłáhági átʼéego:Choyoołʼįįhí he	Categoria:Usuários he
Tʼááłáhági átʼéego:Choyoołʼįįhí he-1	Categoria:Usuário he-1
Tʼááłáhági átʼéego:Choyoołʼįįhí he-2	Categoria:Usuário he-2
Tʼááłáhági átʼéego:Choyoołʼįįhí he-3	Categoria:Usuário he-3
Tʼááłáhági átʼéego:Choyoołʼįįhí he-N	Categoria:Usuário he
Tʼááłáhági átʼéego:Choyoołʼįįhí hr-1	Categoria:Usuário hr-1
Tʼááłáhági átʼéego:Choyoołʼįįhí hr-2	Categoria:Usuário hr-2
Tʼááłáhági átʼéego:Choyoołʼįįhí hr-3	Categoria:Usuário hr-3
Tʼááłáhági átʼéego:Choyoołʼįįhí hsb	Categoria:Usuários hsb
Tʼááłáhági átʼéego:Choyoołʼįįhí hsb-1	Categoria:Usuário hsb-1
Tʼááłáhági átʼéego:Choyoołʼįįhí hsb-2	Categoria:Usuário hsb-2
Tʼááłáhági átʼéego:Choyoołʼįįhí hsb-3	Categoria:Usuário hsb-3
Tʼááłáhági átʼéego:Choyoołʼįįhí hu	Categoria:Usuários hu
Tʼááłáhági átʼéego:Choyoołʼįįhí hu-1	Categoria:Usuário hu-1
Tʼááłáhági átʼéego:Choyoołʼįįhí hu-3	Categoria:Usuário hu-3
Tʼááłáhági átʼéego:Choyoołʼįįhí hy	Categoria:Usuários hy
Tʼááłáhági átʼéego:Choyoołʼįįhí hy-1	Categoria:Usuário hy-1
Tʼááłáhági átʼéego:Choyoołʼįįhí hy-2	Categoria:Usuário hy-2
Tʼááłáhági átʼéego:Choyoołʼįįhí hy-3	Categoria:Usuário hy-3
Tʼááłáhági átʼéego:Choyoołʼįįhí id-1	Categoria:Usuário id-1
Tʼááłáhági átʼéego:Choyoołʼįįhí id-2	Categoria:Usuário id-2
Tʼááłáhági átʼéego:Choyoołʼįįhí id-3	Categoria:Usuário id-3
Tʼááłáhági átʼéego:Choyoołʼįįhí io	Categoria:Usuários io
Tʼááłáhági átʼéego:Choyoołʼįįhí io-1	Categoria:Usuário io-1
Tʼááłáhági átʼéego:Choyoołʼįįhí io-2	Categoria:Usuário io-2
Tʼááłáhági átʼéego:Choyoołʼįįhí io-3	Categoria:Usuário io-3
Tʼááłáhági átʼéego:Choyoołʼįįhí is	Categoria:Usuários is
Tʼááłáhági átʼéego:Choyoołʼįįhí is-1	Categoria:Usuário is-1
Tʼááłáhági átʼéego:Choyoołʼįįhí is-2	Categoria:Usuário is-2
Tʼááłáhági átʼéego:Choyoołʼįįhí is-3	Categoria:Usuário is-3
Bee álnééhí:User la-3	Predefinição:User la-3
Tʼááłáhági átʼéego:Choyoołʼįįhí pt-3	Categoria:Usuário pt-3
Tʼááłáhági átʼéego:Choyoołʼįįhí pl-N	Categoria:Usuário pl
Tʼááłáhági átʼéego:Choyoołʼįįhí pt-1	Categoria:Usuário pt-1
Tʼááłáhági átʼéego:Choyoołʼįįhí ka-1	Categoria:Usuário ka-1
Dził Naajiní	Montanha Ute
Bee álnééhí:Hooʼááłígíí	Wikipédia:Userbox/Administrador
Tʼááłáhági átʼéego:Choyoołʼįįhí it	Categoria:Usuários it
Tʼááłáhági átʼéego:Choyoołʼįįhí it-1	Categoria:Usuário it-1
Tʼááłáhági átʼéego:Choyoołʼįįhí ja-1	Categoria:Usuário ja-1
Tʼááłáhági átʼéego:Choyoołʼįįhí jv	Categoria:Usuários jv
Tʼááłáhági átʼéego:Choyoołʼįįhí jv-2	Categoria:Usuário jv-2
Tʼááłáhági átʼéego:Choyoołʼįįhí jv-3	Categoria:Usuário jv-3
Tʼááłáhági átʼéego:Choyoołʼįįhí ka	Categoria:Usuários ka
Tʼááłáhági átʼéego:Choyoołʼįįhí ka-2	Categoria:Usuário ka-2
Tʼááłáhági átʼéego:Choyoołʼįįhí ka-3	Categoria:Usuário ka-3
Tʼááłáhági átʼéego:Choyoołʼįįhí ka-N	Categoria:Usuário ka
Tʼááłáhági átʼéego:Choyoołʼįįhí ko	Categoria:Usuários ko
Tʼááłáhági átʼéego:Wááshindoon bikéyah bił haʼdaʼhaasdzoígíí	Categoria:Estados dos Estados Unidos
Tʼááłáhági átʼéego:Choyoołʼįįhí ko-1	Categoria:Usuário ko-1
Tʼááłáhági átʼéego:Choyoołʼįįhí ko-2	Categoria:Usuário ko-2
Tʼááłáhági átʼéego:Choyoołʼįįhí ko-3	Categoria:Usuário ko-3
Tʼááłáhági átʼéego:Choyoołʼįįhí ksh	Categoria:Usuários ksh
Tʼááłáhági átʼéego:Choyoołʼįįhí ksh-1	Categoria:Usuário ksh-1
Tʼááłáhági átʼéego:Choyoołʼįįhí ksh-2	Categoria:Usuário ksh-2
Tʼááłáhági átʼéego:Choyoołʼįįhí ksh-3	Categoria:Usuário ksh-3
Tʼááłáhági átʼéego:Choyoołʼįįhí ksh-N	Categoria:Usuário ksh
Tʼááłáhági átʼéego:Choyoołʼįįhí la-1	Categoria:Usuário la-1
Tʼááłáhági átʼéego:Choyoołʼįįhí la-3	Categoria:Usuário la-3
Tʼááłáhági átʼéego:Choyoołʼįįhí la-N	Categoria:Usuário la
Tʼááłáhági átʼéego:Choyoołʼįįhí lb	Categoria:Usuários lb
Tʼááłáhági átʼéego:Choyoołʼįįhí lb-1	Categoria:Usuário lb-1
Tʼááłáhági átʼéego:Choyoołʼįįhí lb-2	Categoria:Usuário lb-2
Tʼááłáhági átʼéego:Choyoołʼįįhí lb-3	Categoria:Usuário lb-3
Bee álnééhí:User sh	Predefinição:User sh
Tʼááłáhági átʼéego:Choyoołʼįįhí nn-2	Categoria:Usuário nn-2
Bee álnééhí:User gl	Predefinição:User gl
Tʼááłáhági átʼéego:Choyoołʼįįhí ru-1	Categoria:Usuário ru-1
Yaaʼ bijáád hastánígíí	Piolho
Bee álnééhí:User ta	Predefinição:User ta
Bee álnééhí:User sv-1	Predefinição:User sv-1
Tʼááłáhági átʼéego:Chʼil bikétłʼóól daadánígíí	Categoria:Raízes e tubérculos comestíveis
Tʼááłáhági átʼéego:Choyoołʼįįhí lv	Categoria:Usuários lv
Tʼááłáhági átʼéego:Choyoołʼįįhí mn-1	Categoria:Usuário mn-1
Tʼááłáhági átʼéego:Choyoołʼįįhí ms-1	Categoria:Usuário ms-1
Nahasdzáán bimagnetic field	Campo magnético terrestre
Bee álnééhí:User jv	Predefinição:User jv
Bee álnééhí:User id	Predefinição:User id
Tʼááłáhági átʼéego:Choyoołʼįįhí nds	Categoria:Usuários nds
Tʼááłáhági átʼéego:Choyoołʼįįhí nds-1	Categoria:Usuário nds-1
Tʼááłáhági átʼéego:Choyoołʼįįhí nds-2	Categoria:Usuário nds-2
Tʼááłáhági átʼéego:Choyoołʼįįhí nds-3	Categoria:Usuário nds-3
Tʼááłáhági átʼéego:Choyoołʼįįhí nds-N	Categoria:Usuário nds
Bee álnééhí:User oc-1	Predefinição:User oc-1
Tʼááłáhági átʼéego:Kéyah Ałhidadiidzooígíí dóó Ahiih Yikaígíí	Categoria:Organizações internacionais
Tʼááłáhági átʼéego:Chʼosh bijáád dahólónígíí	Categoria:Artrópodes
Tʼááłáhági átʼéego:Kʼaalógii	Categoria:Borboletas
Tʼááłáhági átʼéego:Tó	Categoria:Água
Tʼááłáhági átʼéego:Tsáʼásziʼ dóó Noodah	Categoria:Agavaceae
Tʼááłáhági átʼéego:Bidił daazdoígíí dóó daʼalghałígíí	Categoria:Carnívoros
Tʼááłáhági átʼéego:Choyoołʼįįhí nn-1	Categoria:Usuário nn-1
Tʼááłáhági átʼéego:Choyoołʼįįhí nb	Categoria:Usuários nb
Bee álnééhí:User ka-1	Predefinição:User ka-1
Bee álnééhí:User af	Predefinição:User af
Tʼááłáhági átʼéego:Naakaii Łizhiní Bikéyah	Categoria:Países de África
Bee álnééhí:User ka-3	Predefinição:User ka-3
Bee álnééhí:User da-3	Predefinição:User da-3
Bee álnééhí:User pt-4	Predefinição:User pt-4
Bee álnééhí:User sl-3	Predefinição:User sl-3
Bee álnééhí:User ja-2	Predefinição:User ja-2
Bee álnééhí:User ko-2	Predefinição:User ko-2
Bee álnééhí:User ko-1	Predefinição:User ko-1
Bee álnééhí:User cs	Predefinição:User cs
Bee álnééhí:User ru-2	Predefinição:User ru-2
Bee álnééhí:User es-3	Predefinição:User es-3
Bee álnééhí:User ja-3	Predefinição:User ja-3
Bee álnééhí:User eu-1	Predefinição:User eu-1
Bee álnééhí:User ko-3	Predefinição:User ko-3
Tʼááłáhági átʼéego:Choyoołʼįįhí pt-2	Categoria:Usuário pt-2
Tʼááłáhági átʼéego:Choyoołʼįįhí pt-4	Categoria:Usuário pt-4
Tʼááłáhági átʼéego:Choyoołʼįįhí pt-N	Categoria:Usuário pt
Tʼááłáhági átʼéego:Choyoołʼįįhí qu	Categoria:Usuários qu
Tʼááłáhági átʼéego:Choyoołʼįįhí qu-1	Categoria:Usuário qu-1
Tʼááłáhági átʼéego:Choyoołʼįįhí qu-2	Categoria:Usuário qu-2
Tʼááłáhági átʼéego:Choyoołʼįįhí qu-3	Categoria:Usuário qu-3
Tʼááłáhági átʼéego:Choyoołʼįįhí qu-N	Categoria:Usuário qu
Tʼááłáhági átʼéego:Choyoołʼįįhí ro-2	Categoria:Usuário ro-2
Tʼááłáhági átʼéego:Choyoołʼįįhí ro-3	Categoria:Usuário ro-3
Tʼááłáhági átʼéego:Choyoołʼįįhí ro-N	Categoria:Usuário ro
Tʼááłáhági átʼéego:Choyoołʼįįhí ru	Categoria:Usuários ru
Tʼááłáhági átʼéego:Choyoołʼįįhí ru-2	Categoria:Usuário ru-2
Tʼááłáhági átʼéego:Choyoołʼįįhí ru-3	Categoria:Usuário ru-3
Tʼááłáhági átʼéego:Choyoołʼįįhí ru-4	Categoria:Usuário ru-4
Tʼááłáhági átʼéego:Choyoołʼįįhí sk-1	Categoria:Usuário sk-1
Tʼááłáhági átʼéego:Choyoołʼįįhí sk-3	Categoria:Usuário sk-3
Tʼááłáhági átʼéego:Choyoołʼįįhí sr	Categoria:Usuários sr
Tʼááłáhági átʼéego:Choyoołʼįįhí sr-1	Categoria:Usuário sr-1
Tʼááłáhági átʼéego:Choyoołʼįįhí sr-2	Categoria:Usuário sr-2
Tʼááłáhági átʼéego:Choyoołʼįįhí sr-3	Categoria:Usuário sr-3
Tʼááłáhági átʼéego:Choyoołʼįįhí sr-N	Categoria:Usuário sr
Tʼááłáhági átʼéego:Choyoołʼįįhí sv-1	Categoria:Usuário sv-1
Tʼááłáhági átʼéego:Choyoołʼįįhí sv-3	Categoria:Usuário sv-3
Tʼááłáhági átʼéego:Choyoołʼįįhí sv-N	Categoria:Usuário sv
Tʼááłáhági átʼéego:Choyoołʼįįhí sxu	Categoria:Usuários sxu
Tʼááłáhági átʼéego:Choyoołʼįįhí sxu-1	Categoria:Usuário sxu-1
Tʼááłáhági átʼéego:Choyoołʼįįhí sxu-2	Categoria:Usuário sxu-2
Tʼááłáhági átʼéego:Choyoołʼįįhí sxu-3	Categoria:Usuário sxu-3
Tʼááłáhági átʼéego:Choyoołʼįįhí ta-1	Categoria:Usuário ta-1
Tʼááłáhági átʼéego:Choyoołʼįįhí ta-2	Categoria:Usuário ta-2
Tʼááłáhági átʼéego:Choyoołʼįįhí th-1	Categoria:Usuário th-1
Tʼááłáhági átʼéego:Choyoołʼįįhí th-2	Categoria:Usuário th-2
Tʼááłáhági átʼéego:Choyoołʼįįhí th-3	Categoria:Usuário th-3
Tʼááłáhági átʼéego:Choyoołʼįįhí th-N	Categoria:Usuário th
Tʼááłáhági átʼéego:Choyoołʼįįhí tr	Categoria:Usuários tr
Tʼááłáhági átʼéego:Choyoołʼįįhí tr-N	Categoria:Usuário tr
Tʼááłáhági átʼéego:Choyoołʼįįhí uk-1	Categoria:Usuário uk-1
Tʼááłáhági átʼéego:Choyoołʼįįhí uk-2	Categoria:Usuário uk-2
Tʼááłáhági átʼéego:Choyoołʼįįhí uk-3	Categoria:Usuário uk-3
Tʼááłáhági átʼéego:Choyoołʼįįhí uk-4	Categoria:Usuário uk-4
Tʼááłáhági átʼéego:Choyoołʼįįhí vi	Categoria:Usuários vi
Tʼááłáhági átʼéego:Choyoołʼįįhí vi-1	Categoria:Usuário vi-1
Tʼááłáhági átʼéego:Choyoołʼįįhí vi-2	Categoria:Usuário vi-2
Tʼááłáhági átʼéego:Choyoołʼįįhí vi-N	Categoria:Usuário vi
Bee álnééhí:User ro-1	Predefinição:User ro-1
Tʼááłáhági átʼéego:Tsin ííʼáhígíí	Categoria:Árvores
Bee álnééhí:User th	Predefinição:User th
Bee álnééhí:User nds-2	Predefinição:User nds-2
Náshdóítsoh (Ałtsʼáʼáztiin)	Grande felino
Bee álnééhí:User ca	Predefinição:User ca
Tʼááłáhági átʼéego:Mágí: Diné Ndahalinígíí	Categoria:Hominoidea
Tʼááłáhági átʼéego:Mágí	Categoria:Primatas
Bee álnééhí:LivingP	Predefinição:BPV
Bee álnééhí:User sv-3	Predefinição:User sv-3
Bee álnééhí:User hy-1	Predefinição:User hy-1
Bee álnééhí:User hsb-1	Predefinição:User hsb-1
Bee álnééhí:User hsb	Predefinição:User hsb
Tʼááłáhági átʼéego:Naʼiiniʼ	Categoria:Comércio
Bee álnééhí:User hsb-2	Predefinição:User hsb-2
Bee álnééhí:User af-3	Predefinição:User af-3
Tʼááłáhági átʼéego:Naaki góneʼ yéigo daʼahijoogą́ą́ʼ	Categoria:Segunda Guerra Mundial
Bee álnééhí:User ms-1	Predefinição:User ms-1
Tʼááłáhági átʼéego:Mósí dóó Náshdóí	Categoria:Felídeos
Bee álnééhí:User nds	Predefinição:User nds
Tʼááłáhági átʼéego:Tó Kéyah Bináhaazyínígíí	Categoria:Países insulares
Bee álnééhí:User az-2	Predefinição:User az-2
Bee álnééhí:User be	Predefinição:User be
Bee álnééhí:User ca-2	Predefinição:User ca-2
Bee álnééhí:User ca-3	Predefinição:User ca-3
Bee álnééhí:User cs-3	Predefinição:User cs-3
Bee álnééhí:User el-2	Predefinição:User el-2
Bee álnééhí:User et-3	Predefinição:User et-3
Bee álnééhí:User fa-2	Predefinição:User fa-2
Bee álnééhí:User fa-3	Predefinição:User fa-3
Bee álnééhí:User fi-2	Predefinição:User fi-2
Bee álnééhí:User fi-3	Predefinição:User fi-3
Bee álnééhí:User ga-2	Predefinição:User ga-2
Bee álnééhí:User he-3	Predefinição:User he-3
Bee álnééhí:User hu-1	Predefinição:User hu-1
Bee álnééhí:User hy	Predefinição:User hy
Bee álnééhí:User jv-1	Predefinição:User jv-1
Bee álnééhí:User ka	Predefinição:User ka
Bee álnééhí:User ko	Predefinição:User ko
Bee álnééhí:User la-2	Predefinição:User la-2
Bee álnééhí:User lb-2	Predefinição:User lb-2
Bee álnééhí:User li-1	Predefinição:User li-1
Bee álnééhí:User li-3	Predefinição:User li-3
Bee álnééhí:User mk-1	Predefinição:User mk-1
Bee álnééhí:User nn-2	Predefinição:User nn-2
Bee álnééhí:User no-1	Predefinição:User no-1
Bee álnééhí:User pl-2	Predefinição:User pl-2
Bee álnééhí:User pt	Predefinição:User pt
Bee álnééhí:User ro-2	Predefinição:User ro-2
Bee álnééhí:User ru-1	Predefinição:User ru-1
Bee álnééhí:User sa-1	Predefinição:User sa-1
Bee álnééhí:User sk-1	Predefinição:User sk-1
Bee álnééhí:User sk-2	Predefinição:User sk-2
Bee álnééhí:User sk-3	Predefinição:User sk-3
Bee álnééhí:User sr-1	Predefinição:User sr-1
Bee álnééhí:User sxu-1	Predefinição:User sxu-1
Bee álnééhí:User tr-1	Predefinição:User tr-1
Bee álnééhí:User tr-3	Predefinição:User tr-3
Bee álnééhí:User uk-1	Predefinição:User uk-1
Bee álnééhí:User uk-4	Predefinição:User uk-4
Bee álnééhí:User vo-1	Predefinição:User vo-1
Bee álnééhí:User zh-1	Predefinição:User zh-1
Bee álnééhí:User zh-2	Predefinição:User zh-2
Bee álnééhí:User zh-3	Predefinição:User zh-3
Tʼááłáhági átʼéego:Naakaii Łizhiní Bikéyahdę́ę́ʼ Ndaaldeehii	Categoria:Fauna de África
Tʼááłáhági átʼéego:Hakʼazdi Ndaaldeehii	Categoria:Fauna do Ártico
Tʼááłáhági átʼéego:Choyoołʼįįhí nl	Categoria:Usuários nl
Tʼááłáhági átʼéego:Choyoołʼįįhí nn-3	Categoria:Usuário nn-3
Tʼááłáhági átʼéego:Choyoołʼįįhí no-1	Categoria:Usuário no-1
Tʼááłáhági átʼéego:Choyoołʼįįhí no-2	Categoria:Usuário no-2
Tʼááłáhági átʼéego:Choyoołʼįįhí no	Categoria:Usuários no
Tʼááłáhági átʼéego:Choyoołʼįįhí zh-1	Categoria:Usuário zh-1
Tʼááłáhági átʼéego:Choyoołʼįįhí zh-3	Categoria:Usuário zh-3
Tʼááłáhági átʼéego:Choyoołʼįįhí zh-2	Categoria:Usuário zh-2
Tʼááłáhági átʼéego:Chʼał	Categoria:Anura
Tʼááłáhági átʼéego:Atłʼóóh	Categoria:Tecelagem
Tʼááłáhági átʼéego:Mąʼii yił Ałhidanoolinígíí Yázhí	Categoria:Procionídeos
Tʼááłáhági átʼéego:Bitsįʼ yishtłizhii	Categoria:Povos ameríndios
Tʼááłáhági átʼéego:Dlǫ́ʼiitsoh Danilínígíí	Categoria:Viverridae
Tʼááłáhági átʼéego:Chéłchaaʼ	Categoria:Besouros
Tʼááłáhági átʼéego:Naakáí dootłʼizhí dóó Bééshbichʼahii dabizaad ndahalinígíí	Categoria:Línguas indo-europeias
Tʼááłáhági átʼéego:Hazéí	Categoria:Esquilos
Tʼááłáhági átʼéego:Chidí naatʼaʼí ńdinibįįhígi	Categoria:Aeroportos
Tʼááłáhági átʼéego:Áʼádaatʼéhígíí	Categoria:Elementos químicos
Bee álnééhí:User pfl-1	Predefinição:User pfl-1
Bee álnééhí:User gsw-3	Predefinição:User gsw-3
Tʼááłáhági átʼéego:Mósí Danilínígíí	Categoria:Felis
Tʼááłáhági átʼéego:Articles by class	Categoria:!Artigos por qualidade
Tʼááłáhági átʼéego:Biwooʼ Ádaałtsʼíísígíí dóó Kááʼtsʼiní	Categoria:Xenarthra
Chʼoshtsoh bíláshgaantsohí (tónílį́įgiʼígíí)	Astacoidea
Tʼááłáhági átʼéego:Naakaii dootłʼizhí bikéyah	Categoria:Países da Ásia Meridional
Tʼááłáhági átʼéego:Abeʼ bitsʼą́ą́dóó ádaalyaaígíí	Categoria:Laticínios
Tʼááłáhági átʼéego:Tsin dóó chʼil bineestʼąʼ	Categoria:Frutos
Tʼááłáhági átʼéego:Kʼaalógii dóó Iichʼąhii	Categoria:Lepidoptera
Tʼááłáhági átʼéego:Chʼosh bijáád ádaadinígíí	Categoria:Moluscos
Tʼááłáhági átʼéego:Deeteel Bikéyah bił haʼdaʼhaasdzoígíí	Categoria:Territórios do Canadá
Tʼááłáhági átʼéego:Shádiʼááhdę́ę́ʼ Mágí	Categoria:Macacos do Novo Mundo
Tʼááłáhági átʼéego:Gáagii dóó Joogii Ndahalinígíí	Categoria:Corvidae
Tʼááłáhági átʼéego:Mąʼii dóó Łééchąąʼí	Categoria:Canídeos
Tʼááłáhági átʼéego:Tó Wónaanídę́ę́ʼ Mágí	Categoria:Cercopithecidae
Tʼááłáhági átʼéego:Naayízí dóó taʼneeskʼání	Categoria:Cucurbitaceae
Tʼááłáhági átʼéego:Dlǫ́ʼii Ndahalinígíí	Categoria:Mustelídeos
Tʼááłáhági átʼéego:Łóóʼtsoh biwooʼ dantłʼizígíí	Categoria:Odontocetos
Tʼááłáhági átʼéego:Łóóʼtsoh biwooʼ daditsʼózígíí	Categoria:Misticetos
Tʼááłáhági átʼéego:Naaldeehii	Categoria:Animais
Tʼááłáhági átʼéego:Shádiʼááhdę́ę́ʼ Ndaaldeehii	Categoria:Fauna da América do Sul
Tʼááłáhági átʼéego:Bizaʼazis Dahólónígíí	Categoria:Marsupiais
Nahashtʼeʼii azis (chʼil)	Reverchonia
Tʼááłáhági átʼéego:Choyoołʼįįhí pfl-1	Categoria:Usuário pfl-1
Tʼááłáhági átʼéego:Chʼosh chʼééh diikáhii	Categoria:Gastrópodes
Tʼááłáhági átʼéego:Chʼosh bitsʼaʼígíí	Categoria:Bivalves
Tʼááłáhági átʼéego:Gah	Categoria:Lagomorfos
Tʼááłáhági átʼéego:Łóóʼtsoh dóó Tééh hóyáanii	Categoria:Cetáceos
Bee álnééhí:User jv-2	Predefinição:User jv-2
Bee álnééhí:User fy-1	Predefinição:User fy-1
Bee álnééhí:User uk-3	Predefinição:User uk-3
Tʼááłáhági átʼéego:Eʼeʼaahjí Tónteel bikáaʼgi Kéyah dah Ndaaʼeełígíí	Categoria:Ilhas do Pacífico
Tʼááłáhági átʼéego:Łóóʼ Bigaan Dahólónígíí	Categoria:Cefalópodes
Tʼááłáhági átʼéego:Chʼééh digháhii dóó Tsisteeł	Categoria:Tartarugas
Tʼááłáhági átʼéego:Béésh	Categoria:Metais
Tʼááłáhági átʼéego:Naayééʼ	Categoria:Dinossauros
Tʼááłáhági átʼéego:Choyoołʼįįhí pl	Categoria:Usuários pl
Tʼááłáhági átʼéego:Chʼosh bikágí dantłʼizí	Categoria:Crustáceos
Tʼááłáhági átʼéego:Jaaʼabaní	Categoria:Morcegos
Tʼááłáhági átʼéego:Tłʼiish	Categoria:Serpentes
Tʼááłáhági átʼéego:Shádiʼááhjí kéyah yistinígíí	Categoria:Antártida
Tʼááłáhági átʼéego:Beʼekʼid	Categoria:Lagos
Bee álnééhí:User sl	Predefinição:User sl
Tʼááłáhági átʼéego:Łóóʼ hashkéhé	Categoria:Tubarões
Tʼááłáhági átʼéego:Łóóʼ ooshgę́ęzhii	Categoria:Chondrichthyes
Bee álnééhí:User hsb-3	Predefinição:User hsb-3
Tʼááłáhági átʼéego:Chidí	Categoria:Automóveis
Bee álnééhí:User ga-1	Predefinição:User ga-1
Bee álnééhí:User lb	Predefinição:User lb
Bee álnééhí:User af-2	Predefinição:User af-2
Chąąshtʼezhiitsoh	Cenoura
Tʼááłáhági átʼéego:Jeeshóóʼ	Categoria:Abutres do Novo Mundo
Tʼááłáhági átʼéego:Kéyah bił haʼdaʼhaasdzoígíí	Categoria:Subdivisões de países
Tséyooʼáałii	Curculionidae
Tʼááłáhági átʼéego:Łį́į́ʼ Ndahalinígíí	Categoria:Equídeos
Tʼááłáhági átʼéego:Naabeehó	Categoria:Nação Navajo
Tʼááłáhági átʼéego:Wóʼatsʼǫǫsii Ádaatʼéhígíí	Categoria:Hemiptera
Tʼááłáhági átʼéego:Tsin Deigházhígíí	Categoria:Roedores
Bee álnééhí:User hr-2	Predefinição:User hr-2
Bee álnééhí:User sl-1	Predefinição:User sl-1
Bee álnééhí:User pl-3	Predefinição:User pl-3
Bee álnééhí:User an-1	Predefinição:User an-1
Bee álnééhí:User vo-3	Predefinição:User vo-3
Bee álnééhí:User vo-2	Predefinição:User vo-2
Bee álnééhí:User vo	Predefinição:User vo
Bee álnééhí:User vi-2	Predefinição:User vi-2
Bee álnééhí:User vi-1	Predefinição:User vi-1
Bee álnééhí:User ta-3	Predefinição:User ta-3
Bee álnééhí:User ta-1	Predefinição:User ta-1
Bee álnééhí:User sxu-3	Predefinição:User sxu-3
Bee álnééhí:User sxu-2	Predefinição:User sxu-2
Bee álnééhí:User sxu	Predefinição:User sxu
Bee álnééhí:User sw	Predefinição:User sw
Bee álnééhí:User sr-3	Predefinição:User sr-3
Bee álnééhí:User sr-2	Predefinição:User sr-2
Bee álnééhí:User sl-2	Predefinição:User sl-2
Bee álnééhí:User sh-3	Predefinição:User sh-3
Bee álnééhí:User sh-1	Predefinição:User sh-1
Bee álnééhí:User sc-1	Predefinição:User sc-1
Bee álnééhí:User sa-3	Predefinição:User sa-3
Bee álnééhí:User qu-3	Predefinição:User qu-3
Bee álnééhí:User qu-2	Predefinição:User qu-2
Bee álnééhí:User qu-1	Predefinição:User qu-1
Bee álnééhí:User pfl	Predefinição:User pfl
Bee álnééhí:User oc-3	Predefinição:User oc-3
Bee álnééhí:User oc-2	Predefinição:User oc-2
Bee álnééhí:User oc	Predefinição:User oc
Bee álnééhí:User nds-3	Predefinição:User nds-3
Bee álnééhí:User nb	Predefinição:User nb
Bee álnééhí:User nah-3	Predefinição:User nah-3
Bee álnééhí:User nah-2	Predefinição:User nah-2
Bee álnééhí:User nah-1	Predefinição:User nah-1
Bee álnééhí:User mn-1	Predefinição:User mn-1
Bee álnééhí:User mk-3	Predefinição:User mk-3
Bee álnééhí:User mk-2	Predefinição:User mk-2
Bee álnééhí:User mk	Predefinição:User mk
Bee álnééhí:User lv-1	Predefinição:User lv-1
Bee álnééhí:User lt-3	Predefinição:User lt-3
Bee álnééhí:User lt-1	Predefinição:User lt-1
Bee álnééhí:User li-2	Predefinição:User li-2
Bee álnééhí:User lb-3	Predefinição:User lb-3
Bee álnééhí:User la	Predefinição:User la
Bee álnééhí:User ksh-3	Predefinição:User ksh-3
Bee álnééhí:User ksh-2	Predefinição:User ksh-2
Bee álnééhí:User ksh-1	Predefinição:User ksh-1
Bee álnééhí:User ka-2	Predefinição:User ka-2
Bee álnééhí:User jv-3	Predefinição:User jv-3
Bee álnééhí:User is-3	Predefinição:User is-3
Bee álnééhí:User io-2	Predefinição:User io-2
Bee álnééhí:User io-1	Predefinição:User io-1
Bee álnééhí:User id-2	Predefinição:User id-2
Bee álnééhí:User ia-3	Predefinição:User ia-3
Bee álnééhí:User ia-1	Predefinição:User ia-1
Bee álnééhí:User ia	Predefinição:User ia
Bee álnééhí:User hr-3	Predefinição:User hr-3
Bee álnééhí:User hi-2	Predefinição:User hi-2
Bee álnééhí:User grc-3	Predefinição:User grc-3
Bee álnééhí:User grc-2	Predefinição:User grc-2
Bee álnééhí:User grc	Predefinição:User grc
Bee álnééhí:User ga	Predefinição:User ga
Bee álnééhí:User et-2	Predefinição:User et-2
Bee álnééhí:User et	Predefinição:User et
Bee álnééhí:User el-3	Predefinição:User el-3
Bee álnééhí:User dsb-2	Predefinição:User dsb-2
Bee álnééhí:User dsb	Predefinição:User dsb
Bee álnééhí:User cy-3	Predefinição:User cy-3
Bee álnééhí:User cy-2	Predefinição:User cy-2
Bee álnééhí:User cy-1	Predefinição:User cy-1
Bee álnééhí:User cy	Predefinição:User cy
Bee álnééhí:User csb-1	Predefinição:User csb-1
Bee álnééhí:User cr-1	Predefinição:User cr-1
Bee álnééhí:User bs-2	Predefinição:User bs-2
Bee álnééhí:User bg-3	Predefinição:User bg-3
Bee álnééhí:User bg-2	Predefinição:User bg-2
Bee álnééhí:User be-3	Predefinição:User be-3
Bee álnééhí:User be-1	Predefinição:User be-1
Bee álnééhí:User an	Predefinição:User an
Bee álnééhí:User gl-2	Predefinição:User gl-2
Bee álnééhí:User eu-3	Predefinição:User eu-3
Bee álnééhí:User ast	Predefinição:User ast
Bee álnééhí:User ro-3	Predefinição:User ro-3
Tʼááłáhági átʼéego:Dlǫ́ʼii yił Aheedaałtʼéhígíí	Categoria:Herpestídeos
Bee álnééhí:User nah	Predefinição:User nah
Bee álnééhí:User eu-2	Predefinição:User eu-2
Tʼááłáhági átʼéego:Hoozdo Hahoodzodi chidí naatʼaʼí ńdinibįįhígi	Categoria:Aeroportos do Arizona
Tʼááłáhági átʼéego:Yootó Hahoodzodi chidí naatʼaʼí ńdinibįįhígi	Categoria:Aeroportos do Novo México
Tʼááłáhági átʼéego:Beeʼeldííldahsinil	Categoria:Albuquerque
Tʼááłáhági átʼéego:Chʼosh Deildeełii	Categoria:Insectívoros
Tʼááłáhági átʼéego:Tábąąstííntsoh	Categoria:Pinnipedia
Tʼááłáhági átʼéego:Táłkáaʼgi Tsídii	Categoria:Anseriformes
Tʼááłáhági átʼéego:Tsísʼná dóó Wáláchííʼ	Categoria:Apocrita
Tʼááłáhági átʼéego:Chʼosh bijáád tseebíhígíí	Categoria:Aracnídeos
Tʼááłáhági átʼéego:Yágháhonikáánji biłnaaztʼiʼígíí	Categoria:Exploração espacial
Tʼááłáhági átʼéego:Shash	Categoria:Ursídeos
Tʼááłáhági átʼéego:Tsin deiłkaałii	Categoria:Picidae
Tʼááłáhági átʼéego:Tsékooh	Categoria:Cânions
Tó bichʼoshtsoh	Belostomatidae
Tʼááłáhági átʼéego:Chʼosh bijáád neeznánígíí	Categoria:Decapoda
Tʼááłáhági átʼéego:Bílaʼashdlaʼii bilį́į́ʼ danilínígíí	Categoria:Animais domésticos
Tʼááłáhági átʼéego:Dziil / Atsiniltłʼish álʼį́	Categoria:Energia
Tʼááłáhági átʼéego:Shádiʼááh biyaadi dóó Kéyah Yistinígíí bikáaʼgi Ndaaldeehii	Categoria:Fauna da Antártica
Tʼááłáhági átʼéego:Nahatʼeʼiitsoh Bikéyahdę́ę́ʼ Ndaaldeehii	Categoria:Fauna da Austrália
Tʼááłáhági átʼéego:Tsʼíʼii dóó Tséʼédǫ́ʼii	Categoria:Moscas
Tʼááłáhági átʼéego:Tązhii dóó Naaʼahóóhai Ndahalinígíí	Categoria:Galliformes
Tʼááłáhági átʼéego:Tééh łééchąąʼí	Categoria:Hyaenidae
Tʼááłáhági átʼéego:Wónitłʼizí	Categoria:Isópodos
Tʼááłáhági átʼéego:Kǫʼ naʼałbąąsii ninádaaltłiʼígi	Categoria:Estações ferroviárias
Tʼááłáhági átʼéego:Daʼałtʼoʼígíí biyęęzhii deiłchíhígíí	Categoria:Monotremados
Tʼááłáhági átʼéego:Nahachagii dóó Nahakʼízii	Categoria:Orthoptera
Tʼááłáhági átʼéego:Chéłchaaʼ bigaantéłígíí	Categoria:Scarabaeidae
Tʼááłáhági átʼéego:Tábąąsdísí	Categoria:Scolopacidae
Tʼááłáhági átʼéego:Séigoʼ	Categoria:Escorpiões
Tʼááłáhági átʼéego:Táłtłʼááhdę́ę́ʼ dóó tónteel biyiʼdę́ę́ʼ chʼiyáán	Categoria:Frutos do mar
Tʼááłáhági átʼéego:Tsin naaʼeeł	Categoria:Navios
Tʼááłáhági átʼéego:Naʼashjéʼii	Categoria:Aranhas
Tʼááłáhági átʼéego:Jááłánii	Categoria:Miriápodes
Tʼááłáhági átʼéego:Bisóodi	Categoria:Suídeos
Tʼááłáhági átʼéego:Choyoołʼįįhí dsb-3	Categoria:Usuário dsb-3
Tʼááłáhági átʼéego:Choyoołʼįįhí pfl	Categoria:Usuários pfl
Tʼááłáhági átʼéego:Choyoołʼįįhí pfl-N	Categoria:Usuário pfl
Tʼááłáhági átʼéego:Azeeʼ	Categoria:Plantas medicinais
Tʼááłáhági átʼéego:Choyoołʼįįhí vo-3	Categoria:Usuário vo-3
Tʼááłáhági átʼéego:Naʼastsʼǫǫsí dóó Łéʼétsoh	Categoria:Muridae
Bee álnééhí:User cs-2	Predefinição:User cs-2
Bee álnééhí:Image label begin	Predefinição:Image label begin
Tʼááłáhági átʼéego:Yootó Hahoodzodi kin naaznilígíí	Categoria:Cidades do Novo México
Tʼááłáhági átʼéego:Choyoołʼįįhí hsb-N	Categoria:Usuário hsb
Tʼááłáhági átʼéego:Choyoołʼįįhí sxu-N	Categoria:Usuário sxu
Tʼááłáhági átʼéego:Naakaii Łizhiní Bikéyahdi Hadahóólįįdígíí	Categoria:Afrotheria
Tʼááłáhági átʼéego:Biishchʼid Dahólónígíí	Categoria:Placentalia
Bee álnééhí:User nn-3	Predefinição:User nn-3
Bee álnééhí:User vi	Predefinição:User vi
Tʼááłáhági átʼéego:Choyoołʼįįhí en-1	Categoria:Usuário en-1
Tʼááłáhági átʼéego:Choyoołʼįįhí de-1	Categoria:Usuário de-1
Tʼááłáhági átʼéego:Bikétłʼááh Hoolzhólígíí	Categoria:Tylopoda
Tʼááłáhági átʼéego:Choyoołʼįįhí da-N	Categoria:Usuário da
Tʼááłáhági átʼéego:Choyoołʼįįhí vo-N	Categoria:Usuário vo
Tʼááłáhági átʼéego:Choyoołʼįįhí gl-2	Categoria:Usuário gl-2
Tłʼiish áníní	Cascavel
Yaaʼ bijáád tseebíhígíí	Ixodida
Hatinídę́ę́ʼ tsídiiłgaii	Chionididae
Dahsání	Erethizon dorsatum
Tsiiyázhí (dééł)	Psophia
Bee álnééhí:User nn-1	Predefinição:User nn-1
Bee álnééhí:User lt-2	Predefinição:User lt-2
Bee álnééhí:User ru-3	Predefinição:User ru-3
Bee álnééhí:User az-1	Predefinição:User az-1
Bee álnééhí:User nl-3	Predefinição:User nl-3
Bee álnééhí:User nn	Predefinição:User nn
Bee álnééhí:User dsb-1	Predefinição:User dsb-1
Bee álnééhí:User mwl	Predefinição:User mwl
Bee álnééhí:User bar	Predefinição:User bar
Bee álnééhí:User sa-2	Predefinição:User sa-2
Bee álnééhí:User li	Predefinição:User li
Bee álnééhí:User bar-2	Predefinição:User bar-2
Bee álnééhí:User hy-2	Predefinição:User hy-2
Bee álnééhí:User fy	Predefinição:User fy
Bee álnééhí:User dsb-3	Predefinição:User dsb-3
Bee álnééhí:User hi	Predefinição:User hi
Bee álnééhí:User hu-2	Predefinição:User hu-2
Bee álnééhí:User bar-3	Predefinição:User bar-3
Bee álnééhí:User th-2	Predefinição:User th-2
Bee álnééhí:User sh-2	Predefinição:User sh-2
Bee álnééhí:User hu-3	Predefinição:User hu-3
Bee álnééhí:User pdc	Predefinição:User pdc
Bee álnééhí:User ga-3	Predefinição:User ga-3
Bee álnééhí:User qu	Predefinição:User qu
Bee álnééhí:User mwl-2	Predefinição:User mwl-2
Bee álnééhí:User vi-3	Predefinição:User vi-3
Bee álnééhí:User th-3	Predefinição:User th-3
Bee álnééhí:User ta-2	Predefinição:User ta-2
Bee álnééhí:User hy-3	Predefinição:User hy-3
Bee álnééhí:User id-1	Predefinição:User id-1
Bee álnééhí:Bidił daazdoígíí dóó da'ałt'o'ígíí	Predefinição:Mamíferos
Kʼaalógii	Borboleta
Akétłʼóól łichxííʼí yázhí	Rabanete
Bee álnééhí:Nobots	Predefinição:Nobots
Bee álnééhí:User gsw	Predefinição:User gsw
Bee álnééhí:User gsw-2	Predefinição:User gsw-2
Special:RecentChanges	Especial:Mudanças recentes
Gaantsʼosí dóó Sǫʼ łóóʼ biyaʼ	Myzostomida
Atseełtsʼózí (tónteel tsídii)	Rabo-de-palha
Ábishjaaʼ łóóʼ	Dendrogramma
