Afrika	África
Jabaan	Japão
Ameerikada koonfureed	América do Sul
Norway	Noruega
Ingiriiska	Inglaterra
Skotland	Escócia
Waalis	País de Gales
Waqooyiga Ayrland	Irlanda do Norte
Ireland	República da Irlanda
Hungaria	Hungria
Isbania	Espanha
Mareykanka	Estados Unidos
Beljim	Bélgica
Luksemburg	Luxemburgo
Koon	Universo
Dhul	Terra
Nolosha	Vida
Biniaadan	Homo sapiens
George Washington	George Washington
Finland	Finlândia
Iswiidhan	Suécia
Denmark	Dinamarca
Boland	Polónia
Lithuaniya	Lituânia
Talyaaniga	Itália
Iswisarland	Suíça
Austriya	Áustria
Giriig	Grécia
Turkiga	Turquia
Bortuqaal	Portugal
Yurub	Europa
Aasiya	Ásia
Woqooyiga Ameerika	América do Norte
Antiarktis	Antártida
Wikipedia	Wikipédia
Holland	Países Baixos
New York	Nova Iorque
Washington D.C	Washington, D.C.
Baarliin	Berlim
Los Angeles	Los Angeles
Boeing	Boeing
Kumbuyuutar	Computador
Jineefa	Genebra
Internet	Internet
Barack Obama	Barack Obama
Uruguay	Uruguai
London	Londres
Qaahiro	Cairo
Baariis	Paris
Android	Android
Google	Google
Meksiko	México
Badweynta Atlaantik	Oceano Atlântico
Badweynta Baasifik	Oceano Pacífico
Kalifornia	Califórnia
Isniin	Segunda-feira
Janaayo	Janeiro
Febraayo	Fevereiro
Maarso	Março
Farraare	Marte (planeta)
Kiinya	Quénia
Itoobiya	Etiópia
Gaana	Gana
Abriil	Abril
May	Maio
Juun	Junho
Luuliyo	Julho
Agoosto	Agosto
Sebteembar	Setembro
Oktoobar	Outubro
Nofeembar	Novembro
Diseembar	Dezembro
Talaado	Terça-feira
Arbaco	Quarta-feira
Khamiis	Quinta-feira
Jimco	Sexta-feira
Sabti	Sábado
Axad	Domingo
Libaax	Leão
Faransiiska	França
Esberanto	Esperanto
Ey	Canis lupus familiaris
Midowga boqortooyada Britan	Reino Unido
Yaanyuur	Gato
Shiinaha	República Popular da China
Af-Faransiis	Língua francesa
Malaay	Peixe
Khamri	Bebida alcoólica
Barasiil	Brasil
François Hollande	François Hollande
Ruushka	Rússia
Nibiri	Cetáceos
Labajibaarane	Quadrado
Bad	Mar
Bada madaw	Mar Negro
Pi Sumad xisaabeed	Pi
Cambe	Manga (fruta)
Wiki	Wiki
Toronto	Toronto
Alabama	Alabama
São Paulo	São Paulo (cidade)
São Paulo (Gobol)	São Paulo
Wikimedia	Wikimedia
Jimmy Wales	Jimmy Wales
Jarmalka	Alemanha
Belarus	Bielorrússia
Af-Jarmal	Língua alemã
Island	Islândia
Estoniya	Estónia
David Cameron	David Cameron
Raage	Saturno (planeta)
Chocolate	Chocolate
Dagaalada	Guerra
Kow	Um
Labo	Dois
Sadax	Três
Afar (lambar)	Quatro
Shan	Cinco
0	0 (número)
George W. Bush	George W. Bush
Laydi	Retângulo
Latfiya	Letónia
Ukrain	Ucrânia
Jamhuuriyadda Tashik	República Checa
Islofaakiya	Eslováquia
Isloveeniya	Eslovénia
Moldofa	Moldávia
Romania	Roménia
Bulgaria	Bulgária
Roma	Roma
Jamhuriyada Makedonia	República da Macedónia
Albania	Albânia
Griinland	Gronelândia
Kroatia	Croácia
Bosniya	Bósnia e Herzegovina
Aserbiijaan	Azerbaijão
Andorra	Andorra
Jasiirada Qabrus	Chipre
Joorjiya	Geórgia
Kasakhstan	Cazaquistão
Malta	Malta
Monako	Mónaco
Montenegro	Montenegro
Faatikan	Vaticano
San Marino	San Marino
Boroksel	Cidade de Bruxelas
Kuuba	Cuba
Belise	Belize
Barbados	Barbados
Indunisiya	Indonésia
Wolfgang Amadeus Mozart	Wolfgang Amadeus Mozart
Af-Turki	Língua turca
Koonfur Afrika	África do Sul
Aljeeriya	Argélia
Usbekistan	Uzbequistão
Biyo	Água
Alwaax	Madeira
Telefishin	Televisão
Claude Monet	Claude Monet
Diego Velázquez	Diego Velázquez
Jili	Chile
El Greco	El Greco
Ciise	Jesus
Dusaa	Mercúrio (planeta)
Taariikh	História
Apple Inc	Apple
Waxaraxir	Vénus (planeta)
Jaceyl	Amor
Cirjeex	Júpiter (planeta)
Uraano	Urano (planeta)
Nicolas Sarkozy	Nicolas Sarkozy
Nebtuun	Netuno (planeta)
Xiddigis	Astronomia
Singabuur	Singapura
Saynis	Ciência
Buluuto	Plutão
Liechtenstein	Liechtenstein
Ciyaaraha	Desporto
Adolf Hitler	Adolf Hitler
Facebook	Facebook
Julian Assange	Julian Assange
Dagaalkii koowaad	Primeira Guerra Mundial
Dagaalkii Labaad ee Aduunka	Segunda Guerra Mundial
Goorsheegto	Relógio
Linux	Linux
Xisaab	Matemática
Af-Laatiin	Língua latina
Baxrayn	Bahrein
Armania	Arménia
Seerbiya	Sérvia
Bil	Lua
Istanbuul	Istambul
Australia	Austrália
Fiisigis	Física
Arjantiina	Argentina
Isgaarsiinta	Telecomunicações
Peru	Peru
Bayoloji	Biologia
Waqooyiga Kuuriya	Coreia do Norte
Kambodiya	Camboja
Qur'aan	Alcorão
Diinsoor (xayawaan)	Dinossauros
Islaam	Islão
Ljubljana	Liubliana
World Wide Web	World Wide Web
Naag	Mulher
Gabay	Poesia
Chernobyl	Acidente nuclear de Chernobil
Milan	Milão
Torino	Turim
Liin dhanaan	Limão
Moos	Banana
Ubax	Flor
Magaalo	Cidade
Napoleon Bonaparte	Napoleão Bonaparte
Xidig	Estrela
Qorax	Sol
Cir	Céu
Tuulo	Aldeia
Ooshiyaaniya	Oceania
Bahda Midaysay Qoraxdu	Sistema Solar
Ilig	Dente
Hydrogen	Hidrogénio
Hiliyaam	Hélio
Cadaab	Inferno
Wikimedia Commons	Wikimedia Commons
Liithiyaam	Lítio
Beriiliyaam	Berílio
Buug	Livro
Maalin	Dia
Bariga Timor	Timor-Leste
Sanad	Ano
Qarni	Século
Oslo	Oslo
Lissabon	Lisboa
Dubay	Dubai
Lionel Messi	Lionel Messi
Booron	Boro
Versailles	Versalhes
Kaarboon	Carbono
Nitrojiin	Azoto
Ogsajiin	Oxigénio
FC Internazionale Milano	Football Club Internazionale Milano
Meere	Planeta
Muusig	Música
Moskow	Moscovo
Foloriin	Flúor
Af-Taliyaani	Língua italiana
Niyoon	Néon
Saint Petersburg	São Petersburgo
Jad	Chade
Sodhiyaam	Sódio
Woqooyi	Norte
Magniisiyaam	Magnésio
Alumiiniyaam	Alumínio
New Zealand	Nova Zelândia
Koonfur	Sul
Hindiya	Índia
Silikoon	Silício
Faransiyaam	Frâncio
Tuvalu	Tuvalu
Fosforos	Fósforo
Xadiid	Ferro
Galbeed	Oeste
Salfar	Enxofre
Bari (Jiho)	Leste
Jasiiradaha Solomon	Ilhas Salomão
Koloriin	Cloro
Koofurta Holland	Holanda do Sul
Balau	Palau
Aargon	Árgon
Nawru	Nauru
Firefox	Mozilla Firefox
Waqooyiga Holland	Holanda do Norte
Botashiyaam	Potássio
Zeeland	Zelândia (Países Baixos)
Kaalshiyaam	Cálcio
Flevoland	Flevolândia
Lead	Chumbo
Jasiirada Marshall	Ilhas Marshall
Kiribati	Kiribati
Mongolia	Mongólia
Fiji	Fiji
Iskaandhiyaam	Escândio
Titaaniyaam	Titânio
Fanansuwela	Venezuela
Jinkis Khan	Gengis Khan
Fanadhiyaam	Vanádio
Koroomiyaam	Crômio
Faras	Equus ferus caballus
Amistardam	Amesterdão
Hub	Arma
Xayawaan	Animalia
Surinam	Suriname
Manganiis	Manganês
Paraguay	Paraguai
Guyana	Guiana
Fan	Arte
Ikwadoor	Equador
Reheniyaam	Rênio
Kolombiya	Colômbia
Kobalti	Cobalto
Tungsten	Tungstênio
Nikel	Níquel
Boliifia	Bolívia
Osmiyaam	Ósmio
Groningen	Groninga (província)
Kober	Cobre
Beer	Plantae
Sinki	Zinco
Leonardo da Vinci	Leonardo da Vinci
Boqoshaa	Fungi
Jamayka	Jamaica
Friesland	Frísia (província)
Drenthe	Drente
Overijssel	Overissel
Guatemala	Guatemala
Gelderland	Guéldria
Utrecht	Utrecht (província)
Bahamas	Bahamas
Dooro	Gallus gallus domesticus
Antigua iyo Barbuda	Antígua e Barbuda
Hawaay	Havaí
Dominika	Dominica
Doofaar	Sus domesticus
Haiti	Haiti
El Salfador	El Salvador
Iiraan	Irão
Ciraaq	Iraque
Xikmad	Sapiência
Kosta Rika	Costa Rica
Israaiil	Israel
Magaalada Utrecht	Utrecht
Banama	Panamá
Yemen	Iémen
Virus	Vírus
Urdun	Jordânia
Nikaragua	Nicarágua
Florida	Flórida
Qargistan	Quirguistão
Kuwayt	Kuwait
Laos	Laos
Lubnaan	Líbano
Jasiirada Maldiif	Maldivas
Ameerika	América
Lo'	Bos taurus
Malaysiya	Malásia
Burma	Myanmar
Nebal	Nepal
Cumaan	Omã
Bakistaan	Paquistão
Qatar	Catar
Ciyaarta Teeniska	Ténis
Sacuudi Carabiya	Arábia Saudita
Siri Lanka	Sri Lanka
Suuriya	Síria
Gaaliyaam	Gálio
Tadsjikistan	Tajiquistão
Pokemon	Pokémon
Taywan	República da China
YouTube	YouTube
Jermaaniyaam	Germânio
Tayland	Tailândia
Tareen	Trem
Aarsenik	Arsênio
Turkmenistan	Turquemenistão
Seleniyaam	Selênio
Iridiyaam	Irídio
Imaaraatka Carabta	Emirados Árabes Unidos
Boromiin	Bromo
Balatiniyaam	Platina
Fiyetnam	Vietname
Charlie Chaplin	Charlie Chaplin
Koonfur Kuuriya	Coreia do Sul
Kiribtoon	Crípton
Afgaanistan	Afeganistão
Gangnam Style	Gangnam Style
Rubiidhiyaam	Rubídio
Dahab	Ouro
Kanaalka Suweys	Canal de Suez
Bangladesh	Bangladesh
Maali	Mali
Sokrades	Sócrates
Angola	Angola
Butaan	Butão
Twitter	Twitter
Barunay	Brunei
Tansaaniya	Tanzânia
Meerkuri	Mercúrio (elemento químico)
Roald Amundsen	Roald Amundsen
Harry Mulisch	Harry Mulisch
Filibiin	Filipinas
Jamhuuriyadda Bartamaha Afrika	República Centro-Africana
Cirifka Koonfur	Polo Sul
Cirifka waqooyi	Polo Norte
Isxaaq Newton	Isaac Newton
Albert Einstein	Albert Einstein
Istoroontiyaam	Estrôncio
Itriyaam	Ítrio
Bismuth	Bismuto
Jaale	Amarelo
Togo	Togo
Tunisiya	Tunísia
Saambiya	Zâmbia
Simbaabwi	Zimbabwe
Beijing	Pequim
Koonfur Suudaan	Sudão do Sul
Benin	Benim
Botswana	Botswana
Burkina Faso	Burkina Faso
Burundi	Burundi
Komoros	Comores
Jamhuuriyadda Kongo	República do Congo
Jamhuuriyada Dimuqaraadiga Kongo	República Democrática do Congo
Jabuuti	Djibouti
Boloniyaam	Polônio
Ikweetiga Guinea	Guiné Equatorial
Eratareya	Eritreia
New Delhi	Nova Deli
Astatiin	Ástato
Gabon	Gabão
Mahatma Gandhi	Mahatma Gandhi
Gambia	Gâmbia
Guinea	Guiné
Guinea-Bissau	Guiné-Bissau
Xeebta Foolmaroodi	Costa do Marfim
Kamiruun	Camarões
Kab Ferde	Cabo Verde
Lesotho	Lesoto
Liberia	Libéria
Libiya	Líbia
Madagaskar	Madagáscar
Malaawi	Malawi
Mauritania	Mauritânia
Mauritius	Maurícia
Marooko	Marrocos
Musanbiig	Moçambique
Nambiya	Namíbia
Nayjar	Níger
Nayjeeriya	Nigéria
Yugandha	Uganda
Ruwanda	Ruanda
Sirkooniyaam	Zircônio
Sao Tome iyo Prinsipe	São Tomé e Príncipe
Sinigaal	Senegal
Seyshelles	Seicheles
Sierra Leone	Serra Leoa
Soomaaliya	Somália
Niyobiyaam	Nióbio
Julius Caesar	Júlio César
Suudaan	Sudão
Swasiland	Suazilândia
Qaansa Roobaad	Arco-íris
Molybdenum	Molibdênio
Teknetiyaam	Tecnécio
Qaramada Midoobay	Organização das Nações Unidas
Juquraafi	Geografia
Wadno	Coração
Maskax	Cérebro
Maqaar	Pele
Midab	Cor
Rutheniyaam	Rutênio
Roodhiyaam	Ródio
Baluug	Azul
Baladiyaam	Paládio
Naxaas	Prata
Kaadmiyaam	Cádmio
Limburg	Limburgo (Países Baixos)
Tin (curiye)	Estanho
Antimony	Antimônio
Teluriyaam	Telúrio
Waqooyiga Brabant	Brabante do Norte
Aaydhiin	Iodo
Siinoon	Xenônio
Kaasiyaam	Césio
Baariyaam	Bário
Haafniyaam	Háfnio
Aktiiniyaam	Actínio
Tantalum	Tântalo (elemento químico)
Bill Clinton	Bill Clinton
Raadhiyaam	Rádio (elemento químico)
Raadhoon	Rádon
Lorraine	Lorena (França)
Buerto Riko	Porto Rico
Niedersachsen	Baixa Saxônia
Lombardia	Lombardia
Qudus	Jerusalém
Rutherfordium	Rutherfórdio
Dubniyaam	Dúbnio
Siiborgiyaam	Seabórgio
Badweynta Hindiya	Oceano Índico
Kosofo	Kosovo
Badda Karabiya	Mar do Caribe
Bohriyaam	Bóhrio
Hasiyaam	Hássio
Meitneriyaam	Meitnério
Darmstadtiyaam	Darmstácio
Roentgeniyaam	Roentgênio
Dortmund	Dortmund
Ununtriyaam	Unúntrio
Lifermoriyaam	Livermório
Ununoktiyaam	Ununóctio
Maastricht	Maastricht
Jiilaal	Inverno
Gu	Primavera
Xagaa	Verão
Dayr	Outono
Sadaam Xuseen	Saddam Hussein
Usaama bin Laadin	Osama bin Laden
Caarcaaro	Aranha
Miro	Fruto
Lacagta	Dinheiro
Xasharaad	Insetos
Faladimir Lenin	Lenin
Uetersen	Uetersen
Augustus Octavian	Augusto
Microsoft Windows	Microsoft Windows
Jibraltaar	Gibraltar
Nokia	Nokia
Baabuur	Automóvel
Juventus FC	Juventus Football Club
Texas	Texas
Bruno Mars	Bruno Mars
Sasiiliya	Sicília
Sardiiniya	Sardenha
Fuuqbax	Doença de Crohn
Buenos Aires	Buenos Aires
Tokyo	Tóquio
Barcelona	Barcelona
Abidjan	Abidjã
Minnesota	Minnesota
Baqdaad	Bagdá
Isuduwaha Waqtiga Caalamiga	Tempo Universal Coordenado
AC Milan	Associazione Calcio Milan
Buuri	Tabaco
Internet Explorer	Internet Explorer
Sigaar	Cigarro
Nayl armistaroong	Neil Armstrong
Maxamed Faarax	Mo Farah
München	Munique
Fiyena	Viena
Kobanhaygan	Copenhaga
Stockholm	Estocolmo
Helsinki	Helsínquia
Dublin	Dublin
Bratislava	Bratislava
Budapest	Budapeste
Frankfurt	Frankfurt am Main
Lanthanum	Lantânio
Kitaabka quduska	Bíblia
Phnom Penh	Phnom Penh
Ho Chi Minh City	Cidade de Ho Chi Minh
Luteetiyaam	Lutécio
Mida Rumeed Kaniisada Ciise	Verdadeira Igreja de Jesus
Ingiriis (luqad)	Língua inglesa
Bangkok	Banguecoque
Dong Hoi	Dong Hoi
Concepción	Concepción (Chile)
Franck Ribéry	Franck Ribéry
Ottawa	Ottawa
Dayaxa Cirjeex	Satélites de Júpiter
Juba	Juba (Sudão do Sul)
Końskowola	Końskowola
Dar es Salaam	Dar es Salaam
Khartuum	Cartum
Dayaxa raage	Satélites de Saturno
2000	2000
2003	2003
2002	2002
2001	2001
2012	2012
2011	2011
2010	2010
2009	2009
2013	2013
2014	2014
2008	2008
2004	2004
2005	2005
2006	2006
2007	2007
1900	1900
1901	1901
Charles De Gaulle	Charles de Gaulle
1906	1906
1908	1908
1909	1909
1992	1992
1991	1991
1990	1990
1993	1993
1994	1994
1995	1995
1996	1996
1910	1910
1911	1911
1912	1912
1913	1913
1914	1914
1997	1997
1998	1998
1999	1999
1918	1918
Cunto	Alimento
Mas	Serpente
Dayaxa docay	Satélites de Netuno
Dashiishe	1 de janeiro
1920	1920
1919	1919
1921	1921
Georges Pompidou	Georges Pompidou
Malmö	Malmö
Birmingham	Birmingham
Microsoft	Microsoft
Borotoon	Próton
Kurów	Kurów
Kimisteri	Química
Robin van Persie	Robin van Persie
27	27
1989	1989
1988	1988
1987	1987
1986	1986
1985	1985
1984	1984
1983	1983
1982	1982
1981	1981
1980	1980
Muqdisho	Mogadíscio
Sana'a	Saná
1970	1970
1971	1971
1972	1972
1973	1973
1974	1974
1975	1975
1976	1976
1977	1977
1978	1978
1979	1979
1969	1969
18 Abriil	18 de abril
25 Abriil	25 de abril
26 Abriil	26 de abril
Dayax	Satélite natural
Kristian Wulff	Christian Wulff
15 Meey	15 de maio
SSC Napoli	Società Sportiva Calcio Napoli
1968	1968
1967	1967
1966	1966
1965	1965
1964	1964
27 Juun	27 de junho
Kubadda Cagta	Futebol
AS Roma	Associazione Sportiva Roma
1963	1963
Holokost	Holocausto
1962	1962
Michael Jackson	Michael Jackson
Bogota	Bogotá
29 Diseembar	29 de dezembro
Quito	Quito
Adhi	Capra aegagrus hircus
21 Oktoobar	21 de outubro
Paramaribo	Paramaribo
Wiil	Menino
Gabar	Menina
Kanbera	Camberra
Sydney	Sydney
Cagaar	Verde
Gaduud	Vermelho
Perth	Perth (Austrália Ocidental)
Galbeed Australia (gobol)	Austrália Ocidental
New South Wales	Nova Gales do Sul
Wabiga Niil	Rio Nilo
Jini	Gênio
Wabiga Nijer	Rio Níger
Rabat	Rabat
Algiers	Argel
Tunis	Tunes
Triboli	Trípoli
Rede Globo	Rede Globo
Jabuuti (magaalo)	Djibouti (cidade)
Tahraan	Teerã
Addis Abeba	Adis Abeba
Ankara	Ancara
Asmara	Asmara
Nijamiina	N'Djamena
Niamey	Niamey
Nawakshot	Nouakchott
1961	1961
Bamako	Bamako
Belgaraad	Belgrado
Dakar	Dakar
Banjul	Banjul
Konakri	Conacri
Bissau	Bissau
Category:Template	Categoria:!Predefinições Wikipédia
Monrofia	Monróvia
Braia	Praia (Cabo Verde)
1960	1960
Akara	Acra
Dimishiq	Damasco
Yamoussoukro	Yamoussoukro
Faransiis Guyana	Guiana Francesa
Ougadougou	Ouagadougou
Freetown	Freetown
Abuja	Abuja
Lome	Lomé
Borto-Novo	Porto Novo (Benim)
Yawunde	Yaoundé
Malabo	Malabo
Librefille	Libreville
Bangui	Bangui
Kinshasa	Kinshasa
Barasafille	Brazzaville
Bujumbura	Bujumbura
Kigali	Kigali
Dodoma	Dodoma
Nayroobi	Nairóbi
Lilongwe	Lilongwe
Lusaka	Lusaka
Qorax madoobaad	Eclipse solar
Mabuto	Maputo
Kambaala	Kampala
Luanda	Luanda
Moroni	Moroni
Mabane	Mbabane
Maseru	Maseru
Dugsi	Escola
Antananarifo	Antananarivo
Jaamacad	Universidade
Gaborone	Gaborone
Harare	Harare
Pretoria	Pretória
Bort Lois	Port Louis
Sao Tome	São Tomé (São Tomé e Príncipe)
Windhoek	Windhoek
Wikipedia:Bacaadka	Wikipédia:Página de testes
Fiktoria	Victoria (Seychelles)
Guri	Casa
Kombuyuuterka Dhabta	Laptop
Computer Hardware	Hardware
Aljebra	Álgebra
Webiyada	Rio
Osasko	Osasco
Garoonka ee Dong Hoi	Aeroporto de Dong Hoi
Curitiba	Curitiba
Pangea	Pangeia
Keyn	Floresta
Anne Frank	Anne Frank
Shilin Soomaali	Xelim somaliano
Confucius	Confúcio
Category:Taariikhda Ciraaq	Categoria:História do Iraque
Corbin Bleu	Corbin Bleu
Category:Xisaab	Categoria:Matemática
Jasiiradaha Feroe	Ilhas Feroe
Maxamed Morsi	Mohamed Morsi
Euro	Euro
Bada Dhexe	Mar Mediterrâneo
Masiixiyad	Cristianismo
Windows 8	Windows 8
Template:Dalalka Aasiya	Predefinição:Países da Ásia
Bariis	Arroz
Céline Dion	Céline Dion
Qaaradaha	Continente
Adelaide	Adelaide (Austrália)
Shimbir	Aves
Template:Islaam	Predefinição:Islã
Bilaha	Mês
Mustafa Kemal Atatürk	Mustafa Kemal Atatürk
1948	1948
Jeejniya	Chechênia
1949	1949
Garoosni	Grózni
Huang Xianfan	Huang Xianfan
1956	1956
1941	1941
1945	1945
1958	1958
1926	1926
1947	1947
1944	1944
1952	1952
Bill Gates	Bill Gates
Encyclopedia	Enciclopédia
DVD	DVD
Bogga Hore	Wikipédia:Página principal
CPU	Unidade central de processamento
1959	1959
Template:Maqaal Cusub	Predefinição:Artigo bom
Dhesibel	Decibel
Kubadda Koleyga	Basquetebol
Kab town	Cidade do Cabo
Bada Qaswiin	Mar Cáspio
Harta Fiktooriya	Lago Vitória
Harada malaawi	Lago Niassa
Salvador Dalí	Salvador Dalí
Finsent van Gogh	Vincent van Gogh
Hokusai	Katsushika Hokusai
Mishelangelo	Michelangelo
Bablo bekaso	Pablo Picasso
Rembrandt van Rijn	Rembrandt
Eminem	Eminem
Bas	Ônibus
Baabiyloon	Babilônia (cidade)
Katalooniya	Catalunha
Samarqanda	Samarcanda
Bukhaara	Bucara
Mekka	Meca
Che Guvara	Che Guevara
Mao Zedong	Mao Tsé-Tung
Kabul	Cabul
Luqada Tamil-ka	Língua tâmil
Filasoofiyada	Filosofia
50 Cent	50 Cent
Dr. Dre	Dr. Dre
Snoop Dogg	Snoop Dogg
Shaax	Chá
Tupac Shakur	Tupac Shakur
1507	1507
Shuuciyad	Comunismo
Amadeyo afogadro	Constante de Avogadro
Liberalinimo	Liberalismo
Wadan	País
Qaran	Nação
Jow Bayden	Joe Biden
Hillary Clinton	Hillary Clinton
Dabaal	Natação
Category:Xiddigis	Categoria:Astronomia
1542	1542
1543	1543
Jaan Jaak Rosoo	Jean-Jacques Rousseau
Saxaara	Deserto do Saara
Hambeegar	Hambúrguer
Shaydaanka	Diabo
1606	1606
Maktabad	Biblioteca
FC Barcelona	Futbol Club Barcelona
Midowga afrika	União Africana
Siyaasadda,	Política
Jaamacada Carabta	Liga Árabe
Dimoqraadi	Democracia
Hay'ada laanqayrta cas	Movimento Internacional da Cruz Vermelha e do Crescente Vermelho
Gaashaanbuurta NATO	Organização do Tratado do Atlântico Norte
Qin Shi Huang	Qin Shihuang
Bariga Dhexe	Médio Oriente
Jamhuriyadda	República
Hantiwadaag	Socialismo
Dowlad	Estado
Xisbi	Partido político
Kilimanjaaro	Kilimanjaro
Kristoffer Kolombus	Cristóvão Colombo
Rixlaat Ibn Batuuta	Ibn Battuta
Kanaalka Banama	Canal do Panamá
Dheg	Orelha
San	Nariz
Muruq	Músculo
Hees	Canção
Kaneeco	Culicidae
Libaax Badeed	Tubarão
Geel	Camelo
Naasley	Mamíferos
Maroodi	Elefante
Quraansho	Formiga
Shini	Anthophila
Software	Software
Af-Holandees	Língua neerlandesa
DNA	Ácido desoxirribonucleico
Nuucyada dhirta	Espécie
Hooyo	Mãe
Aabe	Pai
Gaadiidka Dadweynaha	Transporte
Debian	Debian
1669	1669
1670	1670
1671	1671
1672	1672
1673	1673
1674	1674
1675	1675
1676	1676
1677	1677
1678	1678
1679	1679
1680	1680
1856	1856
Af-Ruush	Língua russa
Faladimir Putin	Vladimir Putin
Dastuur	Constituição
Dalalka Kommonwels	Commonwealth
OPEC	Organização dos Países Exportadores de Petróleo
Rooti	Pão
UNESCO	Organização das Nações Unidas para a Educação, a Ciência e a Cultura
Baaqa Caalamiga ee Xuquuqda Aadanaha	Declaração Universal dos Direitos Humanos
1796	1796
1797	1797
1899	1889
Sawaaxili	Língua suaíli
1893	1893
Unug	Célula
Dhiig	Sangue
Qolfoof	Esqueleto
Sambab	Pulmão humano
Hab Neefsi	Sistema respiratório
Habdhiska Taranka	Aparelho reprodutor
Af-Romani	Língua romena
Roob	Chuva
Dhulgariir	Sismo
Ibn Siinaa	Avicena
Nelson Mandela	Nelson Mandela
Martin Luther King,	Martin Luther King Jr.
Ensiim	Enzima
Borotiin	Proteína
Daad	Inundação
Tsunami	Tsunami
Fulkaano	Vulcão
Caad	Nuvem
Tirignoometeri	Trigonometria
Joomitiri	Geometria
Qarnigii 2aad	Século II
Qarnigii 1aad	Século I
Dhaqaale	Economia
Warshad	Indústria
Farta laatiinka	Alfabeto latino
Suugaan	Literatura
Category:Faransiiska	Categoria:França
Category:Muusig	Categoria:Música
Kun Habeen Iyo Habeen	As Mil e Uma Noites
Category:Suugaanta	Categoria:Literatura
Category:Gabayada	Categoria:Poesia
Waxbarasho	Educação
Qoys	Família
Hugo Chavez	Hugo Chávez
Nin	Homem
Guur	Casamento
Midab Takoor	Racismo
Adoon	Escravidão
Dagaal Sokeeye	Guerra civil
Cumar	Omar
Suldaan Suleymaan kan 1aad	Solimão, o Magnífico
Bun	Café
Caano	Leite
Buur	Montanha
Salaaxudiin al-Ayyuubi	Saladino
Karaaji	Carachi
Riyaal Madrid	Real Madrid Club de Fútbol
Dagaalkii qaboobaa	Guerra Fria
Seoul	Seul
Tomas Edison	Thomas Edison
Michael Faraday	Michael Faraday
Internet protocol	Protocolo de Internet
HTML	HTML
Af-Iswiidhan	Língua sueca
Muxamed bin Muuse al-Khwarizmī	Al-Khwarizmi
Karl Marx	Karl Marx
Nabi Muuse C.S.	Moisés
Aqoon	Conhecimento
Naas	Mama
Atom	Átomo
Ileys	Luz
Af Giriig	Língua grega
Operating system	Sistema operativo
Naf	Alma
Af-Faarsi	Língua persa
Diin	Religião
Nabi Ibraahiim C.S.	Abraão
Saladh	Salada
Yuhuuda	Judaísmo
Af-Hebrow	Língua hebraica
Ibn Khalduun	Ibn Khaldun
Beer (xubin)	Fígado
Bakeyle	Coelho
Cilminafsi	Psicologia
Badweyn	Oceano
Gootama buuda	Sidarta Gautama
Muxamed	Maomé
BBC	British Broadcasting Corporation
Shahrukh Khan	Shahrukh Khan
Al-Ghazaali	Al-Ghazali
Gerald Ford	Gerald Ford
Shiica	Xiismo
Suufi	Sufismo
Carab	Língua
Chelsea FC	Chelsea Football Club
Arsenal F.C.	Arsenal Football Club
Ganac	Pâncreas
Qolfoofta Dadka	Esqueleto humano
Qoor	Pescoço
Af	Boca
Sakaar	Peito
Elizabeth II	Isabel II do Reino Unido
Caajiska	Fadiga
Schiphol	Aeroporto de Amsterdão Schiphol
Haarlem	Haarlem
Ronald Reagan	Ronald Reagan
Af-Zulu	Língua zulu
Foosto	Barril
Sabool	Pobreza
Gordon Brown	Gordon Brown
Jadwalka Curiyayaasha	Tabela periódica
Robert Mugabe	Robert Mugabe
Xamaam(Shinbir)	Columbidae
Bakteeri	Bactéria
Geed	Árvore
Canab	Uva
Malab	Mel
Hilib	Carne
Barandho	Batata
Sonkor	Açúcar
Khudaar	Hortaliça
Robot	Robô
Makiinad	Máquina
Saxaafad	Jornalismo
Taleefoon	Telefone
Dhaqan	Cultura
RNA	Ácido ribonucleico
Xidigisyahan	Astrônomo
Habdhiska Wareega Dhiiga	Sistema circulatório
Mindhicirka weyn	Intestino grosso
Mindhicirka yar	Intestino delgado
Ibn Haytham	Alhazen
Isku dhis	Composto químico
Sharci dajinta	Poder Legislativo
Windows 7	Windows 7
Boqolleey	Porcentagem
Windows Vista	Windows Vista
Fidel Castaro	Fidel Castro
Category:Barasiil	Categoria:Brasil
Tamar	Energia
Abala-abalayn bayoloji	Classificação científica
Awood	Força
Cufisjiidad	Gravidade
Cuf	Massa
Bir	Metal
Hawo	Gás
Dareere	Líquido
Adke	Sólido
Bushkuleeti	Bicicleta
Markab	Navio
Beeraha	Agricultura
Cudbi	Algodão
Tiknolajiga nano	Nanotecnologia
Xaansho	Papel
Bac	Plástico
Bed	Área
Lambar	Número
Kiilogaraam	Quilograma
Cristiano Ronaldo	Cristiano Ronaldo
Mitir	Metro
Ilbiriqsi	Segundo
Galley	Milho
Kelvinka	Kelvin
Dalalka	Lista de Estados soberanos
Ludwik Lejzer Zamenhof	Ludwik Lejzer Zamenhof
Mesobotaamiya	Mesopotâmia
Buti	Ursidae
Britney Spears	Britney Spears
Habdhiska Dheefshiidka	Digestão
Habka Samayska Cuntada	Fotossíntese
Kansar	Cancro
Boqortooyo	Rei
Qamadi	Trigo
Kalandar	Calendário
Dhagool	Surdez
Cudur	Doença
Niikotiin	Nicotina
Malaariyo	Malária
Cunto xumida	Má-nutrição
Benseliin	Penicilina
Nantes	Nantes
AIDS	Síndrome da imunodeficiência adquirida
Sokorow	Diabetes mellitus
Template:Location map Yemen	Predefinição:Mapa de localização/Iémen
Mona Lisa	Mona Lisa
Horgale (Fiisikis)	Sistema Internacional de Unidades
Burj Khalifa	Burj Khalifa
Gidaarka Shiinaha	Muralha da China
Abyoone	Número inteiro
Kubad	Esfera
Dawladii Cabaasiyiinta	Califado Abássida
Dawlada Cosmaniya	Império Otomano
Koronto	Eletricidade
Seef	Espada
Pawlo Kuwelho	Paulo Coelho
Stephan El Shaarawy	Stephan El Shaarawy
Liin	Citrus × sinensis
Af-Soomaali	Língua somali
Aljaziira	Al Jazira
Carabi	Língua árabe
Xorta ah	Conteúdo livre
Baar	Palmeira
Ra'iisul wasaare	Primeiro-ministro
Araga	Óptica
Calan	Bandeira
Qalin Qori	Lápis
Saabaan	Mobiliário
Template:Location map Sudan	Predefinição:Mapa de localização/Sudão
Template:Location map Eritrea	Predefinição:Mapa de localização/Eritreia
Template:Location map Ethiopia	Predefinição:Mapa de localização/Etiópia
Template:Location map Djibouti	Predefinição:Mapa de localização/Djibouti
Template:Location map Somalia	Predefinição:Mapa de localização/Somália
Template:Location map Nigeria	Predefinição:Mapa de localização/Nigéria
Template:Location map Uganda	Predefinição:Mapa de localização/Uganda
Geri	Girafa
Faruur	Lábio
Shaarbo	Bigode
Midowga Sofiyet	União Soviética
Qolofta kore ee Dhulka	Crosta
Lil Wayne	Lil Wayne
FC Bayern München	Fußball-Club Bayern München
Queen	Queen
Kanye West	Kanye West
Huguri	Garganta
Wikipedia:Maqaallo Xul Ah	Wikipédia:Artigos destacados
Template:Link FA	Predefinição:Link FA
Aduunka	Mundo
Wikipedia:Goob	Wikipédia:Esplanada
Nanjing	Nanquim
Mayotte	Mayotte
Goobo	Círculo
Cesc Fàbregas	Cesc Fàbregas
Mobile	Telefone celular
Goronyo	Avestruz
Kuuriya	Coreia
Manchester	Manchester
1000	1000
999	999
Yeey	Lobo
1955	1955
1954	1954
1953	1953
1951	1951
1950	1950
1946	1946
1943	1943
1942	1942
1940	1940
1939	1939
1938	1938
1937	1937
1936	1936
Manchester United FC	Manchester United Football Club
1935	1935
1934	1934
Axdiga Cusub	Novo Testamento
Qafqaas	Cáucaso
Sagaal	Nove
Dabaqaroof	Escorpião
Koobka Adduunka	Copa do Mundo FIFA
Boolo	Pelicano
Macdin Alkaliini ah	Metal alcalino
Macdin dhuleed ah	Metal alcalinoterroso
Rafael Correa	Rafael Correa
Transitional Metal	Metal de transição
Bir la Mood	Semimetal
Bir Ma Ahe	Não metal
Guruubka 17	Halogênio
Neefta Gobta	Gás nobre
5	5
4	4
3	3
Boqorad	Rainha
2	2
Buqarest	Bucareste
Louvre	Museu do Louvre
Motorhead	Motörhead
Dameer	Equus africanus asinus
Wikipedia:Maqaal Cusub	Wikipédia:Artigos bons
6	6
Axdigii Hore	Antigo Testamento
Saddax-xagal	Triângulo
Lady Gaga	Lady Gaga
Luqada Hindo Yurub	Línguas indo-europeias
Breinigerberg	Breinigerberg
Muammar Qadaafi	Muammar al-Gaddafi
Shabeel	Tigre
Francesco Totti	Francesco Totti
PSY	Psy (cantor)
Nissan	Nissan
Booyad	Caminhão-tanque
Walhade	Pêndulo
Samsung	Samsung
Skandinafiyen	Escandinávia
Aruba	Aruba
Smartphone	Smartphone
Shidaal	Petróleo
Isuduwe Habka Juqraafiga	Coordenadas geográficas
Banki	Banco
1	1
10	10
20	20
30	30
Abkhazia	Abecásia
40	40
9	9
7	7
8	8
Todoba	Sete
Sideed	Oito
Todobaad	Semana
Deero	Cervidae
Baraf	Gelo
Toon	Alho
Musée d'Orsay	Museu de Orsay
Anthroboloji	Antropologia
Badacas	Mar Vermelho
13	13
Koonfur Ossetia	Ossétia do Sul
Ulan Bator	Ulan Bator
51	51
Jasiirad	Ilha
Cad	Branco
Madaw	Preto
37	37
900	900
Lordi	Lordi
Basal	Cebola
Lix	Seis
700	700
Yaanyo	Tomate
George H. W. Bush	George H. W. Bush
68	68
89	89
11	11
Quang Binh	Quang Binh
Entrena	Entrena
Dhulbare	Linha do equador
NASA	NASA
Benito Mussolini	Benito Mussolini
15	15
14	14
17	17
500	500
150	150
Qaamuus	Dicionário
Bermuda	Bermudas
Madax	Cabeça
Wellington	Wellington
23	23
800	800
Heesta qaranka	Hino nacional
42	42
Afarta jiho	Ponto cardeal
18	18
Nuurad	Calcário
19	19
16	16
21	21
26	26
41	41
32	32
33	33
Falastiin	Palestina
Valletta	Valeta
200	200
38	38
43	43
39	39
24	24
79	79
61	61
104	104
29	29
102	102
100	100
Haramcad	Acinonyx jubatus
Afarta xilli	Estação do ano
101	101
105	105
108	108
Dhuxul Dhagax	Carvão mineral
22	22
46	46
25	25
153	153
156	156
31	31
28	28
Liverpool	Liverpool
85	85
88	88
76	76
54	54
60	60
47	47
Guumees	Strigiformes
Nederlaan Antiilis	Antilhas Neerlandesas
Bahda Bisada	Felidae
Ambeer	Ampere
Isotope	Isótopo
Göteborg	Gotemburgo
Culeys	Peso
Geed Timir	Tamareira
Burris	Martelo
Racibórz	Racibórz
Odense	Odense
Kobe Bryant	Kobe Bryant
Luqadaha Berberiga	Línguas berberes
600	600
400	400
300	300
Tilburg	Tilburgo
Dayax gacmeed	Satélite artificial
Taylor Swift	Taylor Swift
Khaalid bin Waliid	Khalid ibn al-Walid
Bariga Afrika	África Oriental
Fiat	FIAT
Bartamaha Ameerika	América Central
Af-Cafari	Língua afar
Magrib	Magrebe
Amxaari	Língua amárica
36)	36
Tin	Pelo
Wareeg	Perímetro
Dhicis	Aborto espontâneo
Dhar	Tecido têxtil
Kacdoonka masar	Revolução Egípcia de 2011
Willis Tower	Willis Tower
Kacbada	Caaba
Beatriks	Beatriz dos Países Baixos
Isuzu	Isuzu
Dublad	Funil
159	159
107	107
103	103
152	152
240	240
197	197
70	70
Duqa	Prefeito
81	81
69	69
87	87
65	65
66	66
67	67
55	55
34	34
44	44
35	35
64	64
151	151
155	155
50	50
260	260
45	45
49	49
230	230
Zhengzhou	Zhengzhou
154	154
52	52
82	82
84	84
73	73
72	72
62	62
71	71
75	75
74	74
83	83
78	78
77	77
90	90
80	80
91	91
190	190
109	109
53	53
270	270
Madaxweyne	Presidente
63	63
86	86
401	401
99	99
98	98
110	110
137	137
138	138
140	140
130	130
210	210
220	220
Dell	Dell
180	180
158	158
157	157
106)	106
48	48
97	97
Yuumbi	Marlim
56	56
93	93
Alofi	Alofi
57	57
Jamestown	Jamestown (Santa Helena)
170	170
171	171
172	172
58	58
59	59
139	139
134	134
135	135
96)	96
92	92
133	133
176	176
131	131
Jasiirad Dhuleedka Carabta	Arábia
250	250
280	280
290	290
Mindi	Faca
Masaajid	Mesquita
Akon	Akon
Dumnad	Dominó
174	174
International Standard Book Number	International Standard Book Number
132	132
178	178
Luqadaha Tashaadiga	Línguas tchádicas
Drake	Drake (artista)
Luqadaha Kushiitiga	Línguas cuchíticas
Afguri	Dialeto
95	95
94	94
257	257
Biriq	Raio (meteorologia)
Gacan	Mão
Af-Oromo	Língua oromo
Caleen	Folha
Jilaa	Ator
Niue	Niue
Luqadaha Semitiga	Línguas semíticas
Justin Bieber	Justin Bieber
Xusni Mubaarak	Hosni Mubarak
Af-Tigrinya	Língua tigrínia
Af-Tigre	Língua tigré
Dhululubo	Cilindro
Subag	Manteiga
Yaasir Carafaat	Yasser Arafat
Fara-ka hadal	Língua de sinais
136	136
Injiil	Evangelho
Alexander Graham Bell	Alexander Graham Bell
Tasmaniya	Tasmânia
Rotterdam	Roterdão
Saabuun	Sabonete
Cabdillahi ibn Cabdi al Mudalib	Abdalá ibn Abd al-Mutalib
Mošovce	Mošovce
Zeyd Binu Xaaritha	Zayd ibn Harithah
Shakira	Shakira
Jaamacadda Oxford	Universidade de Oxford
Maxamuud Axmadinajaad	Mahmoud Ahmadinejad
CD	Compact Disc
Al-Qaacida	Al-Qaeda
Maxamed Al-faatex	Maomé II, o Conquistador
Jeer	Hipopótamo-comum
Far	Dedo
Furaat	Rio Eufrates
Gacanka Faarsiga	Golfo Pérsico
Cilmiga bulshada	Ciências sociais
Somaliland	Somalilândia
Ciida sanadka cusub	Ano-Novo
Babaay	Mamão
Brisbane	Brisbane
Fiitamiin	Vitamina
Towraad	Torá
Koonfur Joorjiya iyo Koonfurta Jasiiradaha Sanwij	Ilhas Geórgia do Sul e Sandwich do Sul
Noemi	Noemi (cantora)
Website	Site
Ido	Língua ido
Sumeer	Suméria
Kolonbo	Colombo
Dariishad	Janela
Medina	Medina
Akkadiyaan	Língua acádia
Booliis	Polícia
UEFA	União das Federações Europeias de Futebol
Tigris	Rio Tigre
Koonfur Australia (gobol)	Austrália Meridional
Baarlamaan	Parlamento
Maatar	Matéria
Jaamacadda Cambridge	Universidade de Cambridge
Fulinta (Dawlad)	Poder Executivo
Hurdo	Sono
Neefta	Asma
Doon	Barco
Queensland	Queensland
Mohammed ali Clay,	Muhammad Ali
Beyoncé Knowles	Beyoncé Knowles
Urur	Conjunto
Siligo	Siligo
Riyo	Sonho
Bur	Farinha
Dhigaha	Longitude
Kimikal dibusocod	Reação química
Den Haag	Haia
Goriila	Gorila
Daylight saving time	Horário de verão
Daanta galbeed	Cisjordânia
Maraykanka assalkoodii	Povos ameríndios
Siinaa	Sinai
Albaab	Porta
Rihanna	Rihanna
Hargab Doofaar	Gripe suína
Cinjo	Unha
Ugaadhsi	Caça
Toshiro Mifune	Toshiro Mifune
Waji	Face
Aleksander Fileming	Alexander Fleming
Musmaar	Prego
Nabi Suleymaan C.S.	Salomão
Yahoo	Yahoo!
AK-47	AK-47
Mowjad	Onda
Dhexroor	Diâmetro
Bare	Professor
Internet Movie Database	Internet Movie Database
Dalai Lama	Dalai Lama
Jilib (xubin)	Joelho
ISO 4217	ISO 4217
Tomas hobis	Thomas Hobbes
Campora San Giovanni	Campora San Giovanni
Jirjiroole	Camaleão
Cusmaan bin Cafaan	Otman
Jaandi	Liga metálica
Nafto	Diesel
Qare	Melancia
Toban iyo shan	Quinze
Rikter Cabir	Escala de Richter
Xamaas	Hamas
Ruhollah Khomeini	Ruhollah Khomeini
Rajab Dayib Erdogaan	Recep Tayyip Erdoğan
Mug	Volume
Jamaal Cabdinaasir	Gamal Abdel Nasser
Bluetooth	Bluetooth
Cali	Ali
Marinka Gaza	Faixa de Gaza
Radio Studio 54 Network	Rádio Studio 54 Network
Cabitaan	Bebida
Qoori	Praia
Qabaal	Elipse
Hobart	Hobart
Dayax Gacmeed	Nave espacial
Doorashada	Eleição
Iskudhufasho	Multiplicação
Saxaraha Galbeed	República Árabe Saaraui Democrática
.et	.et
Geeska Afrika	Corno de África
Lisa Gerrard	Lisa Gerrard
Nabi Yaxye C.S.	João Batista
Jennifer Lopez	Jennifer Lopez
Faraq	Subtração
Breda (Netherlands)	Breda
Shuban	Diarreia
Nancy	Nancy
Honiara	Honiara
PH	PH
Asiyriya	Assíria
Qardhaas	Losango
Xayla Siilaasi	Haile Selassie
Xalab	Alepo
Big Ben	Big Ben
Dhererka Mowjadda	Comprimento de onda
Nabi Daa'uud C.S.	David
Borussia Dortmund	Ballspiel-Verein Borussia 1909 e. V. Dortmund
Xidido	Raiz
Mole	Mol
Frank Lampard	Frank Lampard
Qallal	Epilepsia
Baqal	Mula
Garaam	Grama
Shahaadah	Chahada
Gacanka Cadmeed	Golfo de Áden
Beeraha laalaada	Jardins Suspensos da Babilónia
Maas	Rio Mosa
Khadiija binti Khuweylad	Cadija
Waraabe	Hiena
Sariir	Cama
Madaxwayne kuxigeen	Vice-presidente
Cilmibaadhis	Pesquisa
Faaranhaayt	Grau Fahrenheit
Dhuldaaqsiin	Savana
Dhogor	Lã
Toobin	Cone
Daliban	Taliban
MP3	MP3
Ismaamulka Falastiin	Autoridade Nacional Palestiniana
.ke	.ke
Fernando Torres	Fernando Torres
Gar	Barba
Nabi	Profeta
Derbi	Muro
SMS	Serviço de mensagens curtas
Yaxaas	Crocodilo
Majladda Time	Time (revista)
Dhedig	Fêmea
Farabadne	Quilópode
Amedeo Avogadro	Amedeo Avogadro
Shambay	Gato-bravo
Federaalka	Federação
Sedex Geesoodka Bermuda	Triângulo das Bermudas
Arjen Robben	Arjen Robben
Xamid Karzai	Hamid Karzai
Lab	Macho
Rey mysterio	Rey Mysterio
Dayax madoobaad	Eclipse lunar
Taxane	Matriz (matemática)
Kayene	Caiena
John Cena	John Cena
Waran	Lança
Dadqalato	Antropofagia
Busbus	Varicela
Provinces of Argentina	Províncias da Argentina
Dekad	Porto (transporte)
Garoonka Diyaaradaha ee Bole	Aeroporto Internacional Bole
Dadka Berberiga	Berberes
Afganbi	Golpe de Estado
Burcad Badeed	Pirata
RSS	RSS
Lacagta Meherka	Dote
Barbaroole	Paralelogramo
Leeb	Flecha
Chris Paul	Chris Paul
Awood Socota	Energia cinética
Koor	Trapézio (geometria)
Qaanso	Arco (arma)
Amiibada	Amoeba
Zlatan Ibrahimović	Zlatan Ibrahimović
GSM	GSM
Dhaban	Bochecha
Saint-Denis	Saint-Denis (Reunião)
Arsène Wenger	Arsène Wenger
Baabiylooniya	Babilônia (região)
Muslim	Muçulmano
Warqadda aqoonsiga	Documento de identidade
Template:Commonscat	Predefinição:Commonscat
Qoorgooye	Meningite
399	399
Iidi Amiin Daada	Idi Amin
Kayseri	Kayseri
CNN	CNN
Drogbaa	Didier Drogba
Dhakhaatiirta Bilaaxuduudaa	Médicos sem Fronteiras
Manchester city	Manchester City Football Club
Ilaahay	Troms
John Dramani Mahama	John Dramani Mahama
Luqada Masaarida	Língua egípcia
Anatooliya	Anatólia
Nabi Ciise	Isa (profeta)
Cudurka Ebola	Doença por vírus Ébola
Template:Taxobox	Predefinição:Info/Taxonomia
Carly Rae Jepsen	Carly Rae Jepsen
Toyota	Toyota Motor
Osmose	Osmose
Af-Hawsa	Língua haúça
Saxan	Prato
Mwai Kibaki	Mwai Kibaki
Jalaal Daalabaani	Jalal Talabani
Ismaaciil Cumar Geelle	Ismaïl Omar Guelleh
Nuur Al-Maliki	Nouri al-Maliki
Dileita Maxamed Dileita	Dileita Mohamed Dileita
Mark Rutte	Mark Rutte
Cumar Cabdirashiid Cali Sharmaarke	Omar Abdirashid Ali Sharmarke
Axmed Dafutoglu	Ahmet Davutoğlu
Robinho	Robinho
Bada Carbeed	Mar Arábico
Dhircun	Herbívoro
Calanka Denmark	Bandeira da Dinamarca
Jay-Z	Jay-Z
Yuusuf Alqardaawi	Yusuf Al-Qaradawi
Sahel	Sahel
Henry Kissinger	Henry Kissinger
Flums	Flums
Diego Milito	Diego Milito
Shumac	Vela
Wikipedia:Sharaxaada Maqaalada Xulka Ah	Wikipédia:Escolha do artigo em destaque
Dhalo	Garrafa
Raqay	Tamarindus
Shabeelada Tamil	Tigres de Liberação do Tamil Eelam
Qaangaadh	Adulto
Enjerneer	Engenheiro
Gacanka Caqaba	Golfo de Aqaba
KwaZulu-Natal Province	KwaZulu-Natal
Hilibcun	Carnívoro
AFC Ajax	AFC Ajax
Qaado	Colher
VOIP	Voz sobre IP
Jibriil	Gabriel (anjo)
Astaamayn	Pontuação
Taksi	Táxi
Soqotra	Socotorá
Timor	Timor
Almere	Almere
Xoor-dubbur	Mephitidae
Dooli	Mus musculus
Suul	Polegar
Mesut ozil	Mesut Özil
Turki	Turcos
Ukun	Ovo (alimento)
HyperText	Hipertexto
Xeeb	Costa
Ibb	Ibb
Lobamba	Lobamba
Walxaha	Período (química)
Magarete2	Margarida II da Dinamarca
Calanka jabuuti	Bandeira do Djibouti
Xareed	Água doce
Calanka Suudaan	Bandeira do Sudão
Daanyeer	Hominoidea
Sodium Hydroxide	Hidróxido de sódio
Xoolo	Gado
Cirid	Gengiva
Chalcogen	Calcogênio
Tufaax	Malus
Shakaal	Hipotenusa
Biniktojiin	Grupo do nitrogênio
Lambedusa	Lampedusa
Manuel Neuer	Manuel Neuer
Jalmad	Chaleira
Wiz Khalifa	Wiz Khalifa
Agool	Caspa
Maydhax	Xilema
Dhax kujir	Lista de países sem costa marítima
Andalus	Al-Andalus
Sako	Zakat
Dhadhan	Paladar
ICAO	Organização da Aviação Civil Internacional
.so	.so
Western Cape Province	Cabo Ocidental
Mario Balotelli	Mario Balotelli
Qiiq	Fumo
Eastern Cape Province	Cabo Oriental
Cerebellum	Cerebelo
Haaruun Alrashiid	Harun al-Rashid
Kaftan	Piada
Funaanad	Camiseta
IMMAGINE&POESIA	IMMAGINE&POESIA
Tangent	Tangente (geometria)
Niisaabuur	Nixapur
Khilaafada Islaamka	Califado
Cadan	Áden
Het Wilhelmus	Het Wilhelmus
Universidade Federal de Minas Gerais	Universidade Federal de Minas Gerais
Mpumalanga Province	Mpumalanga
Northern Cape Province	Cabo Setentrional
Mamawdsaw	Mamoudzou
Gauteng Province	Gauteng
Lug	Perna
Cagaarshow	Icterícia
Du gamla, Du fria	Du gamla, Du fria
Shaydaanimo	Satanismo
Limpopo Province	Limpopo (África do Sul)
LG	LG Group
Ogaden	Ogaden
Alexandre Pato	Alexandre Pato
Wabiga Jubba	Rio Juba
Qooleey	Pombo-correio
Wabiga Shabeelle	Rio Shebelle
Marsho	Engrenagem
Nabi Yuusuf	José (filho de Jacob)
One Direction	One Direction
Mille	Solvente
Herpesviruses	Herpesviridae
Degmo	Distrito
Tomahok (gantaal)	BGM-109 Tomahawk
Dambas	Cinzas
Eduard Douwes Dekker	Multatuli
Yuusuf Islaam	Cat Stevens
Kiyaawe	Chave (ferramenta)
Awood Kaydsan	Energia potencial
Chris Brown	Chris Brown (cantor)
Universidade Estadual de Feira de Santana	Universidade Estadual de Feira de Santana
Aadan Cabdulle Cusmaan	Aden Abdullah Osman Daar
Saylac	Zeila
Anopheles	Anopheles
Malawad	Reto
Universidade Federal da Bahia	Universidade Federal da Bahia
Centro Federal de Educação Tecnológica de Minas Gerais	Centro Federal de Educação Tecnológica de Minas Gerais
Calanka Soomaaliya	Bandeira da Somália
Dhuuso	Flatulência
Free State Province	Estado Livre
Maqal	Audição
Oorfane	Orfanato
Ubuc	Tronco (anatomia)
Meles Zenawi	Meles Zenawi
Nicki Minaj	Nicki Minaj
Wahaabi	Wahhabismo
Diffusion	Difusão molecular
DDT	DDT
Cadnaan Oktaar	Adnan Oktar
Ibrahim Affelay	Ibrahim Afellay
Angry Birds	Angry Birds
Daango	Pipoca
Qalin	Caneta
Aadaan	Adhan
Usher	Usher
Hummaag noqod	Reflexão (física)
North West Province	Noroeste (África do Sul)
Lelystad	Lelystad
Midabada Asaasiga	Cor primária
Isnidaamis	Sarna
Daaf	Conjuntivite
Abkow	Avós
CAF	Confederação Africana de Futebol
Hargeysa	Hargeisa
Nabiyada Islaamka	Profetas do islão
Xijaas	Hejaz
Filibs	Philips
Kaliber	Calibre
Geed Hindi	Neem
Jidh	Corpo
Qosol	Gargalhada
Nektar	Néctar
Mount kenya	Monte Quénia
Uunsi	Olíbano
Jomo Kenyatta	Jomo Kenyatta
Gacan (Joomitiri)	Raio (geometria)
Centimetre	Centímetro
Millimeter	Milímetro
Baadiye	Zona rural
Fasuul Cabdalla Maxamed	Fazul Abdullah Mohammed
Portal:Taariikh	Portal:História
Hunguriga neefta	Traqueia
Bowdo	Fêmur
Qaamo-qashiir	Parotidite infecciosa
Tiirarka Islaamka	Cinco pilares do Islamismo
Huulaaku Khan	Hulagu Khan
Wadan soo kobcooyo	País em desenvolvimento
Dhuxul	Carvão vegetal
Shansho	Tíbia
Saac (faah faahin)	Relógio de pulso
Alchemist(Buug)	O Alquimista
The Notorious B.I.G.	The Notorious B.I.G.
Sanab	Estátua
Saadiyom bicarbonate	Bicarbonato de sódio
Nabi Ayuub C.S.	Jó
Fatima bint Muxamed	Fátima (filha de Maomé)
Baras	Vitiligo
Sumad xisaabed	Tabela de símbolos matemáticos
Ricir	Vértebra
Qol	Quarto
Dhado	Humidade
Curiye	Elemento
Mucaawiye bin Abii Sufyaan	Muawiya I
Xasan Nasrallaah	Hassan Nasrallah
Mahathir Bin Maxamed	Mahathir bin Mohamad
Bidaar	Calvície
Aafda tahriibka	Tráfico de pessoas
KLM	KLM
Mitsubishi	Mitsubishi
Cashuura	Ashura
Tamaashiir	Giz
Memory card	Cartão de memória
Daxal	Ferrugem
Will.i.am	Will.i.am
Saxaro	Estrume
Gaamur	Alcatrão
UFC	Ultimate Fighting Championship
Pitbull	Pitbull (rapper)
Aayad	Ayat
Tariikhda Shiikh Axmed Yaasiin	Ahmed Yassin
Saxaabi	Sahaba
Gows	Molar (dente)
Shanbal	Prato (instrumento musical)
Harar	Harar
Dhismaha websiteka	Web design
Golcas	Gazela
Abuu Xaniifa	Abu Hanifa
Ammonium	Amónio
Session Initiation Protocol	Protocolo de Iniciação de Sessão
Salafiya	Salafismo
Berbera	Berbera
Botka internetka	Bot
Bergen op Zoom	Bergen op Zoom
Mengista Xayle Maryam	Mengistu Haile Mariam
Mowliidka Nebiga	Mawlid
Ciraaqi Diinaar	Dinar iraquiano
Adenoviridae	Adenoviridae
Daniel arap Moi	Daniel Toroitich arap Moi
Nabi Huud	Hud
Ne-Yo	Ne-Yo
Sin	Quadril
Rajab	Rajab
Axmed Binu Xambal	Ahmad ibn Hanbal
Sheybaar	Microscópio
Peso (Arjantiina)	Peso argentino
Yamanta Koonfureed	Iémen do Sul
Assur	Assur (Assíria)
Decimetre	Decímetro
Sean paul	Sean Paul
Yazidi (yasiidi)	Yazidi
Calanka somaliland	Bandeira da Somalilândia
Soomaali Galbeed	Região Somali
Astaannta Qaranka ee Soomaaliya	Brasão de armas da Somália
Astaannta Qaranka ee Imaaraatka	Brasão de armas dos Emirados Árabes Unidos
Velupillai Prabhakaran	Velupillai Prabhakaran
Biomolikule	Biomolécula
Nabi Alyasac C.S.	Eliseu
Birr	Birr etíope
Jaad	Khat
Dab Damis	Carro de bombeiro
SliTaz	SliTaz
Maxamed Siyaad Barre	Siad Barre
Ívi Adámou	Ivi Adamou
Cafar	Afares
Angalool	Concha
Flo Rida	Flo Rida
Eden Hazard	Eden Hazard
T.I.	T.I.
Budhcad badeeda geeska afrika	Pirataria na Somália
Ayaan Xirsi Cali	Ayaan Hirsi Ali
Cabdullaahi Yuusuf Axmed	Abdullahi Yusuf Ahmed
Ururka Dawladaha aan la aqoonsan Wali	Organização das Nações e Povos Não Representados
Qof	Pessoa (filosofia)
Addimo-yaqaan	Ortopedia
Dhul (dhulka lagu socdo)	Pavimento
Faysal Bin Cabdil Caziiz	Faisal da Arábia Saudita
Wadar	Somatório
Qormo saynis	Notação científica
C.H	BC
Adam Levine	Adam Levine
Al-Faatixa	Al-Fatiha
Al-Baqara	Al-Baqara
Hogaamiye Kooxeed	Chefe militar
T-pain	T-Pain
Anggun	Anggun
Carlos the Jackal	Ilich Ramírez Sánchez
Fatima	Fátima
Mombaaso	Mombaça (Quênia)
Alexa Internet	Alexa Internet
Sheekh Xasan Albanaa	Hassan al Banna
Daariq ibn Ziyaad	Tárique
Seed	Tendão
Al-Ikhlas	Al-Ikhlas
Suurad	Sura
Xadiis	Hadith
Sunna	Suna
Allaah	Alá
Salaad	Salá
Xaj	Hajj
Malag	Anjo
Astaannta Qaranka ee Kolombiya	Brasão de armas da Colômbia
Xisbiga shacabka iyo xoriyada Holalnd	Partido Popular para a Liberdade e Democracia
Qeshm	Qeshm
Bukhaari	Al-Bukhari
Dadka Soomaaliyeed	Somalis
Dagaalkii sokeeye ee Soomaaliya	Guerra Civil da Somália
Jason Derulo	Jason Derulo
Macrakadii Ceyn Jaaluut	Batalha de Ain Jalut
Iskugeyn	Plus
FIFA	Federação Internacional de Futebol
Uumi	Vapor
Iman model	Iman (modelo)
Amina bint Wahb	Amina bint Wahab
Laf	Osso
Wayne Rooney	Wayne Rooney
Al Hudaydah	Al Hudaydah
Sheekh Shariif Axmed	Sharif Ahmed
Kismaayo	Kismayo
Beydaan	Amendoeira-da-praia
R. Kelly	R. Kelly
Fool	Incisivo
Lacey Duvalle	Lacey Duvalle
Jaamacada Ummada Soomaaliyeed	Universidade Nacional da Somália
Saaxil	Saaxil
Dhul Udug	Punt
Bakool	Bakool
Nabi Yacquub C.S.	Jacó
Mariana Ximenes	Mariana Ximenes
Zubeyr bin Cawaam R.C	Zubair ibn al-Awwam
Demba Ba	Demba Ba
Xasan Guuleed Abtidoon	Hassan Gouled Aptidon
K'naan	K'naan
Greyson Chance	Greyson Chance
Cabdul-Qadir Jilani	Abdul-Qadir Gilani
Cabdi Bile Cabdi	Abdi Bile
Cabdiqaasim Salaad Xassan	Abdiqasim Salad Hassan
Cabdirashiid Cali Sharma'arke	Abdirashid Ali Shermarke
Al-Shabaab	Al-Shabaab
Booc	Calotropis
Al Mahwit	Al Mahwit
Al Mukalla	Al Mukalla
Sheekh Yaasir Al-Xabiib	Yasser Al-Habib
Cody Simpson	Cody Simpson
Cabdullaahi Ciise	Abdullahi Issa
Dagaalkii xoraynta ogaden	Guerra de Ogaden
Oromo	Oromas
Xasan Sheekh Maxamuud	Hassan Sheikh Mohamud
Rodolfo Graziani	Rodolfo Graziani
Maxamed Faarax Caydiid	Mohammed Farah Aidid
Biyo baxa deg dega ah	Ejaculação precoce
Dhulka Talyaaniga ee Soomaaliya	Somália Italiana
Saytuun	Psidium
Trey songz	Trey Songz
Macawiis	Sarongue
Compaq	Compaq
Nabi Saalax	Salé (profeta)
Unimog	Unimog
Lufthansa Duulimaadkii 181	Voo Lufthansa 181
Nabi Idriis	Idris
Tooreey	Lâmina (ferramenta de corte)
Boosaaso	Bosaso
Dowladda federaalka kumeelgaarka	Governo Transicional Federal
Abu Bakr	Abu Bakr
Abuu Sufyaan	Abu Sufyan ibn Harb
Timo Soini	Timo Soini
Cali maxamed Geedi	Ali Mohammed Ghedi
Marek Grechuta	Marek Grechuta
Jeddah	Jidá
Shukaansi	Cortejo sexual
Sacad bin Abii Waqaas	Sa`d ibn Abi Waqqas
Afgooye	Afgooye
Xulka Qaranka Soomaaliya	Seleção Somali de Futebol
Woqooyi bari	Nordeste (Quénia)
Masjid al-Aqsa	Mesquita de Al-Aqsa
Computer Engineering	Engenharia de computação
Masjid al-Xaram	Masjid al-Haram
Karl Wolf	Karl Wolf
Nuur Xasan Xuseen	Nur Hassan Hussein
Astaanta Calanka Soomaaliya	Soomaaliyeey toosoo
Pitty	Pitty
Ta'izz	Ta'izz
Murgacasho	Entorse
Calooleey	Tripa
Aamina	Amina (desambiguação)
Paramore	Paramore
Tuur	Cifose
Lafdhabar	Coluna vertebral
Luís Carlos Almeida da Cunha	Nani
Paris Saint-Germain FC	Paris Saint-Germain Football Club
Ahlu sunno waljamaaca	Sunismo
Puntland	Puntlândia
Qureysh	Coraixitas
Masjidka Nabiga	Al-Masjid an-Nabawi
Dagaalkii uxud	Batalha de Uhud
Sambuus	Chamuça
Imaam Mujtahid Sheykhul-Islaam	Ibn Taymiyyah
Fiat 124	Fiat 124
Galatasaray SK	Galatasaray Spor Kulübü
IGAD	Autoridade Intergovernamental para o Desenvolvimento
Astaanta Calanka Jabuuti	Djibouti (hino)
Baydhabo	Baidoa
G-Spot	Ponto G
Xiriirka Soomaaliyeed ee Kubadda Cagta	Federação Somali de Futebol
Salmaan Alfaarisi	Salman, o Persa
Haparanda	Haparanda
Xarardheere	Harardhere
Galinsoor	Galinsoor
Baraawe	Barawa
Aakhiro	Vida após a morte
Dhuusamareeb	Dusa Mareb
Karkaar	Karkaar
Maxamed Cusman Jawaari	Mohamed Osman Jawari
Jowhar	Jowhar
Shimbiris	Shimbiris
Marka	Merca
Biciid	Oryx
Eliana	Eliana (apresentadora)
Hiiraan	Hiiraan
Astaannta Qaranka ee somaliland	Brasão de armas da Somalilândia
Dhulka Biritishka ee Soomaaliya	Somalilândia Britânica
Wax soo saar	Produção (desambiguação)
Nabi Isxaaq C.S.	Isaac
Soomaaliweyn	Grande Somália
Shabeellaha Dhexe	Shabeellaha Dhexe
Hanti maguurto	Imóvel
Naaso hablood	Naasa-Hablood
Liiska dalalka dad ahaan	Lista de países por população
Jaamacada Banaadir	Universidade Benadir
Jaamacada Muqdisho	Universidade de Mogadíscio
Mr. Lordi	Tomi Petteri Putaansuu
Bari (Gobol)	Bari (Somália)
Adult Film Database	Adult Film Database
Cali Mahdi Maxamed	Ali Mahdi Muhammad
Midowga Maxkamadaha Islaamiga	Conselho Supremo das Cortes Islâmicas
Taleefoonada fiilada	Telefone fixo
UNICEF	Fundo das Nações Unidas para a Infância
Behra	Dorcatragus megalotis
Abuu Cubeydah Caamir ibn Jaraax	Abu Ubaidah ibn al Jarrah
Sanaag	Sanaag
Jigjiga	Djidjiga
Centro Federal de Educação Tecnológica Celso Suckow da Fonseca	Centro Federal de Educação Tecnológica Celso Suckow da Fonseca
Garoonka Diyaaradaha ee Da Nang	Aeroporto Internacional de Da Nang
Nansi Ajram	Nancy Ajram
Nashiido	Nasheed
Azania	Azânia
Awdal	Awdal
Baardheere	Bardera
Badhan	Badhan
Baki	Baki (Somália)
Banaadir	Banaadir
Bari	Bari (desambiguação)
Baay	Bay (Somália)
Sedjibeke	Cubo
Beledweyne	Beledweyne
Garoowe	Garoowe
Derg	Derg
Kilometer	Quilômetro
Soor	Farinha de milho
Dhuun	Faringite estreptocócica
Web feed	Feed
YouPorn	YouPorn
Liiska magaalooyinka adduunka dad ahaan	Lista das cidades mais populosas do mundo
Guraag	Gurage
Hectometre	Hectômetro
Eurobeat	Eurobeat
Decametre	Decâmetro
Sool	Sool (Somália)
York University	Universidade Iorque
Gedo	Gedo
Mareexaan	Marehan
Gaalkacyo	Gaalkacyo
Guddi	Comitê
Togdheer	Togdheer
Goobogali	Múltipla escolha
Galguduud	Galguduud
Woqooyi Galbeed	Woqooyi Galbeed
Shabeellaha Hoose	Shabeellaha Hoose
Mudug	Mudug
Jubbada Hoose	Jubbada Hoose
Boorama	Borama
Wikipedia:Caawinaad	Ajuda:Página principal
Wikipedia:Tutorial	Ajuda:Tutorial
Miraha Mucjisada	Fruta-milagrosa
Pontifícia Universidade Católica de Minas Gerais	Pontifícia Universidade Católica de Minas Gerais
Galmudug	Galmudug
Canjeelo	Injera
Pornhub	Pornhub
Dawladii Mamaaliikta	Mamelucos
Poxviruses	Poxviridae
Burco	Burao
Ajdjadajd	Jubalândia
Mandheera	Mandera (Quénia)
Cadaad	Acacia senegal
Qabaa'ilka Soomaaliya	Demografia da Somália
Sheekh Aways	Hassan Dahir Aweys
Bu’aale	Bu'aale
Gabiley	Gabiley
Warshiikh	Warsheekh
Hobyo	Hobyo
Jamaame	Jamaame
Xudur	Xuddur
Doolow	Doolow
Garbahaarey	Garbahaarey
Ceerigaabo	Erigavo
Xaafuun	Hafun
Laascaanood	Las Anod
Eyl	Eyl
Saxiixul Bukhaari	Sahih al-Bukhari
Calool	Estômago
Jubbada Dhexe	Jubbada Dhexe
Nugaal	Nugaal
Internet Adult Film Database	Internet Adult Film Database
Ceres	Ceres
Lambar Tubaxan	Sistema de numeração ternário
Dagaalkii (2006–2009)	Guerra na Somália (2006-2009)
Ciidamada Qalabka Sida ee Masaarida	Forças Armadas do Egito
Milme	Soluto
Garoonka Diyaaradaha ee Aadan Cadde	Aeroporto Internacional Aden Adde
Liverpool FC	Liverpool Football Club
Xariiqanta Cagaaran	Linha Verde (Israel)
Duurjoog	Humbug
Xtube	Xtube
Tusbax	Masbaha
Raas Caseyr	Cabo Guardafui
GCompris	GCompris
Siyaasadda Soomaaliya	Política da Somália
Saynab bint Muxamed	Zainab (filha de Maomé)
Wabiga Daawa	Rio Dawa
Wikipedia:Safaarad	Wikipédia:Embaixada
Naafto	Diesel (desambiguação)
U qeybin	Divisão
Samuel Eto'o	Samuel Eto'o
RedTube	RedTube
Shabiixa	Shabiha
Maakhir	Maakhir
Ra'iisul wasaarayaashii Soomaaliya	Lista de primeiros-ministros da Somália
Qurac	Acacia tortilis
Agnes Monica	Agnes Monica
Pornopedia	Pornopedia
Xuseen Maxamed Faarax Caydiid	Hussein Farrah Aidid
Maxamed Cabdi Yuusuf	Muhammad Abdi Yusuf
Category:Jarmal	Categoria:Alemanha
Category:Talyaaniga	Categoria:Itália
Category:Qaramada Midoobey ee Maraykanka	Categoria:Estados Unidos
Category:Ruushka	Categoria:Rússia
Category:Midowga boqortooyada Britan	Categoria:Reino Unido
Category:Isbania	Categoria:Espanha
Category:Shiinaha	Categoria:China
Category:Hindiya	Categoria:Índia
Category:Sucuudiga	Categoria:Arábia Saudita
Category:Turki	Categoria:Turquia
Category:Koonfur Afrika	Categoria:África do Sul
Category:Masar	Categoria:Egito
Category:Iiraan	Categoria:Irão
Category:Arjantiina	Categoria:Argentina
Category:Afqaanistan	Categoria:Afeganistão
Category:Austriya	Categoria:Áustria
Category:Itoobiya	Categoria:Etiópia
Category:Ciraaq	Categoria:Iraque
Category:Nederland	Categoria:Países Baixos
Category:Bakistaan	Categoria:Paquistão
Category:Boland	Categoria:Polónia
Category:Bortuqaal	Categoria:Portugal
Category:Suudaan	Categoria:Sudão
Category:Iswisarland	Categoria:Suíça
Category:Fiyetnam	Categoria:Vietname
Category:Shimbir	Categoria:Aves
Category:Fiisikis	Categoria:Física
Category:Bayoloji	Categoria:Biologia
Category:Kimisteri	Categoria:Química
Category:Taariikh	Categoria:História
Category:Juqraafi	Categoria:Geografia
Category:Diin	Categoria:Religião
Category:Ciyaaraha	Categoria:Desportos
Category:Saynis	Categoria:Ciência
Category:Filimaanta	Categoria:Cinema
Category:Isgaadhsiin	Categoria:Comunicação
Jamhuuriyadda Dimuqraadiga Soomaaliya	República Democrática da Somália
Dhaqaallaha Soomaaliya	Economia da Somália
Hawiye	Hawiye
Qardho	Qardho
Ciidamada Midowga Afrika	Missão da União Africana para a Somália
International Rescue Committee	Comitê Internacional de Resgate
Template:Box-footer	Predefinição:Box-footer
Waqtiga Bariga Afrika	Horário da África Oriental
Cabdiweli Maxamed Cali	Abdiweli Mohamed Ali
Nabi Nuux C.S.	Nuh
SNM	Movimento Nacional Somali
Laas Geel	Laas Gaal
Isaaq	Isaaq
Aragtida doobnimada	Questões sociais
Muxaram	Muharram
Category:Filasoofiyada	Categoria:Filosofia
Category:Cilminafsi	Categoria:Psicologia
Category:Masiixiyad	Categoria:Cristianismo
Category:Islaam	Categoria:Islamismo
Doorashadii madaxtinimo ee somaliland 2010	Eleição presidencial na Somalilândia em 2010
Dafo	Águia
PornoTube	PornoTube
Badh	Um meio
Diig	Galo
Ruqiya bint Muxamed	Hadhrat Ruqayyah
Kobra	Cobra
Saldanadii Cadal	Sultanato de Adal
Umm Kaltuum bint Muxamed	Umm Kulthum bint Muhammad
Nabi Yuunus C.S.	Jonas (profeta)
Dad	Povo
Universidade do Estado de Minas Gerais	Universidade do Estado de Minas Gerais
Mici	Canino superior
Feedh	Caixa torácica
Cayn	Ayn
Bianca Castanho	Bianca Castanho
Ceelbuur	Ceelbuur
Laan	Galho
Category:Dhaqan	Categoria:Cultura
Category:Tobaneeyada sano	Categoria:Décadas
Category:Sanad	Categoria:Anos
Category:Qaaradaha	Categoria:Continentes
Edmond Debeaumarché	Edmond Debeaumarché
Paolla Oliveira	Paolla Oliveira
Indhafiiqid	Cirurgia de catarata
Portal:Cilmi Fallag	Portal:Astronomia
Portal:Juqraafi	Portal:Geografia
Precalculus	Pré-cálculo
Liboy	Liboi
Radio Gaalkacyo	Radio Gaalkacyo
Lughaya	Lughaya
Wisil	Wisil
Bandiiradley	Bandiiradley
Gunbur	Pirâmide
Jano	Paraíso
Saami qumman	Razão (matemática)
Tiro	Conde
Jaamacada Kismaayo	Universidade Kismayo
Anna Rita Del Piano	Anna Rita Del Piano
Category:Wikipedia bots	Categoria:!Robôs
XVideos	XVideos
Dagaal Dhaqameedka shiineeska	Artes marciais chinesas
Portal:Bulsho	Portal:Sociedade
Dhahar	Dhahar
Dila	Dilla
Cufka atamka	Massa atômica
Hotmail	Microsoft Hotmail
Template:Wikipedialang	Predefinição:Wikipédia em outras línguas
Category:Wadamada	Categoria:Países
Wikipedia:Maamulka	Wikipédia:Administradores
Category:Shaqsiyadaad	Categoria:Pessoas
Wikipedia:Requests for adminship	Wikipédia:Pedidos de administração
Wikipedia:Bots	Wikipédia:Robôs
Category:Amin	Categoria:Tempo
Category:Internet	Categoria:Internet
Caynaba	Ainabo
Category:Siyaasad	Categoria:Política
Category:Waxbarasho	Categoria:Educação
Category:Araga	Categoria:Óptica
Category:Fan	Categoria:Arte
Masar	Egito
Category:Filasoofiyaasha	Categoria:Filósofos
Category:Doorashooyinka	Categoria:Eleições
Template:Bot	Predefinição:Robô
Kanada	Canadá
Category:Denmark	Categoria:Dinamarca
Category:Giriig	Categoria:Grécia
Category:Iswiidhan	Categoria:Suécia
Category:Islofaakiya	Categoria:Eslováquia
Wikipedia:Copyright	Wikipédia:Direitos de autor
Wikipedia:Ku saabsan	Wikipédia:Sobre a Wikipédia
Category:Dagaalada	Categoria:Guerras
Category:Microsoft	Categoria:Microsoft
Portal:Saynis	Portal:Ciência
Wikipedia:Ogaysiiska Maamulka	Wikipédia:Pedidos/Outros
Wikipedia:Goob/Farsamo	Wikipédia:Café dos programadores
Template:Flagicon	Predefinição:ÍconeBandeira
Category:Wadamada Yurub	Categoria:Países da Europa
Category:Yurub	Categoria:Europa
Wikipedia:Bogga Isticmaalaha	Wikipédia:Página de usuário
Portal:Dhacdooyinka Hadda	Portal:Eventos atuais
Template:Documentation	Predefinição:Documentação
Wikipedia:Ilaalinta badelka	Wikipédia:Página protegida
Wikipedia:Albaabka bulshada	Wikipédia:Portal comunitário
Category:Luqadaha wikipediyaasha	Categoria:!Wikipedistas por idioma
Wikipedia:Shan walxood	Wikipédia:Cinco pilares
Wikipedia:Userboxes	Wikipédia:Userbox
Wikipedia:Saxiix	Wikipédia:Regras para assinaturas
Sung Jae-ki	Sung Jae-ki
Afbarwaaqo	Afbarwaaqo
Caa'isha binti Abiibakar	Aisha bint Abu Bakr
Ganacsi	Negócio
Instituto Federal da Bahia	Instituto Federal da Bahia
Template:Softredirect	Predefinição:Pseudorredirecionamento
Template:Tirtir	Predefinição:ER
Category:Teknooloji	Categoria:Tecnologia
Category:Afafka	Categoria:Línguas
Category:Kalandar	Categoria:Calendários
Category:Wikipedia	Categoria:Wikipédia
Wikipedia:Masuul la'aan guud	Wikipédia:Aviso geral
Category:Pages with broken file links	Categoria:!Páginas com ficheiros inexistentes
Wikipedia:Tirakoob	Wikipédia:Estatísticas
Wikipedia:Xeerka Wiki	Wikipédia:Política de privacidade
Burtinle	Burtinle
Template:Navbox	Predefinição:Navbox
Template:Coat of arms	Predefinição:Brasão
Dangorayo	Dan Gorayo
Template:Xaqiiq	Predefinição:Carece de fontes
Ceel Huur	Ceel Huur
Portal:Siiro	Portal:Biografias
Template:Tnavbar	Predefinição:Tnavbar
Template:Clear	Predefinição:Limpar
Template:Nowrap	Predefinição:Nowrap
Millan	Solução
Wikipedia:Maqaalada aan u baahan laheen	Wikipédia:Artigos essenciais
Category:Afrika	Categoria:África
Category:Elektaroonig	Categoria:Eletrônica
Category:Kitaabka quduska	Categoria:Bíblia
Category:Buugta	Categoria:Livros
Category:Bilaha	Categoria:Meses
Template:Babel	Predefinição:Babel
Template:Reflist	Predefinição:Referências
Xidhiidhka Dibada ee Somaliland	Relações exteriores de Somalilândia
Category:Isbitaal	Categoria:Hospitais
Wikipedia:Soo bandhigida xogta	Wikipédia:Livro de estilo/Cite as fontes
Wikipedia:Habka maqaalada Xulka Ah	Wikipédia:O que é um artigo em destaque?
Template:Gumud	Predefinição:Esboço
Template:User ar-1	Predefinição:User ar-1
Template:See also	Predefinição:VT
Template:User da-2	Predefinição:User da-2
Template:User da	Predefinição:User da
Template:User de	Predefinição:User de
Template:User de-1	Predefinição:User de-1
Template:User es	Predefinição:User es
Template:User de-3	Predefinição:User de-3
Template:User en-3	Predefinição:User en-3
Template:User en-1	Predefinição:User en-1
Template:User en-2	Predefinição:User en-2
Template:User en-4	Predefinição:User en-4
Template:User fi	Predefinição:User fi
Template:User en-0	Predefinição:User en-0
Template:User en	Predefinição:User en
Template:User de-2	Predefinição:User de-2
Template:User fi-1	Predefinição:User fi-1
Template:User fr-1	Predefinição:User fr-1
Template:User sk	Predefinição:User sk
Template:User fr-2	Predefinição:User fr-2
Template:User ja	Predefinição:User ja
Template:User ja-1	Predefinição:User ja-1
Template:User fr	Predefinição:User fr
Category:Aasiya	Categoria:Ásia
Category:Jili	Categoria:Chile
Category:Ameerikada koonfureed	Categoria:América do Sul
Template:Intricate template	Predefinição:Predefinição complexa
Template:Mod	Predefinição:Mod
Template:User es-2	Predefinição:User es-2
Template:Country data Belgium	Predefinição:Country data Bélgica
Category:Maalmaha usbuuca	Categoria:Dias da semana
Template:Navy/core	Predefinição:Marinha/core
Category:Bogga Hore	Categoria:Página principal
Template:Country data Ethiopia	Predefinição:Country data Etiópia
Template:Country data Cuba	Predefinição:Country data Cuba
Template:Country data Kenya	Predefinição:Country data Quénia
Template:Country data Denmark	Predefinição:Country data Dinamarca
Template:Click	Predefinição:Click
Template:Country data Bosnia and Herzegovina	Predefinição:Country data Bósnia e Herzegovina
Template:Number of defined parameters	Predefinição:Number of defined parameters
Template:Country data Norway	Predefinição:Country data Noruega
Template:Country data Argentina	Predefinição:Country data Argentina
Template:Country showdata	Predefinição:Country showdata
Template:Image label	Predefinição:Image label
Template:Country data Mexico	Predefinição:Country data México
Template:Country data Saudi Arabia	Predefinição:Country data Arábia Saudita
Template:Dalalka Afrika	Predefinição:Países da África
Template:Country data Iraq	Predefinição:Country data Iraque
Template:Country data United Arab Emirates	Predefinição:Country data Emirados Árabes Unidos
Template:Kutaal	Predefinição:Localização geográfica
Template:Country data Australia	Predefinição:Country data Austrália
Template:Sidebar	Predefinição:Sidebar
Template:Navigation templates	Predefinição:Modelo de navegação
Template:Infobox Xooga Dalka Soomaaliyeed	Predefinição:Info/Forças Armadas
Template:Country data Austria	Predefinição:Country data Áustria
Template:Collapsible option	Predefinição:Collapsible option
Template:Country data Nepal	Predefinição:Country data Nepal
Template:Country data Finland	Predefinição:Country data Finlândia
Wikipedia:Tutorial (Wikipedia links)	Ajuda:Tutorial/Ligações internas
Template:Country data Netherlands	Predefinição:Country data Países Baixos
Template:Hatnote	Predefinição:Dablink
Template:Maqaal Xul Ah	Predefinição:Artigo destacado
Template:Country data Russian Federation	Predefinição:Country data Rússia
Category:Gaana	Categoria:Gana
Category:User en	Categoria:Usuários en
Category:User en-2	Categoria:Usuário en-2
Template:Infobox	Predefinição:Info
Template:Navy	Predefinição:Marinha
Template:User eo	Predefinição:User eo
Template:User zh	Predefinição:User zh
Category:Farta	Categoria:Alfabetos
Template:Template other	Predefinição:Template other
Template:Country data Italy	Predefinição:Country data Itália
Template:Country data	Predefinição:Dados de país
Template:Pp-template	Predefinição:Pp-template
Template:Min	Predefinição:Min
Category:Astaannta Qaranka	Categoria:Brasões
Category:Beeraha	Categoria:Agricultura
Category:Dowladaha	Categoria:Estado
Template:Country data Soviet Union	Predefinição:Country data União Soviética
Template:Country data India	Predefinição:Country data India
Category:Falastiin	Categoria:Palestina
Category:Language user templates	Categoria:!Predefinições de babel
Template:Navbox subgroup	Predefinição:Navbox subgroup
Template:Farac	Predefinição:Info/Grupo étnico
Template:Category redirect	Predefinição:Redirecionamento de categoria
Template:Macluumaad Qof Madax Ah	Predefinição:Info/Político
Category:Kacaanka	Categoria:Revolucionários
Template:Border	Predefinição:Borda
Template:Country data Turkey	Predefinição:Country data Turquia
Category:Qoraaga	Categoria:Escritores
Category:Jaamacadaha	Categoria:Universidades
Wikipedia:Maxaan akoon usamaynayaa	Wikipédia:Usuários registrados
Template:Country data Nigeria	Predefinição:Country data Nigéria
Template:Hidden begin	Predefinição:Hidden begin
Template:Country data Malaysia	Predefinição:Country data Malásia
Template:User pt-1	Predefinição:User pt-1
Template:Infobox planet	Predefinição:Info/Planeta
Template:User nl	Predefinição:User nl
Template:Infobox website	Predefinição:Info/Sítio
Template:Image label end	Predefinição:Image label end
Template:Documentation subpage	Predefinição:Subpágina de documentação
Template:Infobox number	Predefinição:Info/Número
Template:Please don't change this page	Wikipédia:Introdução/2
Category:Dekedaha	Categoria:Portos
Template:Lang-la	Predefinição:Lang-la
Template:Macluumaad askariga	Predefinição:Info/Militar
Template:User	Predefinição:Usuário2
Template:References	Predefinição:Sem-fontes
Template:Jadwal	Predefinição:Tabela bonita
Template:PD-because	Predefinição:DomínioPúblico
Template:Infobox former country	Predefinição:Info/Estado extinto
Template:1	Predefinição:Ouro1
Template:Suugaan	Predefinição:Literatura
Template:Kaydka wadahadalka	Predefinição:Arquivo de discussão
Portal:Fiisikis	Portal:Física
Template:Usbuuc	Predefinição:Dias da semana
Template:Largest cities	Predefinição:Maiores cidades
Template:Country data West Germany	Predefinição:Country data Alemanha Ocidental
Template:Hooyga Maqaalada	Predefinição:Barra de portais
Template:Divbox	Predefinição:Caixa
Category:Booliis	Categoria:Polícia
Template:Astaamayn	Predefinição:Pontuação
Template:Plain link	Predefinição:Plnk
Template:Country data Comoros	Predefinição:Country data Comores
Template:Magaalooyinka Soomaaliya	Predefinição:Cidades mais populosas da Somália
Template:Geobox	Predefinição:Geobox
Template:Farriimaha Bulshada	Predefinição:Box
Template:Lower	Predefinição:Lower
Template:Dhintey	Predefinição:Morte
Template:User sandbox	Predefinição:Página de testes de utilizador
Template:Saynis	Predefinição:Ciências-vertical
Template:High-risk	Predefinição:Alto risco
Template:Country data Qadar	Predefinição:Country data Qatar
Template:Country data Ukrain	Predefinição:Country data Ucrânia
Template:Country data Pakistan	Predefinição:Country data Paquistão
Template:User pt-0	Predefinição:User pt-0
Template:MainPageInterwikis	Predefinição:Interwikis da página principal
Template:Higgaad	Predefinição:Corrigir
Template:User pt-3	Predefinição:User pt-3
Template:User pt-2	Predefinição:User pt-2
Doorashada Madaxtinimada Soomaaliya, 2009	Eleições presidenciais na Somália em 2009
Category:User sk	Categoria:Usuários sk
Category:User eo	Categoria:Usuários eo
Category:User ja	Categoria:Usuários ja
Category:User da-2	Categoria:Usuário da-2
Category:Ganacsi	Categoria:Negócios
Template:Correct title	Predefinição:Título errado
Category:User ar	Categoria:Usuários ar
Category:Jasiirad	Categoria:Ilhas
Category:User da	Categoria:Usuários da
Category:User sk-N	Categoria:Usuário sk
Category:User de	Categoria:Usuários de
Category:User fi	Categoria:Usuários fi
Category:Nabiyada Islaamka	Categoria:Profetas do Islamismo
Category:Tiirarka Islaamka	Categoria:Cinco pilares do Islamismo
Template:Country data Burundi	Predefinição:Country data Burundi
Template:Country data Germany	Predefinição:Country data Alemanha
Template:Country data UK	Predefinição:Country data Reino Unido
Template:Color sample	Predefinição:Color sample
Template:Lambarada	Predefinição:Números
Category:User ja-1	Categoria:Usuário ja-1
Category:User ko	Categoria:Usuários ko
Template:Macluumaad	Predefinição:Information
Template:Gobollada Soomaaliya	Predefinição:Somália
Template:Button	Predefinição:MBotão
Wikipedia:Babel	Wikipédia:Babel
Template:Help contents back	Predefinição:Ajuda conteúdo volta
Category:Abwaanada	Categoria:Poetas
Template:Sidebar with collapsible lists	Predefinição:Sidebar with collapsible lists
Category:Badaha	Categoria:Mares
Template:No2	Predefinição:Não2
Category:Ingiriiska	Categoria:Inglaterra
Template:Str ≥ len	Predefinição:Str ≥ len
Category:Taariikhda Soomaaliya	Categoria:História da Somália
Leilani Leeane	Leilani Leeane
Template:Country data Brazil	Predefinição:Country data Brasil
Template:Yes2	Predefinição:Sim2
Category:Ururada caalamiga ah	Categoria:Organizações internacionais
Template:Siyaasadda Soomaaliya	Predefinição:Política da Somália
Category:Gobolada Soomaaliya	Categoria:Regiões da Somália
Category:Juquraafiga Soomaaliya	Categoria:Geografia da Somália
Template:Country data Somaliland	Predefinição:Country data Somalilândia
Category:Madaxda Soomaaliya	Categoria:Presidentes da Somália
Category:Cilmiga bulshada	Categoria:Ciências sociais
Category:Wadamada Afrika	Categoria:Países de África
Template:User da-3	Predefinição:User da-3
Template:User pt-4	Predefinição:User pt-4
Category:1542	Categoria:1542
Fenerbahce SK	Fenerbahçe Spor Kulübü
Template:Country data United States	Predefinição:Country data Estados Unidos
Universidade Federal do Recôncavo da Bahia	Universidade Federal do Recôncavo da Bahia
Category:Farshaxanka	Categoria:Pintores
Wikipedia:Xeerka adeegsiga sawirada	Wikipédia:Política de imagens
Template:Raadiyoow	Predefinição:Info/Emissora de rádio
Category:Dhirta	Categoria:Árvores
Portal:Hiddaha iyo Dhaqanka	Portal:Cultura
Wikipedia:Habaynta Maqaalada Xulka Ah	Wikipédia:Revalidação
Portal:Baayooloji	Portal:Biologia
Category:Juquraafiga Hindiya	Categoria:Geografia da Índia
Category:Jilaaga	Categoria:Atrizes
Template:Convert/And0	Predefinição:Convert/And0
Template:Weather box/cold	Predefinição:Infobox Weather/cold
Category:Jabuuti	Categoria:Djibouti
Category:Ereteriya	Categoria:Eritreia
Category:Kiinya	Categoria:Quénia
Category:Komoros	Categoria:Comores
Category:Libiya	Categoria:Líbia
Category:Diinta Soomaaliya	Categoria:Religião na Somália
Category:Dhaqaalaha Soomaaliya	Categoria:Economia da Somália
Category:Lacagta	Categoria:Moedas
Category:Webiyada	Categoria:Rios
Category:Juquraafiga Jabuuti	Categoria:Geografia do Djibouti
Template:User pt	Predefinição:User pt
Category:Holland	Categoria:Holanda
Category:Soomaaliya	Categoria:Somália
Category:Webiyada Soomaaliya	Categoria:Rios da Somália
Template:DecreasePositive	Predefinição:Baixa positiva
Category:Juquraafiga Yemen	Categoria:Geografia do Iémen
Category:Magaalooyinka Yemen	Categoria:Cidades do Iémen
Template:Maanta	Predefinição:Calendario
Template:Country data Djibouti	Predefinição:Country data Djibouti
Category:User nl	Categoria:Usuários nl
Category:Hay'ada laanqayrta cas	Categoria:Cruz Vermelha
Template:Country data Federated States of Micronesia	Predefinição:Country data Estados Federados da Micronésia
Template:Navbar-header	Predefinição:Tnavbar-header
Category:Diffusion	Categoria:Difusão
Category:Suuriya	Categoria:Síria
Category:Qarniyada	Categoria:Séculos
Category:Qarnigii 16aad	Categoria:Século XVI
Category:Qooriyada	Categoria:Praias
Category:Filasoofiyaasha Jarmalka	Categoria:Filósofos da Alemanha
Category:Esoteric templates	Categoria:!Predefinições complexas
Category:Harraha Afrika	Categoria:Lagos da África
Category:Madaxda Faransiiska	Categoria:Presidentes da França
Category:Madaxda Iiraan	Categoria:Presidentes do Irão
Category:Norway	Categoria:Noruega
Category:Yemen	Categoria:Iémen
Category:Malaay	Categoria:Peixes
Category:Mutolojiyada	Categoria:Mitologia
Category:Qaamuus	Categoria:Dicionários
Category:Axdiga Cusub	Categoria:Novo Testamento
Category:Ilko	Categoria:Dentes
Category:Dhaqanka Soomaalida	Categoria:Cultura da Somália
Category:Wikimedia	Categoria:Wikimedia
Category:Radio	Categoria:Rádio
Category:Xayawaan	Categoria:Animais
Category:Jamhuriyadda	Categoria:Repúblicas
Category:Muqdisho	Categoria:Mogadíscio
Category:Jilaaga barasiiliyanka	Categoria:Atrizes do Brasil
Template:Raise	Predefinição:Raise
Category:Bartamaha Ameerika	Categoria:América Central
Category:Caasimadaha	Categoria:Capitais
Category:Magaalooyinka Hindiya	Categoria:Cidades e vilas da Índia
Category:Isgaarsiinta	Categoria:Telecomunicações
Category:Gaadiidka	Categoria:Transporte
Category:Ameerikada waqooyi	Categoria:América do Norte
Category:Harraha	Categoria:Lagos
Category:Saxaabada	Categoria:Sahaba
Category:Calamada	Categoria:Bandeiras
Template:Flagcountry	Predefinição:Flagcountry
Template:Macluumaad luqadda	Predefinição:Info/Língua
Category:Dimoqraadi	Categoria:Democracia
Kaaroot	Cenoura
Category:Caasimadaha afrika	Categoria:Capitais da África
Template:Infobox polygon	Predefinição:Info/Polígono
Category:Komunistiyaasha Jarmalka	Categoria:Comunistas da Alemanha
Category:Magaalooyinka Soomaaliya	Categoria:Cidades da Somália
Category:Magaalooyinka Jabuuti	Categoria:Cidades do Djibouti
Category:Guurka	Categoria:Casamento
Category:Aadam iyo Xaawo	Categoria:Eve
Xingood	Xingood
Category:Lahjadaha looga hadlo Soomaaliya	Categoria:Línguas da Somália
Category:Caasimadaha yurub	Categoria:Capitais da Europa
Category:Somaliland	Categoria:Somalilândia
Template:Politics browsebar	Predefinição:Barra de navegação de portais de política
Template:Country data Puntland	Predefinição:Country data Puntlândia
Template:H:title	Predefinição:H:title
Category:Caafimaadka	Categoria:Saúde
Template:Country data Canada	Predefinição:Country data Canadá
Template:Clickable button 2	Predefinição:Clickable button 2
Template:Convert/numdisp/frac1	Predefinição:Convert/numdisp/frac1
Template:Flag	Predefinição:Flag
Template:Country data Malawi	Predefinição:Country data Malawi
Template:Country data South Yemen	Predefinição:Country data Iêmen do Sul
Template:Country data Uganda	Predefinição:Country data Uganda
Template:Country data Yemen	Predefinição:Country data Iémen
Template:Lang-pl	Predefinição:Lang-pl
Category:Buuraha Soomaaliya	Categoria:Montanhas da Somália
The Narrative	The Narrative
Portal:Xisaab	Portal:Matemática
Trojany	Trojany
Template:HMXA	Predefinição:Revalidação
Category:Wadamada Aasiya	Categoria:Países da Ásia
Template:Bogag Maqaalada Xulka Ah	Predefinição:PáginasAD
Category:Wikipedia uncategorized templates	Categoria:!Predefinições por categorizar
Portal:Siyaasadda	Portal:Política
Portal:Qaynuun	Portal:Direito
Category:Abidjan	Categoria:Abidjan
Category:Awdal	Categoria:Awdal
Template:Colonne	Predefinição:Multicol
Eray bixin	Terminologia
Category:Degmooyinka Soomaaliya	Categoria:Distritos da Somália
Category:Esperanto	Categoria:Esperanto
Template:Lang-am	Predefinição:Lang-am
Template:Lang-sv	Predefinição:Lang-sv
Khilaafadii Umawiyiinta	Califado Omíada
Portal:Kimistari	Portal:Química
Category:Linux	Categoria:Linux
Category:Soomaali Galbeed	Categoria:Região de Somali
Category:Qabaa'ilada Soomaaliya	Categoria:Clãs somalis
Category:Siyaasada Soomaaliya	Categoria:Política da Somália
Category:Komunistiyaasha	Categoria:Comunistas
Category:Qiyaasaha Masaafooyinka	Categoria:Unidades de comprimento
Category:Midabada	Categoria:Cor
Category:Triboli	Categoria:Trípoli
Category:Jaamacadaha Soomaaliya	Categoria:Universidades da Somália
Category:Bahalada sheeko xariirka	Categoria:Sereias
Wikipedia:Habka Maqaalada Cusub	Wikipédia:O que é um artigo bom?
Template:Country data Somalia	Predefinição:Country data Somália
Template:Image label begin	Predefinição:Image label begin
Category:Magaalooyinka Soomaali Galbeed	Categoria:Woredas da região de Somali
Template:Tirada Maqaalada Cusub	Predefinição:Número de artigos bons
Category:User en-1	Categoria:Usuário en-1
Universidade Fundação Mineira de Educação e Cultura	Universidade Fundação Mineira de Educação e Cultura
Portal:Caafimaad	Portal:Medicina
Template:Afarta xilli	Predefinição:Estações do ano
Wikipedia:Tutorial (Talk pages)	Ajuda:Tutorial/Discussão
Wikipedia:Tutorial (Keep in mind)	Ajuda:Tutorial/A reter
Template:User nl-3	Predefinição:User nl-3
Template:Goob	Predefinição:Discussão
Template:Infobox/row	Predefinição:Infobox/row
Template:Wayback	Predefinição:Wayback
Wikipedia:Tutorial (Wrap-up and more info)	Ajuda:Tutorial/Sumário
Wikipedia:Tutorial (Registration)	Ajuda:Tutorial/Registo
Template:Significant figures	Predefinição:Sigfig
Template:ForLoop/aux	Predefinição:ForLoop/aux
Template:Saxaafad	Predefinição:Jornalismo
Template:For year month day	Predefinição:Tempo decorrido
Portal:Soomaaliya	Portal:Somália
Template:Efn	Predefinição:Efn
Template:Element color/Actinoids	Predefinição:Elemento/Cor actinídios
Template:Element color/Alkaline earth metals	Predefinição:Elemento/Cor metais alcalino-terrosos
Template:Weather box/colh	Predefinição:Infobox weather/colh
Budbud	Budbud
Template:Xpda	Predefinição:Xpda
Parvoviruses	Parvoviridae
Template:Element color/Alkali metals	Predefinição:Elemento/Cor metais alcalinos
Template:Element color/Lanthanoids	Predefinição:Elemento/Cor lantanídios
Template:Element color/Nonmetals	Predefinição:Elemento/Cor não-metais
Wikipedia:Editnotice	Wikipédia:Namespace MediaWiki/Editnotice
Template:Infobox Weather/khad	Predefinição:Infobox weather/line
Template:Infobox Weather/colp	Predefinição:Infobox weather/colp
Template:Infobox Weather/colt	Predefinição:Infobox weather/colt
Template:Significant figures/rnd	Predefinição:Sigfig/rnd
Bitaale	Bitaale
Template:Degmooyinka Soomaaliya	Predefinição:Distritos da Somália
Template:Weather box/cols	Predefinição:Infobox weather/cols
Template:Weather box/oneline	Predefinição:Infobox Weather/line/onevalue
Template:Xpd5op3p3p3c	Predefinição:Xpd5op3p3p3c
Template:Divbox/style/blue	Predefinição:Divstyleblue
Adnan Januzaj	Adnan Januzaj
Cabdiweli Sheekh Axmed	Abdiweli Sheikh Ahmed
Barkhad Cabdi	Barkhad Abdi
Special:RecentChanges	Especial:Mudanças recentes
Aqriste	Reader
Module:Navbox	Módulo:Navbox
Category:Wabiyada Afrika	Categoria:Rios da África
