非洲	África
日本	Japão
南美洲	América do Sul
挪威	Noruega
英格兰	Inglaterra
苏格兰	Escócia
匈牙利	Hungria
西班牙	Espanha
美国	Estados Unidos
比利时	Bélgica
卢森堡	Luxemburgo
地球	Terra
人	Homo sapiens
欢喜	Felicidade
芬兰	Finlândia
瑞典	Suécia
波兰	Polónia
立陶宛	Lituânia
意大利	Itália
瑞士	Suíça
奥地利	Áustria
希腊	Grécia
土耳其	Turquia
啤酒	Cerveja
葡萄牙	Portugal
欧洲	Europa
亚洲	Ásia
维基百科	Wikipédia
尼德兰	Países Baixos
PHP	PHP
纽约市	Nova Iorque
旧金山	São Francisco (Califórnia)
洛杉矶	Los Angeles
计算机	Computador
办合纳	Berna
极乃伐	Genebra
苏黎世	Zurique
巴拉克·奥巴马	Barack Obama
乌拉圭	Uruguai
白才尔	Basileia
打印机	Impressora
伦敦	Londres
开罗	Cairo
苹果	Maçã
墨西哥	México
大西洋	Oceano Atlântico
太平洋	Oceano Pacífico
加利福尼亚	Califórnia
波士顿	Boston
礼拜一	Segunda-feira
火星	Marte (planeta)
肯尼亚	Quénia
礼拜两	Terça-feira
礼拜三	Quarta-feira
礼拜四	Quinta-feira
礼拜五	Sexta-feira
礼拜六	Sábado
礼拜天	Domingo
法国	França
世界语	Esperanto
狗	Canis lupus familiaris
英国	Reino Unido
貓	Gato
中华人民共和国	República Popular da China
法文	Língua francesa
鱼	Peixe
巴西	Brasil
俄罗斯	Rússia
大海	Mar
圓周率	Pi
Π	Π
聖保羅	São Paulo (cidade)
该办克	Quebec
德国	Alemanha
白俄罗斯	Bielorrússia
德语	Língua alemã
冰岛	Islândia
愛沙尼亞	Estónia
土星	Saturno (planeta)
巧克力	Chocolate
飞机	Avião
打仗	Guerra
拉脱维亚	Letónia
乌克兰	Ucrânia
捷克	República Checa
斯洛伐克	Eslováquia
斯洛文尼亚	Eslovénia
摩尔多瓦	Moldávia
罗马尼亚	Roménia
保加利亚	Bulgária
罗马	Roma
马其顿	República da Macedónia
阿爾巴尼亞	Albânia
格陵兰	Gronelândia
克罗地亚	Croácia
波黑	Bósnia e Herzegovina
阿塞拜疆	Azerbaijão
安道尔	Andorra
塞浦路斯	Chipre
格鲁吉亚	Geórgia
哈萨克斯坦	Cazaquistão
马耳他	Malta
摩纳哥	Mónaco
黑山共和国	Montenegro
梵蒂冈	Vaticano
圣马力诺	San Marino
布鲁塞尔	Cidade de Bruxelas
古巴	Cuba
大众汽车	Volkswagen
Java	Java (linguagem de programação)
印度尼西亚	Indonésia
南非	África do Sul
阿尔及利亚	Argélia
乌兹别克斯坦	Uzbequistão
欧罗维竞唱歌比赛	Festival Eurovisão da Canção
水	Água
木	Madeira
电视机	Televisão
冰岛文	Língua islandesa
智利	Chile
耶稣	Jesus
語言	Linguagem
英语维基百科	Wikipédia em inglês
尼古拉·萨科齐	Nicolas Sarkozy
新加坡	Singapura
科学	Ciência
自由軟件	Software livre
列支敦士登	Liechtenstein
希特拉	Adolf Hitler
WikiLeaks	WikiLeaks
第二次世界大战	Segunda Guerra Mundial
科隆	Colônia (Alemanha)
Linux	Linux
数学	Matemática
拉丁文	Língua latina
巴林	Bahrein
亚美尼亚	Arménia
塞尔维亚	Sérvia
月球	Lua
澳大利亚	Austrália
物理学	Física
阿根廷	Argentina
秘鲁	Peru
朝鲜民主主义人民共和国	Coreia do Norte
柬埔寨	Camboja
恐龙	Dinossauros
回教	Islão
里昂	Lyon
欧洲联盟	União Europeia
女性	Mulher
诗	Poesia
米蘭	Milão
屁眼	Ânus
古高尔	Googol
珠穆朗玛峰	Monte Everest
城市	Cidade
巴斯德	Louis Pasteur
村	Aldeia
大洋洲	Oceania
太阳系	Sistema Solar
氢	Hidrogénio
维基共享	Wikimedia Commons
揚聲器	Altifalante
东帝汶	Timor-Leste
维嘞合朋纳	Villeurbanne
学纳河	Rio Ródano
迪拜	Dubai
瀑瑶兰葡萄酒	Beaujolais (vinho)
哥白尼	Nicolau Copérnico
碳	Carbono
音乐	Música
圣皮得斯堡	São Petersburgo
北	Norte
新西兰	Nova Zelândia
南	Sul
印度	Índia
西	Oeste
氯气	Cloro
铅	Chumbo
蒙古国	Mongólia
委内瑞拉	Venezuela
国际象棋	Xadrez
缅因	Maine
苏里南	Suriname
巴拉圭	Paraguai
圭亚那	Guiana
艺术	Arte
厄瓜多尔	Equador
哥伦比亚	Colômbia
佛教	Budismo
玻利维亚	Bolívia
特里尼达搭仔多巴哥	Trinidad e Tobago
新罕布什爾	Nova Hampshire
马萨诸塞	Massachusetts
康涅狄格	Connecticut
鸡	Gallus gallus domesticus
澤西島	Jersey
猪猡	Sus domesticus
伊朗	Irão
伊拉克	Iraque
阿拉斯加	Alasca
以色列	Israel
巴拿马	Panamá
也門	Iémen
约旦	Jordânia
佛罗里达州	Flórida
吉尔吉斯斯坦	Quirguistão
科威特	Kuwait
老挝	Laos
黎巴嫩	Líbano
俄勒冈	Oregon
马尔代芙	Maldivas
马来西亚	Malásia
缅甸	Myanmar
尼泊尔	Nepal
阿曼	Omã
巴基斯坦	Paquistão
卡塔尔	Catar
沙特阿拉伯	Arábia Saudita
斯里兰卡	Sri Lanka
史太林	Josef Stalin
叙利亚	Síria
塔吉克斯坦	Tajiquistão
口袋妖怪	Pokémon
中华民国	República da China
泰国	Tailândia
火车	Trem
土库曼斯坦	Turquemenistão
阿拉伯联合酋长国	Emirados Árabes Unidos
越南	Vietname
新西伯利亚	Novosibirsk
大韩民国	Coreia do Sul
阿富汗	Afeganistão
金	Ouro
喀山	Cazã
孟加拉	Bangladesh
马里	Mali
安哥拉	Angola
不丹	Butão
文莱	Brunei
菲律宾	Filipinas
牛顿	Isaac Newton
OpenStreetMap	OpenStreetMap
量子力学	Mecânica quântica
突尼斯	Tunísia
赞比亚	Zâmbia
津巴布韦	Zimbabwe
北京	Pequim
贝宁	Benim
博茨瓦纳	Botswana
布隆迪	Burundi
刚果共和国	República do Congo
刚果民主共和国	República Democrática do Congo
甘地	Mahatma Gandhi
连环画	Banda desenhada
冈比亚	Gâmbia
科特迪瓦	Costa do Marfim
喀麦隆	Camarões
尼日利亚	Nigéria
索马里	Somália
铌	Nióbio
凱撒	Júlio César
苏丹	Sudão
汉堡	Hamburgo
联合国	Organização das Nações Unidas
唐担	Dante Alighieri
艾哈迈德堡	Ahmedabad
锡	Estanho
克林顿总统	Bill Clinton
孟买	Bombaim
波多黎各	Porto Rico
卡纳塔克邦	Karnataka
列农	John Lennon
爱达荷州	Idaho
华盛顿州	Washington
科索沃	Kosovo
潘基文	Ban Ki-moon
Kofi Annan	Kofi Annan
分类:页面分类	Categoria:Conteúdo
多特蒙德	Dortmund
冬天	Inverno
西班牙语	Língua castelhana
匹兹堡	Pittsburgh
费城	Filadélfia
金奈	Chennai
班加罗尔	Bangalore
钞票	Dinheiro
纽约州	Nova Iorque (estado)
罗德岛	Rhode Island
昆虫	Insetos
宾夕法尼亚	Pensilvânia
Uetersen	Uetersen
奧古斯都	Augusto
微软视窗	Microsoft Windows
直布罗陀	Gibraltar
布宜诺斯艾利斯	Buenos Aires
东京都	Tóquio
爱荷华州	Iowa
里昂地铁	Metrô de Lyon
印地语	Língua hindi
艾迪托·比娅呋	Édith Piaf
因斯孛鲁克	Innsbruck
都柏林	Dublin
法兰克福	Frankfurt am Main
天主教	Catolicismo
圣经	Bíblia
金边	Phnom Penh
胡志明市	Cidade de Ho Chi Minh
河內市	Hanói
真耶稣教会	Verdadeira Igreja de Jesus
英语	Língua inglesa
曼谷	Banguecoque
臺北市	Taipé
同海市	Dong Hoi
Końskowola	Końskowola
达累斯萨拉姆	Dar es Salaam
Al-Khartoum	Cartum
1月11号	11 de janeiro
明斯克	Minsk
微软公司	Microsoft
库鲁夫	Kurów
化学	Química
2月19号	19 de fevereiro
Visual Basic	Visual Basic
本笃十六世	Papa Bento XVI
12月25号	25 de dezembro
8月4号	4 de agosto
8月31号	31 de agosto
迈克尔·杰克逊	Michael Jackson
巴西利亞	Brasília
圣地牙哥	Santiago (Chile)
坎培拉	Camberra
悉尼	Sydney
墨尔本	Melbourne
木卫三	Ganímedes (satélite)
珀斯	Perth (Austrália Ocidental)
西澳大利亚州	Austrália Ocidental
北领地 (澳大利亚)	Território do Norte
苏门答腊岛	Sumatra
突尼斯市	Tunes
德黑兰	Teerã
亚的斯亚贝巴	Adis Abeba
安卡拉	Ancara
贝尔格莱德	Belgrado
分类:维基百科模板	Categoria:!Predefinições Wikipédia
爪哇岛	Java
法属圭亚娜	Guiana Francesa
安曼	Amã
贝鲁特	Beirute
分类:国家模板	Categoria:!Predefinições sobre países
内罗毕	Nairóbi
分类:地理模板	Categoria:!Predefinições sobre geografia
学堂	Escola
大学	Universidade
Wikipedia:沙盘	Wikipédia:Página de testes
屋	Casa
卡尔梅克共和国	Calmúquia
金头公园	Parque da Tête d'Or
地图	Mapa
奥萨斯库	Osasco
同海机场	Aeroporto de Dong Hoi
里昂祭光节	Festival das Luzes (Lyon)
世界言话排名	Lista de línguas por total de falantes
分类:日本历史	Categoria:História do Japão
孔子	Confúcio
分类:数学	Categoria:Matemática
法罗群岛	Ilhas Feroe
分类:印度历史	Categoria:História da Índia
分类:泰国历史	Categoria:História da Tailândia
巴厘岛	Bali
分类:缅甸历史	Categoria:História de Mianmar
欧元	Euro
美元	Dólar dos Estados Unidos
地中海	Mar Mediterrâneo
威尼斯共和国	República de Veneza
杭州市	Hangzhou
基督教	Cristianismo
模板:亚洲行政区划	Predefinição:Países da Ásia
模板:Support	Predefinição:Concordo
金国	Dinastia Jin (1115-1234)
洲	Continente
模板:ALA	Predefinição:ALA
阿德来得	Adelaide (Austrália)
首都	Capital
葡萄牙语	Língua portuguesa
模板:Portal	Predefinição:Portal
公元1949年	1949
阿嘞玛桑	Almazán
黄现璠	Huang Xianfan
日语	Língua japonesa
百科全书	Enciclopédia
封面	Wikipédia:Página principal
路由器	Roteador
棒球	Basebol
奧林匹克运动会	Jogos Olímpicos
长江	Rio Yangtzé
里海	Mar Cáspio
拉斐尔	Rafael Sanzio
电车	Elétrico
加泰罗尼亚	Catalunha
毛泽东	Mao Tsé-Tung
西安	Xian
拉萨市	Lassa
性行为	Relação sexual
加夫列尔·加西亚·马尔克斯	Gabriel García Márquez
分类:快速删除候选	Categoria:!Páginas para eliminação rápida
莎里 嘛克嘞朗	Sally Pearson
马可·波罗	Marco Polo
共产主义	Comunismo
1368年	1368
國家	País
Joe Biden	Joe Biden
希拉里·克林顿	Hillary Clinton
Yelena Isinbayeva	Yelena Isinbayeva
大英博物馆	Museu Britânico
蒙彼利埃	Montpellier
分类:天文学	Categoria:Astronomia
汉堡包	Hambúrguer
班合比让	Perpinhã
标致汽车	Peugeot
李白	Li Bai
图书馆	Biblioteca
世界银行	Banco Mundial
汉武帝	Wu de Han
女权主义	Feminismo
元朝	Dinastia Yuan
库克船长	James Cook
郑和	Zheng He
黃河	Rio Amarelo
蚂蚁	Formiga
宋朝	Dinastia Sung
落苏	Beringela
龙	Dragão
姆妈	Mãe
隆波岛	Lombok
小人	Criança
俄语	Língua russa
人家	Lar
普京	Vladimir Putin
东南亚国家联盟	Associação de Nações do Sudeste Asiático
面包	Pão
国际货币基金组织	Fundo Monetário Internacional
联合国教育科学文化组织	Organização das Nações Unidas para a Educação, a Ciência e a Cultura
联合国卫生组织	Organização Mundial da Saúde
漢語	Língua chinesa
雨	Chuva
全球暖化	Aquecimento global
纳尔逊·曼德拉	Nelson Mandela
马丁·路德·金	Martin Luther King Jr.
蛋白质	Proteína
天灾	Desastre natural
海啸	Tsunami
云	Nuvem
电视	Televisor
几何学	Geometria
日圆	Iene
单词	Palavra
漢字	Caracteres chineses
希腊字母	Alfabeto grego
諺文	Hangul
分类:法国	Categoria:França
分类:音乐	Categoria:Música
红楼梦	O Sonho da Câmara Vermelha
漫画	Mangá
狐狸	Raposa
哈利波特	Harry Potter
小提琴	Violino
肛交	Sexo anal
教育	Educação
男性	Homem
婚姻	Casamento
法语维基百科	Wikipédia em francês
咖啡	Café
果汁	Suco
山	Montanha
第29届奧林匹克运动会	Jogos Olímpicos de Verão de 2008
孙中山	Sun Yat-sen
香港	Hong Kong
首尔	Seul
上海	Xangai
伦敦 海斯楼 飞机场	Aeroporto de Londres Heathrow
清朝	Dinastia Qing
越南战争	Guerra do Vietnã
巴斯克语	Língua basca
阿拉贡语	Língua aragonesa
瓦伦西亚	Valência (Espanha)
玛丽咏·高帝娅	Marion Cotillard
麦克斯韦	James Clerk Maxwell
原子	Átomo
光	Luz
罗鲍斯	Dayron Robles
韩语	Língua coreana
官話	Língua mandarim
高棉文	Língua khmer
弗洛伊德	Sigmund Freud
泰语	Língua tailandesa
马来语	Língua malaia
蒙古语	Língua mongol
犹太教	Judaísmo
万象	Vienciana
莫白桑	Guy de Maupassant
司马迁	Sima Qian
朱熹	Zhu Xi
廷巴克图	Tombuctu
伦理学	Ética
沙·卢克·康	Shahrukh Khan
什叶派	Xiismo
道教	Taoismo
子宫	Útero
颈	Pescoço
富克朗特群岛	Ilhas Malvinas
马恩岛	Ilha de Man
戴安娜王妃	Diana, Princesa de Gales
Α	Α
Ω	Ω
Μ	Μ
明朝	Dinastia Ming
朱元璋	Zhū Yuánzhāng
Φ	Φ
Laura Robson	Laura Robson
2008年欧罗维竞唱歌比赛	Festival Eurovisão da Canção 2008
强·马凯恩	John McCain
金正日	Kim Jong-il
元素周期表	Tabela periódica
罗別脫 姆格比	Robert Mugabe
自杀	Suicídio
爬蟲類	Répteis
Λ	Λ
伍老虎	Tiger Woods
洋山芋	Batata
三宝垄	Semarang
报纸	Jornal
电话	Telefone
?	Ponto de interrogação
美国空军	Força Aérea dos Estados Unidos
菲德尔·卡斯特罗	Fidel Castro
元素单子	Elemento (química)
广域网	Rede de longa distância
围棋	Go
电影	Filme
气体	Gás
液体	Líquido
固体	Sólido
脚踏车	Bicicleta
农业	Agricultura
温度	Temperatura
面积	Área
数	Número
玛丽亚·莎拉波娃	Maria Sharapova
重慶	Chongqing
天津市	Tianjin
武汉	Wuhan
世界地理索引	Lista de Estados soberanos
玫瑰人生 (歌)	La vie en rose
担桑身	Gravidez
Google地图	Google Maps
癌	Cancro
残疾人	Deficiência
抗生素	Antibiótico
青霉素	Penicilina
肺炎	Pneumonia
克来普	Crêpe
麻将	Mahjong
运河	Canal
坝	Barragem
牛顿 (单位)	Newton (unidade)
世界报 (法国)	Le Monde
万里长城	Muralha da China
可再生能源	Energia renovável
电	Eletricidade
核武器	Bomba nuclear
Joomla!	Joomla
吉卜赛语	Romani
壮语	Língua zhuang
自由人报 (法国)	Libération
安吉丽娜	Angelina Jolie
阿拉伯语	Língua árabe
马多符	Bernard Madoff
扬马延岛	Jan Mayen
科西嘉岛	Córsega
奥克语	Língua occitana
克里斯蒂娜 艾伐脱	Chris Evert
李明博	Lee Myung-bak
Β	Β
Γ	Γ
Δ	Δ
Ε	Ε
Ζ	Ζ
Η	Η
Θ	Θ
Ι	Ι
Κ	Κ
Ν	Ν
Ξ	Ξ
Ο	Ο
Ρ	Ρ
Σ	Σ
Τ	Τ
Υ	Υ
Χ	Χ
Ψ	Ψ
复活节岛	Ilha de Páscoa
澳门	Macau
联想计算机公司	Lenovo
董建华	Tung Chee-Hwa
胡锦涛	Hu Jintao
习近平	Xi Jinping
深圳市	Shenzhen
廣東省	Guangdong
广西壮族自治区	Guangxi
施蒂文 呼克	Steven Hooker
南澳大学	Universidade da Austrália Meridional
鹿儿岛县	Kagoshima
C语言	C (linguagem de programação)
手铐	Algemas
艾米·麦克唐纳 (歌手)	Amy Macdonald
Wikipedia:Featured articles	Wikipédia:Artigos destacados
模板:Link FA	Predefinição:Link FA
Wikipedia:红茶坊	Wikipédia:Esplanada
釜山广域市	Busan
佛蒙特	Vermont
广州	Cantão (China)
蔣中正	Chiang Kai-shek
江泽民	Jiang Zemin
温家宝	Wen Jiabao
南京市	Nanquim
刘德华	Andy Lau
张学友	Jacky Cheung
郭富城	Aaron Kwok
首都圈电铁	Metropolitano de Seul
北京大学	Universidade de Pequim
清華大學	Universidade Tsinghua
江苏省	Jiangsu
浙江省	Zhejiang
邓小平	Deng Xiaoping
琶兰那克	Parañaque
菲律宾比索	Peso filipino
西藏	Região Autônoma do Tibete
圆	Círculo
同性婚姻	Casamento entre pessoas do mesmo sexo
Francesc Fàbregas	Cesc Fàbregas
手机	Telefone celular
太平山 (香港)	Victoria Peak
欧洲杯足球赛	Liga dos Campeões da UEFA
马来亚半岛	Península da Malásia
平壤市	Pyongyang
奥斯卡奖	Óscar
各经济实体国内生产总值列表	Lista de países por PIB nominal
ی	Yod
司徒华	Szeto Wah
黑龍江省	Heilongjiang
芽庄市	Nha Trang
教皇	Papa
波多黎各独立党	Partido Independentista Portorriquenho
钱塘江	Rio Qiantang
四川省	Sichuan
圣诞	Natal
闰年	Ano bissexto
大田广域市	Daejeon
大邱广域市	Daegu
仁川国际机场	Aeroporto Internacional de Incheon
仁川广域市	Incheon
京畿道	Gyeonggi
计算机科学	Ciência da computação
阿鲁巴	Aruba
国际音标	Alfabeto fonético internacional
河北省	Hebei
GNU自由文档许可证	GNU Free Documentation License
陈水扁	Chen Shui-bian
台湾	Ilha Formosa
纽约	Nova Iorque (desambiguação)
2012年欧洲足球冠军赛	Campeonato Europeu de Futebol de 2012
路由	Encaminhamento
人口密度	Densidade populacional
爱尔兰	Irlanda (ilha)
鲁迅	Lu Xun (escritor)
湖	Lago
黄瓜	Pepino
南奥赛西亚	Ossétia do Sul
阿什哈巴德	Asgabate
岛屿	Ilha
马赛	Marselha
风牙己榜国家公园	Parque Nacional de Phong Nha-Kẻ Bàng
广平省	Quang Binh
赤道	Linha do equador
字典	Dicionário
北塞浦路斯	República Turca de Chipre do Norte
死海	Mar Morto
英镑	Libra esterlina
金兰国际机场	Aeroporto Internacional Cam Ranh
荷属安地列斯	Antilhas Neerlandesas
根西岛	Guernsey
斯瓦尔巴群岛	Svalbard
Benetice	Benetice (Světlá nad Sázavou)
摄氏温标	Grau Celsius
大叻市	Da Lat
岘港市	Da Nang
Washington	Washington (desambiguação)
甴巴子	Barata
鱷魚	Crocodylia
中国工商银行	Banco Industrial e Comercial da China
人造卫星	Satélite artificial
太原省 (越南)	Thái Nguyên
杀人鲸	Orca
印科软件	Infosys
苏岩礁	Rochedo de Socotra
日本海	Mar do Japão
东亚	Ásia Oriental
北亚	Ásia Setentrional
南欧	Europa meridional
东欧	Leste Europeu
北欧	Europa Setentrional
西欧	Europa Ocidental
中欧	Europa Central
辛基得语	Língua tlingit
琉球国	Reino de Ryukyu
县	Condado
氨基糖苷类抗生素	Aminoglicosídeo
伊斯兰历	Calendário islâmico
柳京饭店	Hotel Ryugyong
霍顿汽车	Holden
市长	Prefeito
中文维基百科	Wikipédia em chinês
总统	Presidente
满洲国	Manchukuo
安娜·伊凡诺维琪	Ana Ivanović
圣诞岛	Ilha Christmas
明绞拉	Mingora
拳击	Boxe
樟宜国际机场	Aeroporto de Singapura
大西洋处女	Virgin Atlantic Airways
快达航空	Qantas
斑马	Zebra
同奈省	Dong Nai
广义省	Quang Ngai
金瓯省	Cà Mau
广南省 (越南)	Quang Nam
槟椥省	Ben Tre
庆和省	Khanh Hoa
北宁省	Bac Ninh
优八克	União Internacional de Química Pura e Aplicada
赣语	Chinês gan
海地克里奥耳语	Língua crioula haitiana
大熊猫	Ailuropoda melanoleuca
孤立語言	Língua isolada
卡纳达语	Língua canaresa
杜甫	Du Fu
瓦尔帕莱索	Valparaíso (Chile)
演员	Ator
分类:程序编制言话	Categoria:Linguagens de programação
瓦哈卡	Oaxaca
侗台语	Línguas kradai
白脱	Manteiga
尼亚加拉瀑布	Cataratas do Niágara
吴语	Língua wu
塔斯马尼亚	Tasmânia
贝拉齐尔‧布托	Benazir Bhutto
费利佩二世 (西班牙)	Filipe II de Espanha
牛津大学	Universidade de Oxford
基地 (恐怖组织)	Al-Qaeda
英吉利海峡	Canal da Mancha
柴尔兹孛格	Salzburgo
秦国	Qin (estado)
半岛	Península
新疆維吾爾自治區	Xinjiang
布里司班	Brisbane
东正教	Igreja Ortodoxa
各国首都列表	Lista de capitais nacionais
平面镜	Espelho
锡金语	Língua siquimesa
孛拉特 皮此	Brad Pitt
欧洲足球联合会	União das Federações Europeias de Futebol
美国个州	Estados dos Estados Unidos
议会	Parlamento
大阪市	Osaka (cidade)
剑桥大学	Universidade de Cambridge
牙膏	Creme dental
通货膨胀	Inflação
艾美 羅森	Emmy Rossum
竹	Bambu
刚果	Congo
马失拉地	Maserati
科科斯群岛	Ilhas Cocos (Keeling)
昆士兰州	Queensland
明尼阿波利斯	Minneapolis
顺化市	Huế
马拉雅南语	Língua malaiala
逻辑语	Lojban
北江省	Bac Giang
耶稣会	Companhia de Jesus
承天顺化省	Thua Thien-Hue
北𣴓省	Bac Kan
阿伯丁	Aberdeen
莱州省	Lai Chau
河南省 (越南)	Hà Nam
上海浦东国际机场	Aeroporto Internacional de Xangai Pudong
政治學	Ciência política
闽东语	Língua min oriental
闽南语	Min Nan
安江省	An Giang
茶荣省	Tra Vinh
Tycho Brahe	Tycho Brahe
薄辽省	Bac Lieu
嘉莱省	Gia Lai
平福省	Binh Phuoc
同塔省	Dong Thap
约旦河西岸	Cisjordânia
河江省	Ha Giang
维克多利亚州	Vitória (Austrália)
多乐省	Dac Lac
平定省	Binh Dinh
上海言话	Dialeto xangainês
得农省	Dak Nong
水晶之夜	Noite dos cristais
门	Porta
猪流感	Gripe suína
高平省	Cao Bang
平阳省	Binh Duong
平顺省	Binh Thuan
巴地头顿省	Ba Ria-Vung Tau
奠边省	Dien Bien
三船敏郎	Toshiro Mifune
印度电影观众奖	Filmfare Awards
AK-47	AK-47
孙武	Sun Tzu
国际商用机器公司	IBM
互聯網電影數據庫	Internet Movie Database
贝克特	Samuel Beckett
达赖喇嘛	Dalai Lama
邮政编码	Código postal
Nicole Kidman	Nicole Kidman
联合国安理会	Conselho de Segurança das Nações Unidas
洋火棒儿	Palito de fósforo
雹	Granizo
南海	Mar da China Meridional
肯波拉圣吉奥瓦尼	Campora San Giovanni
朝鮮世宗	Rei Sejong
奥克兰格兰玛学校	Auckland Grammar School
电冰箱	Frigorífico
黄海	Mar Amarelo
大仲马	Alexandre Dumas, pai
孟加拉湾	Golfo de Bengala
哈马斯	Hamas
阿斯旺水坝	Represa de Assuã
人民币	Renminbi
富士山	Monte Fuji
小鼠	Mus
索契	Sóchi
迈克尔·菲尔普斯	Michael Phelps
卡地马党	Kadima
加沙地带	Faixa de Gaza
霍巴特	Hobart
金草莓奖	Framboesa de Ouro
律师	Advogado
相扑	Sumô
希斯·莱杰	Heath Ledger
安徽省	Anhui
内蒙古自治区	Mongólia Interior
金日成	Kim Il-sung
全罗北道	Jeolla do Norte
济州特别自治道	Jeju
郁陵岛	Ulleungdo
湄公河	Rio Mekong
索尼	Sony
巴別塔	Torre de Babel
力学	Mecânica
南半球	Hemisfério sul
蔚山广域市	Ulsan
光州广域市	Gwangju
温室效应	Efeito estufa
Julia Gillard	Julia Gillard
华国锋	Hua Guofeng
福建省	Fujian
克拉耿富合脱	Klagenfurt
小熊猫	Panda-vermelho
大溪地	Taiti
安东市	Andong
海南省	Hainan
汉语拼音	Pīnyīn
远东	Extremo Oriente
西班牙国家足球队	Seleção Espanhola de Futebol
华氏温标	Grau Fahrenheit
海峡群岛	Ilhas do Canal
甘肃省	Gansu
苏州市	Suzhou
无锡市	Wuxi
绍兴市	Shaoxing
汉族	Han (etnia)
宁波市	Ningbo
ETA (民族组织)	Euskadi Ta Askatasuna
隆城国际机场	Aeroporto Internacional Long Thanh
数据	Dados
迪马 皮郎	Dima Bilan
基本粒子	Partícula elementar
陆克文	Kevin Rudd
沙菲娅 劳塔露	Sofia Rotaru
些拉·班琳	Sarah Palin
云南省	Yunnan
苏丹 (称谓)	Sultão
德国国家足球队	Seleção Alemã de Futebol
山东省	Shandong
福楼拜	Gustave Flaubert
英属印度洋领地	Território Britânico do Oceano Índico
地质年代	Escala de tempo geológico
河南省	Henan
乃堂雅虎	Benjamin Netanyahu
护照	Passaporte
遼寧省	Liaoning
件西卡 阿尔白	Jessica Alba
桑•班	Sean Penn
GNOME	GNOME
台湾桃园国际机场	Aeroporto Internacional Chiang Kai-shek
色子	Dado
吉林省	Jilin
东海	Mar da China Oriental
2008年美国总统选举	Eleição presidencial nos Estados Unidos em 2008
阿南德	Viswanathan Anand
湖南省	Hunan
水族馆	Aquário
青海省	Qinghai
柏威夏寺	Templo Hindu de Preah Vihear
豪納省	Ródano (departamento)
金一葉	Kim Il-yeop
陸龜	Testudinidae
話筒	Microfone
山西省	Shanxi
魔方	Cubo de Rubik
尼德兰国家足球队	Seleção Neerlandesa de Futebol
艾西瓦娅·巴克罕	Aishwarya Rai
贵州省	Guizhou
Warren Buffett	Warren Buffett
蹔𧉆	Grilo
纸币	Papel-moeda
加沙城	Gaza
白斯克	País Basco
安达曼海	Mar de Andamão
胡适	Hu Shi
穆斯林	Muçulmano
孛路內 (Blu-Ray)	Disco blu-ray
法国国家足球队	Seleção Francesa de Futebol
宮城县	Miyagi
帕荔斯 希尔顿	Paris Hilton
陕西省	Shaanxi
模板:Commonscat	Predefinição:Commonscat
岩手县	Iwate
死人	Cadáver
莱纳斯·鲍林	Linus Pauling
Patrick Swayze	Patrick Swayze
嫦娥1号	Chang'e 1
純合子	Homozigoto
水彩画	Aguarela
李舜臣	Yi Sun-sin
香港政区	Distritos de Hong Kong
巴黎地铁	Metropolitano de Paris
釜山地铁	Metrô de Busan
清迈	Chiang Mai
对马海峽	Estreito de Tsushima
珍珠港事件	Ataque a Pearl Harbor
分类:化学模板	Categoria:!Predefinições sobre química
模板:Taxobox	Predefinição:Info/Taxonomia
松下电器	Panasonic Corporation
丰田汽车	Toyota Motor
田鸡	Anura
艾奇亚	IKEA
火车站	Estação ferroviária
洛东江	Rio Nakdong
模板:中国历史	Predefinição:História da China
金正恩	Kim Jong-un
豪萨语	Língua haúça
闽语	Línguas min
莆仙语	Língua putian
江西省	Jiangxi
纳姆耶尔·旺楚克 (不丹国王)	Jigme Khesar Namgyal Wangchuck
阮明哲	Nguyễn Minh Triết
宁夏回族自治区	Ningxia
拿督阿都拉萨	Najib Razak
吉格梅·廷礼	Jigme Thinley
约翰·菲利普·凯伊	John Key
扬州市	Yangzhou
泰州	Taizhou (Jiangsu)
南通	Nantong
镇江市	Zhenjiang
常州市	Changzhou
嘉兴市	Jiaxing
迪斯科	Música disco
阉	Castração
老虫	Muroidea
以色列国防军	Forças de Defesa de Israel
嘟嘟車	Tuk-tuk
海蒂·克鲁姆	Heidi Klum
空军	Força aérea
大名	Daimiô
劳莱士表	Rolex
数码照相机	Câmera digital
数词	Numeral
哈里发	Califa
汇率	Taxa de câmbio
青森县	Aomori
福岛县	Fukushima
梁思成	Liang Sicheng
青蛙	Rana (género)
海防市	Haiphong
斯堪的纳维亚半岛	Península Escandinava
里尔克	Rainer Maria Rilke
排列组合	Combinatória
鲍林标度	Eletronegatividade
街道	Rua
Wikipedia:新闻发布	Wikipédia:Notícias
机器翻译	Tradução automática
阿根廷国家足球队	Seleção Argentina de Futebol
千叶县	Chiba
定积分	Integral
故宫	Cidade Proibida
泰米尔猛虎解放组织	Tigres de Liberação do Tamil Eelam
印度卢比	Rupia indiana
Microsoft Outlook	Microsoft Outlook
早饭	Desjejum
自动银行出纳机	Caixa eletrônico
秋田县	Akita
乌克兰元	Grívnia
Ségolène Royal	Ségolène Royal
通用汽车	General Motors
差头	Táxi
乌赛	Região
雷 (天气)	Trovão
尼扎·拉言	Nizar Rayan
拿塔莎 康埔西	Natascha Kampusch
新浪微博	Sina Weibo
模板:Cite book	Predefinição:Citar livro
香农 (计算数学家)	Claude Shannon
宝莱坞	Bollywood
索里亚省	Lista de municípios de Sória
三角函数	Função trigonométrica
2009年甲型H1N1流感疫情	Pandemia de gripe A de 2009
草	Erva daninha
文瑾莹	Moon Geun-young
2004年欧洲足球冠军赛	Campeonato Europeu de Futebol de 2004
严重急性呼吸道综合症	Síndrome respiratória aguda grave
Flickr	Flickr
John C. Mather	John Mather
索尔·珀尔马特	Saul Perlmutter
希腊数字	Numerais gregos
人民力量党 (泰国)	Partido do Poder do Povo
克里米亚鞑靼人	Tártaros da Crimeia
伊斯兰圣战组织 (巴勒斯坦)	Jihad Islâmica
2011年亚洲杯足球比赛入围赛	Eliminatórias para a Copa da Ásia de 2011
爱媛县	Ehime
圣灰星期三	Quarta-feira de cinzas
邻舍	Bairro
沙地	Estepe
鸡窠生凤凰 (电影)	Slumdog Millionaire
浦东新区	Pudong
天坛	Templo do Céu
外滩	Bund (Xangai)
山形县	Yamagata
基呒湖	Lago Kivu
电子工程	Engenharia eletrônica
台湾海峡	Estreito de Taiwan
神奈川县	Kanagawa
中国地区	Região de Chugoku
长野县	Nagano
埼玉县	Saitama
笼	Jaula
英属印度	Índia britânica
法国高速铁路	TGV
Ϝ	Ϝ
群马县	Gunma
Ϙ	Qoopa
Hugh Jackman	Hugh Jackman
兵库县	Hyōgo
2004年东南亚大地震搭海啸	Sismo e tsunami do Oceano Índico de 2004
李准基	Lee Jun Ki
安娜·库妮可娃	Anna Kournikova
天线	Antena
泰国湾	Golfo da Tailândia
2000年欧洲足球冠军赛	Campeonato Europeu de Futebol de 2000
Ϛ	Ϛ
石川县	Ishikawa
妓院	Prostíbulo
国际单位制词头	Prefixo SI
静冈县	Shizuoka
对话	Diálogo
Ͳ	Ͳ
葡蛮郎	Bumerangue
渧拉米酥	Tiramisù
Ϻ	Ϻ
毛巾	Toalha
钱包	Carteira
春节	Ano-novo chinês
麻生太郎	Tarō Asō
无产阶级	Proletariado
弥撒	Missa
Naomi Watts	Naomi Watts
座头鲸	Baleia-jubarte
冈山县	Okayama
赌场	Casino
撒旦教	Satanismo
沙道镇 (泰国)	Sadao
农历	Calendário chinês
克罗地亚国家足球队	Seleção Croata de Futebol
巴尔喀什湖	Lago Balcache
丹尼·波尔	Danny Boyle
泰国旗	Bandeira da Tailândia
希腊国家足球队	Seleção Grega de Futebol
峨眉山	Monte Emei
Zip	ZIP
冰壶	Curling
太湖	Lago Taihu
研究生	Pós-graduação
加蒂诺市 (魁北克)	Gatineau
针	Agulha
加合拉·孛何妮	Carla Bruni
魔幻现实主义	Realismo mágico
潘玉良	Pan Yuliang
义和团	Levante dos boxers
李芙妮	Tzipi Livni
列宁搿拉德围城搭仔保卫战	Cerco a Leninegrado
1988年欧洲足球冠军赛	Campeonato Europeu de Futebol de 1988
皇家夜总会 (电影)	Casino Royale (2006)
薯条	Batata frita
吉赛尔·邦臣	Gisele Bündchen
塔塔拿挪	Tata Nano
特强气旋风暴纳尔吉斯	Ciclone Nargis
2008年希腊街头骚乱	Distúrbios de 2008 na Grécia
半岛战争	Guerra Peninsular
丽水县	Lệ Thủy
锅	Panela
Bipasha Basu	Bipasha Basu
英国电视电影艺术学院奖	British Academy of Film and Television Arts
毛纳洛火山	Mauna Loa
荷兰东印度公司	Companhia Holandesa das Índias Orientais
富牌国际机场	Aeroporto Internacional de Phu Bai
斷背山	O Segredo de Brokeback Mountain
雀巢公司	Nestlé
环球小姐	Miss Universo
ADSL	Asymmetric Digital Subscriber Line
1992年欧洲足球冠军赛	Campeonato Europeu de Futebol de 1992
奥斯区亚国家足球队	Seleção Austríaca de Futebol
伦敦德里城	Derry
新干线	Shinkansen
达新	Thaksin Shinawatra
Olga Kurylenko	Olga Kurylenko
瑞士国家足球队	Seleção Suíça de Futebol
莲姜国际机场	Aeroporto de Lien Khuong
金泳三	Kim Young-sam
星海爭霸	StarCraft
波兰国家足球队	Seleção Polonesa de Futebol
祖父母	Avós
环球影视城	Universal Studios
罗马尼亚国家足球队	Seleção Romena de Futebol
唐宁街10号	10 Downing Street
小仲马	Alexandre Dumas, filho
芹苴机场	Aeroporto de Can Tho
罗杰·科恩伯格	Roger Kornberg
2008年末─2009年初加沙地带大规模军事行动	Operação Chumbo Fundido
利息	Juro
直接民主制	Democracia direta
橡胶擦子	Borracha escolar
幽老猫	Esconde-esconde
萨丽	Sári
1960年欧洲足球国家杯	Campeonato Europeu de Futebol de 1960
几何原本	Os Elementos
数码信号处理	Processamento de sinal
解热镇痛药	Analgésico
木版画	Xilogravura
世界小姐	Miss Mundo
长沙市	Changsha
阿披实	Abhisit Vejjajiva
越南国家航空公司	Vietnam Airlines
伦敦政治经济学院	London School of Economics
油画	Pintura a óleo
达乃 乌同秋克	Danai Udomchoke
Portal:历史	Portal:História
洲际弹道飞弹	Míssil balístico intercontinental
物流	Logística
遗传转录	Transcrição (genética)
繁体字	Chinês tradicional
宦官	Eunuco
虱误	Bug
阿歷克山德拉·柯倫泰	Alexandra Kollontai
George F. Smoot	George Smoot
Ϸ	Ϸ
锡克金庙	Harmandir Sahib
酋长航空公司	Emirates Airlines
1996年欧洲足球冠军赛	Campeonato Europeu de Futebol de 1996
消费者物价指数	Índice de preços no consumidor
国际足球联合会世界排名表	Ranking Mundial da FIFA
卡本塔里亚湾	Golfo de Carpentária
超级市场	Supermercado
章子怡	Zhang Ziyi
Heineken	Heineken
威尔士国家足球队	Seleção Galesa de Futebol
千分比	Por mil
高雄市	Kaohsiung
病人	Paciente
1980年欧洲足球冠军赛	Campeonato Europeu de Futebol de 1980
1968年欧洲足球冠军赛	Campeonato Europeu de Futebol de 1968
1964年欧洲足球国家杯	Campeonato Europeu de Futebol de 1964
印第安纳琼斯 —— 水晶骷髅王国	Indiana Jones e o Reino da Caveira de Cristal
1972年欧洲足球冠军赛	Campeonato Europeu de Futebol de 1972
Bayes定理	Teorema de Bayes
普吉府	Phuket (província)
1984年欧洲足球冠军赛	Campeonato Europeu de Futebol de 1984
亚历山大	Alexandria (desambiguação)
昆明	Kunming
老呒所依	No Country for Old Men (filme)
东京铁塔	Torre de Tóquio
兰州市	Lanzhou
佛來崮	Le Puy-en-Velay
头趟公开募股	Oferta pública inicial
羅迪尼亞	Rodínia
欧里维娅	Olivia Newton-John
Knol	Knol
Ͱ	Ͱ
法国航空447号班机	Voo Air France 447
共享软件	Shareware
简化字	Chinês simplificado
Mike Myers	Mike Myers
薄拉特 (电影)	Borat: Cultural Learnings of America for Make Benefit Glorious Nation of Kazakhstan
張勉	Chang Myon
耳機	Fones de ouvido
利库德党	Likud
洛阳	Luoyang
淞河	Rio Saône
白鳍豚	Lipotes vexillifer
1976年欧洲足球冠军赛	Campeonato Europeu de Futebol de 1976
平昌郡	Pyeongchang
藤球	Sepaktakraw
亚洲开发银行	Banco Asiático de Desenvolvimento
奖学金	Bolsa de estudo
矮马	Pónei
匈奴编年史	Xiongnu
孟子	Mêncio
帝国理工	Imperial College London
卫生	Saúde pública
桂林	Guilin
雪兰莪州	Selangor
海口市	Haikou
海拔	Altitude
挪威广播公司	NRK
第一趟鸦片战争	Primeira Guerra do Ópio
声调	Língua tonal
基督山伯爵	O Conde de Monte Cristo
玛丽女王2号	RMS Queen Mary 2
法国总统	Presidente da França
尹潽善	Yun Bo-seon
伊顿公学	Eton College
越盾	Dong (moeda)
解剖学治疗学及化学分类系统	ATC
尹致昊	Yun Chi-ho
终结者3	Terminator 3: Rise of the Machines
北卡罗莱纳大学教堂山分校	Universidade da Carolina do Norte em Chapel Hill
我有一只梦	Eu Tenho um Sonho
上海世博会	Expo 2010
梦工厂	DreamWorks SKG
谢列梅捷沃国际机场	Aeroporto Moscovo Sheremetievo
瑞联银行	UBS AG
观世音	Avalokiteshvara
新曼谷国际机场	Aeroporto Internacional de Suvarnabhumi
张居正	Zhang Juzheng
郑洁	Zheng Jie
月饼	Bolo lunar
株洲市	Zhuzhou
壯學	Zhuangologia
中国人民解放军	Exército de Libertação Popular
辛格·旺楚克 (不丹国王)	Jigme Singye Wangchuck
利尿药	Diurético
华南虎	Tigre-do-sul-da-china
巴黎大区高速铁路C线	Linha C do RER
精神疾病诊断搭仔统计手冊	Manual Diagnóstico e Estatístico de Transtornos Mentais
米尔克 (电影)	Milk (filme)
高棉帝国	Império Khmer
狙击手	Atirador especial
鼻衄	Epistaxe
开脱•文斯莱脱	Kate Winslet
平均	Média
富国机场	Aeroporto de Phu Quoc
曹操	Cao Cao
火山湖	Lago de cratera
水粉画	Guache
拨人忽视个真相	An Inconvenient Truth
Isaac Hayes	Isaac Hayes
春武里府	Chon Buri (província)
武夷山	Monte Wuyi
塔麻可吉电子小鸡	Tamagotchi
泰王国国歌	Phleng Chat
二氧化氮	Dióxido de nitrogénio
冬至	Solstício de inverno
风月俏佳人	Pretty Woman
新台币	Novo dólar taiwanês
混成词	Palavra-valise
法国省份一览表	Antigas províncias da França
BOINC	BOINC
袁世凯	Yuan Shikai
袋鼠岛	Ilha Kangaroo
泰拉 蕾	Tara Reid
刘翔	Liu Xiang
蒙古人民共和国	República Popular da Mongólia
DTD	Definição de Tipo de Documento
开脱•末斯	Kate Moss
娜塔莎·李察遜	Natasha Richardson
三聚氰胺	Melamina
高隆皮亚国家足球队	Seleção Colombiana de Futebol
莫尼卡-莱温斯基	Monica Lewinsky
雷曼兄弟公司	Lehman Brothers
大使馆	Missão diplomática
喫	Alimentação
金奎植	Kim Kyu-sik
IPod Shuffle	IPod Shuffle
泼水节	Songkran
7-Zip	7-Zip
洋油盏	Lâmpada de querosene
南沙群岛	Ilhas Spratly
湘潭市	Xiangtan
费加罗报 (法国)	Le Figaro
汽车旅馆	Motel
垃圾桶	Lixeira
金刚 (电影)	King Kong
泻药	Laxante
老鼠会	Esquema Ponzi
赌城风云 (电影)	Casino (filme)
学科	Lista de disciplinas acadêmicas
性用品商店	Sex shop
ISO/IEC 8859	ISO 8859
关公	Guan Yu
龟	Testudinata
东方明珠	Torre Pérola Oriental
国际足联世界冠军俱乐部杯赛	Copa do Mundo de Clubes da FIFA
卢旺达旅馆	Hotel Ruanda
重见日头 (1996年电影)	Daylight (filme)
苹果 (消歧义)	Apple (desambiguação)
非洲国家列表	Lista de países e territórios da África
Isla Fisher	Isla Fisher
石泰凡妮 莱斯	Stephanie Rice
印度空间研究组织	Organização Indiana de Pesquisa Espacial
臺灣 (消歧義)	Taiwan (desambiguação)
酱油	Molho de soja
新山	Johor Bahru
Euro	Euro (desambiguação)
MT	MT
国富论	A Riqueza das Nações
清迈府	Chiang Mai (província)
蔡英文	Tsai Ing-wen
宋卡府	Songkhla (província)
平年	Ano comum
玫瑰人生 (2007年电影)	La môme
沙吞府	Satun (província)
清莱府	Chiang Rai (província)
拉廊府	Ranong (província)
披集府	Phichit (província)
We Are the Champions	We Are the Champions
九龙	Kowloon
末尔悬岩	Falésias de Moher
IT狂人	The IT Crowd
北榄坡府	Nakhon Sawan (província)
碧差汶府	Phetchabun (província)
抗心律失常药	Antiarrítmico
陈艳青	Chen Yanqing
2008年欧洲足球冠军赛	Campeonato Europeu de Futebol de 2008
五代十国	Período das Cinco Dinastias e dos Dez Reinos
森理世	Riyo Mori
索马里内战	Guerra Civil da Somália
沙马	Samak Sundaravej
金砖国家	BRICS
安纳乍能府	Amnat Charoen (província)
董里府	Trang (província)
博他仑府	Phatthalung (província)
纳戈尔诺-卡拉巴赫	República do Nagorno-Karabakh
血色将至	There Will Be Blood
乌泰他尼府	Uthai Thani (província)
新北市	Nova Taipé
臺中市	Taichung
他拉嘞共 (维克多利亚)	Traralgon
年号	Nome de era
高丽航空	Air Koryo
环球银行金融电信协会	SWIFT
Motorola	Motorola
欧洲足球冠军赛	Campeonato Europeu de Futebol
汽水	Água gaseificada
三沙市	Sansha
保合多伽勒国家足球队	Seleção Portuguesa de Futebol
车路	Rodovia
苏梅岛	Ko Samui
爱尔兰镑	Libra irlandesa
陈冯富珍	Margaret Chan
中岛美嘉	Mika Nakashima
Lauren Jackson	Lauren Jackson
Prapawadee Jaroenrattanatarakoon	Prapawadee Jaroenrattanatarakoon
邓亚萍	Deng Yaping
里斯班斯 齐凯脱	Lisbeth Trickett
西跋榭滴	Shilpa Shetty
石泰凡妮 孛朗	Stephanie Brown Trafton
Melissa Etheridge	Melissa Etheridge
陈冲	Joan Chen
陈若琳 (运动员)	Chen Ruolin
Jennifer Hawkins	Jennifer Hawkins
Pamela Jelimo	Pamela Jelimo
挪威公主阿斯特丽德	Astrid da Noruega
莱索尔 强斯	Leisel Jones
郭晶晶	Guo Jingjing
陈燮霞	Chen Xiexia
头孢菌素	Cefalosporina
沙没巴干府	Samut Prakan (província)
呵叻府	Nakhon Ratchasima (província)
藏羚羊	Chiru
生个利亚酒	Sangria (bebida)
攀牙府	Phangnga (província)
馅饼统计图	Gráfico de setores
艾管里	Écully
抗酸剂	Antiácido
早稻田大学	Universidade de Waseda
吴 (三国)	Wu Oriental
氯霉素	Cloranfenicol
猜也贲府	Chaiyaphum (província)
计程车3	Taxi 3
英特尔砂桥	Sandy Bridge
马肖·米切姆	Matthew Mitcham
耶莲娜	Jelena Dokić
重组DNA	ADN recombinante
硫酸镁	Sulfato de magnésio
拉喇·杜打	Lara Dutta
汽车租赁	Aluguel de veículos
澳大利亚搭新西兰军团纪念日	Dia ANZAC
ANZ大球场	ANZ Stadium
素拉育	Surayud Chulanont
颂猜·旺沙瓦	Somchai Wongsawat
地帕·漫它	Deepa Mehta
奥特莱•导都	Audrey Tautou
Β－内酰胺类抗生素	Antibiótico betalactâmico
金城武	Takeshi Kaneshiro
周星驰	Stephen Chow
WHO	Who (Unix)
多尼尔228	Dornier Do 228
孙权	Sun Quan
蒋经国	Chiang Ching-kuo
墨尔本胜利	Melbourne Victory Football Club
纳维语	Língua na'vi
Al Burj大厦 (迪拜)	Nakheel Tower
神舟七号飞船	Shenzhou 7
鬼勒耳朵边头讲	Ghost Whisperer
Grant George Hackett	Grant Hackett
松浦晃一郎	Koichirō Matsuura
茄特 艾勒麦勒	Gad Elmaleh
韩愈	Han Yu
梁朝伟	Tony Leung Chiu-Wai
丁俊晖	Ding Junhui
澳大利亚总理	Primeiro-ministro da Austrália
王安石	Wang Anshi
投资银行	Banco de investimento
徐載弼	Philip Jaisohn
巴真府	Prachin Buri (província)
精工表	Seiko
杭州灣大橋	Ponte da Baía de Hangzhou
武里喃府	Buri Ram (província)
坤敬府	Khon Kaen (província)
德国无线通信	T-Mobile
廊开府	Nong Khai (província)
日本中央银行	Banco do Japão
Raja Ravi Varma	Ravi Varma
李自成	Li Zicheng
哈桑式火箭弹	Foguete Qassam
林语堂	Lin Yutang
朴憲永	Pak Hon-Yeong
金枓捧	Kim Du-bong
龙仔厝府	Samut Sakhon (província)
信武里府	Sing Buri (província)
武昌起义	Levantamento de Wuchang
同心隆安足球俱乐部	Dong Tam Long An FC
教堂山	Chapel Hill
阿德来德联队	Adelaide United Football Club
芜湖市	Wuhu
安庆市	Anqing
佛历	Calendário budista
银河处女	Virgin Galactic
2007年加沙地带争夺战	Batalha de Gaza (2007)
拗廊 (泰国)	Ao Nang
新兴工业国家	Países recentemente industrializados
李鸿章	Li Hongzhang
中秋节	Festival da Lua
元均	Won Kyun
浅野忠信	Tadanobu Asano
炳·廷素拉暖	Prem Tinsulanonda
以蒙 苏里房	Eamon Sullivan
雷锋	Lei Feng
多尔衮	Dorgon
素可泰府	Sukhothai (província)
彭德怀	Peng Dehuai
依善	Região Nordeste (Tailândia)
紫峰大厦	Nanjing Greenland Financial Center
姚文元	Yao Wenyuan
斯瓦特县	Swat (Paquistão)
悉尼晨锋报	The Sydney Morning Herald
The quick brown fox jumps over the lazy dog	The quick brown fox jumps over the lazy dog
金牌	Medalha de ouro
亚洲航空	AirAsia
台南	Tainan
秋叶原	Akihabara
徐光启	Xu Guangqi
强心苷	Cardioglicosídeo
SDS	Dodecil sulfato de sódio
大环内酯类抗生素	Macrólido
恒生指数	Hang Seng Index
喹诺酮	Quinolona
Моа	Moa
掸邦	Shan (estado)
1976年河北唐山大地震	Sismo de Tangshan de 1976
上海地铁	Metrô de Xangai
以色列空军	Força Aérea Israelense
玩转身前事	The Bucket List
秋瑾	Qiu Jin
崇礼门	Namdaemun
嫦娥	Chang'e
羅蕙錫	Na Hye-sok
迪温·布朗	Divine Brown
Liudmila Blonska	Lyudmila Blonska
孙休	Jing de Wu
許政	Heo Jeong
孙皓	Modi
孙亮	Feidi
宋吉 (拳手)	Somjit Jongjohor
滑水	Esqui aquático
泰国人	Tais
國際馬術聯合會	Federação Eqüestre Internacional
新山一国际机场	Aeroporto Internacional Tan Son Nhat
宏碁电脑	Acer (empresa)
运动场	Estádio
朝鲜半岛	Península da Coreia
圣保罗地铁	Metrô de São Paulo
亚运会	Jogos Asiáticos
捷克国家足球队	Seleção Tcheca de Futebol
朝鲜族	Coreanos
吕克·贝松	Luc Besson
俞吉濬	Yu Kil-chun
Tesco	Tesco
傲游浏览器	Maxthon
供应链管理	Gestão da cadeia de suprimentos
仁川地铁	Metrô de Incheon
朴重陽	Park Jung-yang
六方会谈	Diálogo a Seis
奶粉	Leite em pó
班地戈 (维克多利亚)	Bendigo
朝鲜核问题	Programa nuclear norte-coreano
韩国放送公社	Korean Broadcasting System
莎阿南	Shah Alam
玉山	Yu Shan
西湖	Lago do Oeste
澳大利亚日	Dia da Austrália
大屿山	Lantau
60秒惊天动地	60 Segundos
伊斯兰祈愿团	Jemaah Islamiyah
Andry Laffita	Andry Laffita
德文语法	Gramática da língua alemã
输入法	Input Method Editor
托忒蒙古文	Todo bitchig
卡卡	Kaká
南印度	Índia do Sul
许冠杰	Sam Hui
视力	Acuidade visual
星期四岛	Ilha Thursday
蒙古简介	Planalto Mongol
巴彦淖尔	Bayan Nur
抗高血压药	Anti-hipertensivo
抗真菌药	Antimicótico
意大利杂菜汤	Minestrone
算筹	Sistema numérico de varas
咳嗽药	Antitússico
海峡两岸关系	Relações entre China e Taiwan
琅琴表	Longines
奠边府战役	Batalha de Dien Bien Phu
窝同搿 (维克多利亚)	Wodonga
List of Thailand cities	Lista de cidades na Tailândia
水 (2005年电影)	Water
西非国家中央银行	Banco Central dos Estados da África Ocidental
依夫城堡	Castelo de If
皮蛋	Ovo centenário
庐山	Monte Lu
必和必拓矿业公司	BHP Billiton
零假设	Hipótese nula
电脑语言	Linguagem de computador
世纪报	The Age
布鲁塞尔皇宫	Palácio Real de Bruxelas
饺子	Guioza
山猜 拉蒂伐塔娜	Sanchai Ratiwatana
乃米湖	Lago Nemi
维杰式坦克 (印度)	Vijayanta
广州地铁	Metrô de Guangzhou
性旅游者	Turismo sexual
卡里平	Caribe
教堂山 (北卡罗来纳州)	Chapel Hill (Carolina do Norte)
启德机场	Aeroporto Internacional Kai Tak
昆剧	Ópera de Kunqu
意大利国家足球队	Seleção Italiana de Futebol
国际先驱论坛报	International New York Times
流亡政府	Governo no exílio
发声态	Fonação
中文数字大写	Numeração chinesa
南京大學	Universidade de Nanquim
輔仁大學	Universidade Católica Fu Jen
快门	Obturador
Shooting Dogs	Tiros em Ruanda
金刚	Vajra
谥号	Nome póstumo
杭州湾	Baía de Hangzhou
魏忠贤	Wei Zhongxian
市区	Zona urbana
网球王子	The Prince of Tennis
段祺瑞	Duan Qirui
中法战争	Guerra Sino-Francesa
庙号	Nome de templo
潘迪华	Rebecca Pan
台湾问题	Estatuto da República da China
溫州話	Dialeto wenzhou
西德	Alemanha Ocidental
蔡卓妍	Charlene Choi
亚洲国家列表	Lista de Estados soberanos e territórios dependentes da Ásia
春卷	Rolinhos-primavera
中子彈	Bomba de nêutrons
澳大利亚电信公司	Telstra
上海申花足球俱乐部	Shanghaï Greenland
俄罗斯国家足球队	Seleção Russa de Futebol
计程车(1998年电影)	Taxi (filme de 1998)
XUL	XUL
蓝天处女	Virgin Blue
現代標準漢語	Mandarim padrão
赛义德·西扬姆	Said Siyam
宋恰脱 拉蒂伐塔娜	Sonchat Ratiwatana
中国国家图书馆	Biblioteca Nacional da China
大漠孤雄 (电影)	Mongol (filme)
墨尔本机场。	Aeroporto de Melbourne
西昌卫星发射中心	Centro Espacial de Xichang
巴黎大区高速铁路A线	Linha A do RER
泰国人妖	Kathoey
丢勒个犀牛	Rinoceronte de Dürer
泰国北部	Região Norte (Tailândia)
凯山丰威汉市	Savannakhet
高分子化学	Química dos polímeros
克里米亚共和国	Crimeia
计程车2	Taxi 2
计程车4	Taxi 4
岘港国际机场	Aeroporto Internacional de Da Nang
国王岛	Ilha King
宋卡市	Songkhla
巴卡西半岛	Bakassi
应召女郎	Garota de programa
赤壁(2008年电影)	A Batalha dos 3 Reinos
黑人	Negros
普腾汽车	Proton (automóvel)
码头	Ancoradouro
金磚四國	BRIC
富通银行	Fortis (empresa)
远古侵略	Primeval
Schweppes	Schweppes
东突厥斯坦	Turquestão Oriental
內排国际机场	Aeroporto Internacional de Noi Bai
普吉市	Phuket (cidade)
F-15雷暴式战斗机	F-15E Strike Eagle
抗病毒药	Antiviral
國際語音學學會	Associação Fonética Internacional
闽东语维基百科	Wikipédia em min oriental
银牌	Medalha de prata
阿嘞白拿湖	Lago Albano
冠军	Campeão
越捷航空	VietJet Air
巴乃到乃	Panetone
拉玛九世	Bhumibol Adulyadej
外国口音综合症	Síndrome do sotaque estrangeiro
嫦娥工程	Programa Chinês de Exploração Lunar
科索沃宣布独立事件（2008年）	Independência do Kosovo
东南亚国家杯足球比赛	Copa AFF Suzuki
苏丹航空公司	Sudan Airways
阴蒂	Clítoris
三清山	Monte Sanqingshan
铜牌	Medalha de bronze
胡志明纪念堂	Mausoléu de Ho Chi Minh
性奴隶	Escravidão sexual
坤敬市	Khon Kaen
粥	Congee
孛拉尼城堡	Castelo de Blarney
孛拉先拿湖	Lago de Bracciano
金瓯机场	Aeroporto de Ca Mau
Debian自由软件指导方针	Debian Free Software Guidelines
外蒙古	Mongólia Exterior
挥发性有机化合物	Composto orgânico volátil
2009年以色列国会大选	Eleições legislativas em Israel em 2009
吴国	Wu (estado)
南美洲国家列表	Lista de países da América do Sul
苏州地铁	Metropolitano de Suzhou
帮助:目录	Ajuda:Página principal
Wikipedia:Tutorial	Ajuda:Tutorial
澳洲电信大球场	Docklands Stadium
澎湖列岛	Ilhas Pescadores
中国画	Pintura da China
澳大利亚国家气象局	Bureau of Meteorology
支气管扩张剂	Broncodilatador
弗林德斯岛 (塔斯曼尼亚)	Ilha Flinders
泰国王家军队	Forças Armadas da Tailândia
阿根廷，勿要为奴哭泣	Don't Cry for Me, Argentina
福布斯	Forbes
塔斯马尼亚州立大学	Universidade da Tasmânia
上海迪斯尼	Shanghai Disney Resort
猜也奔	Chaiyaphum
草原	Pradaria
金球奖	Prêmios Globo de Ouro
比拉伊	Piraí
江阴	Jiangyin
佩蒂翁维尔学校倒塌事故	Desabamento da escola La Promesse Evangelique em 2008
琼山	Chengmai
麻鷹队 (澳式足球)	Hawthorn Football Club
龙虾	Nephropidae
澳大利亚小姐	Miss Austrália
大报恩寺（南京）	Torre de Porcelana de Nanquim
O'Reilly Media	O'Reilly Media
泰国南部	Região Sul (Tailândia)
越南南方共和国	República do Vietname do Sul
百万富豪	Milionário
Club Méd	Club Méditerranée
河西省	Ha Tay
AV女优	AV idol
手写体	Letra cursiva
宋慧教	Song Hye-kyo
吴语维基百科	Wikipédia em chinês wu
迪拜大商场	Dubai Mall
婚礼歌手	The Wedding Singer
异食癖	Pica (transtorno)
本田爵士 (汽车)	Honda Jazz
巩金瓯	Gong Jin'ou
澳大利亚邮政局	Australia Post
大中华地区	Grande China
科廷科技大学	Universidade Curtin
子思	Zisi
1931年个江淮大水	Inundações na China de 1931
陕西历史博物馆	Museu Histórico de Shaanxi
愛科蘭舞	Futari wa Pretty Cure
阿含经	Agama (budismo)
侬	Você
法国人口	Demografia da França
梅林	Merlin (telessérie)
普拉部地伐 (演员)	Prabhu Deva
粤文维基百科	Wikipédia em cantonês
东亚运动会	Jogos da Ásia Oriental
杭州萧山国际机场	Aeroporto Internacional de Hangzhou Xiaoxan
泰国个佛教	Budismo na Tailândia
泰国国立法政大学	Universidade Thammasat
九龙半岛	Península de Kowloon
机场	Aeroporto
世界大桥长度排名	Lista das pontes mais extensas do mundo
男妓	Prostituição masculina
土星运载火箭	Saturno (família de foguetes)
泰叻报	Thai Rath
泰国人民反独裁民主联盟	Frente Unida para a Democracia contra a Ditadura
寶貝計劃	Bo bui gai wak
汉服	Hanfu
中山陵	Mausoléu de Sun Yat-sen
巴黎大区高速铁路B线	Linha B do RER
富劳里友半岛	Península de Fleurieu
Wikipedia:维基大典	Wikipédia em chinês clássico
凡合乃从	Vernaison
法朗 (泰语)	Farang
Simon Crean	Simon Crean
空堤区 (曼谷)	Khlong Toei
分类:德国	Categoria:Alemanha
分类:意大利	Categoria:Itália
分类:美国	Categoria:Estados Unidos
分类:俄罗斯	Categoria:Rússia
分类:英国	Categoria:Reino Unido
分类:西班牙	Categoria:Espanha
分类:中国	Categoria:China
分类:日本	Categoria:Japão
分类:澳大利亚	Categoria:Austrália
分类:墨西哥	Categoria:México
分类:印度	Categoria:Índia
分类:阿根廷	Categoria:Argentina
毛宁吞半岛	Península de Mornington
火•1996 (电影)	Fire (filme)
富国国际机场	Aeroporto Internacional Phu Quoc
巴黎大区高速铁路D线	Linha D do RER
黄塔寺	Wat Chedi Luang
分类:印度尼西亚	Categoria:Indonésia
分类:乃特朗特	Categoria:Países Baixos
分类:新加坡	Categoria:Singapura
分类:韩国	Categoria:Coreia do Sul
分类:泰国	Categoria:Tailândia
分类:越南	Categoria:Vietname
分类:哺乳动物	Categoria:Mamíferos
分类:植物	Categoria:Plantas
分类:物理	Categoria:Física
分类:生物学	Categoria:Biologia
分类:化学	Categoria:Química
分类:历史	Categoria:História
分类:地理	Categoria:Geografia
分类:社会	Categoria:Sociedade
分类:宗教	Categoria:Religião
分类:体育运动	Categoria:Desportos
分类:科学	Categoria:Ciência
分类:电影	Categoria:Cinema
分类:建筑物	Categoria:Construções
澳洲人报	The Australian
拉脱卜大学	Universidade La Trobe
中国宗教	Religião na China
IPCC第4趟评价报告书	Quarto Relatório de Avaliação do Painel Intergovernamental sobre Mudanças Climáticas
国际规则足球	Futebol de regras internacionais
澳大利亚国家档案库	National Archives of Australia
Newsarama	Newsarama
涂改液	Corretivo líquido
神舟十号	Shenzhou 10
巴士底獄	Bastilha
泰国足球联赛	Campeonato Tailandês de Futebol
官恩娜	Ella Koon
隆汉湖 (泰国)	Lago Nong Han
美马宽子	Hiroko Mima
生肖	Horóscopo chinês
中国人口	Demografia da República Popular da China
分类:消歧义	Categoria:Desambiguação
分类:佛教	Categoria:Budismo
分类:基督教	Categoria:Cristianismo
分类:伊斯兰教	Categoria:Islamismo
包恩滴 娜去隆佳诺克	Porntip Nakhirunkanok
华东师范大学	East China Normal University
运动员	Atleta
澳大利亚人口	Demografia da Austrália
Poise	Poise
十月围城	Bodyguards & Assassins
吴	Wu
女阴	Vulva
麦乳精	Leite maltado
2009年新年伊卜拉欣·亚嘞·马卡得纳清真寺拔轰炸	Ataque contra a mesquita Ibrahim al-Maqadna em 2009
Teratai Prima	MV Teratai Prima
容祖儿	Joey Yung
国民报 (泰国)	The Nation (Tailândia)
麦西·芒芝	Maxi Mounds
Bochotnica	Bochotnica
堤岸 (越南)	Cholon
隆宾尼拳场	Lumpinee Boxing Stadium
剑桥高级英语证书	Certificate in Advanced English
威廉·艾米斯	Willie Aames
抗心绞痛药	Antianginoso
Comme si de rien n'était (专辑)	Comme si de rien n'était
斯维斯(Switzerland) 勒欧罗维竞唱歌比赛表现:年份 2008	Suíça no Festival Eurovisão da Canção 2008
选美	Concurso de beleza
卡滴二	Louis Cartier
醒来、才好对面真相。。。 （电影歌曲）	I Need to Wake Up
分类:未完个文章	Categoria:!Esboços
分类:维基百科分类	Categoria:!Categorização da Wikipedia
分类:维基百科管理	Categoria:!Administração da Wikipédia
分类:文化	Categoria:Cultura
分类:大洲	Categoria:Continentes
分类:地质学	Categoria:Geologia
泰国每日新闻	Daily News (Tailândia)
Wikipedia:Selected anniversaries	Wikipédia:Efemérides
嘛莎 (泰国)	Masha Wattanapanich
Wikipedia:命名常规	Wikipédia:Convenção de nomenclatura
剃刀	Barbeador
闽南语维基百科	Wikipédia em min nan
Portal:地理	Portal:Geografia
TAFE	Technical and Further Education
可口可乐公司	The Coca-Cola Company
吴越地区	Wu (região)
谢婷婷	Jennifer Tse
壮语维基百科	Wikipédia em zhuang
Wikipedia:Transclusion	Wikipédia:Transclusão
Wikipedia:HotCat	Wikipédia:Scripts/HotCat
高棉语维基百科	Wikipédia em khmer
计算数学	Matemática computacional
分类:维基百科机器人	Categoria:!Robôs
Portal:艺术	Portal:Arte
分类:美国人	Categoria:Estado-unidenses
分类:演员	Categoria:Atores
分类:英国人	Categoria:Britânicos
分类:法国人	Categoria:Franceses
模板:Tl	Predefinição:Ligação para predefinição
模板:Userbox	Predefinição:Userbox
模板:Wikipedialang	Predefinição:Wikipédia em outras línguas
模板:Itn	Predefinição:Eventos atuais
Wikipedia:问题	Wikipédia:Tire suas dúvidas
分类:自由软件	Categoria:Software livre
分类:国家	Categoria:Países
Wikipedia:Changing username	Wikipédia:Renomeação de conta
Wikipedia:管理员	Wikipédia:Administradores
模板:Sport-stub	Predefinição:Esboço-desporto
分类:人物	Categoria:Pessoas
分类:职业	Categoria:Ocupações
分类:各行各业个人	Categoria:Pessoas por ocupação
Wikipedia:机器人	Wikipédia:Robôs
分类:货币	Categoria:Dinheiro
分类:工程學	Categoria:Engenharia
Wikipedia:100个核心页面	Wikipédia:Lista dos artigos que toda Wikipédia deve ter/Nível 2
Wikipedia:AutoWikiBrowser	Wikipédia:AutoWikiBrowser
分类:医学	Categoria:Medicina
分类:政治	Categoria:Política
分类:教育	Categoria:Educação
分类:光学	Categoria:Óptica
分类:艺术	Categoria:Arte
埃及	Egito
Wikipedia:手傀儡	Wikipédia:Sock puppet
Wikipedia:Categorization	Wikipédia:Categoria
模板:Bot	Predefinição:Robô
加拿大	Canadá
分类:倍尔奇姆	Categoria:Bélgica
分类:捷克	Categoria:República Checa
Wikipedia:版权	Wikipédia:Direitos de autor
Wikipedia:关于	Wikipédia:Sobre a Wikipédia
分类:电子游戏	Categoria:Jogos eletrônicos
分类:游戏	Categoria:Jogos
工业工程	Engenharia industrial
帮助:編輯摘要	Ajuda:Guia de edição/Menus e ferramentas/Sumário de edição
Portal:科学	Portal:Ciência
模板:Flagicon	Predefinição:ÍconeBandeira
分类:欧洲国家	Categoria:Países da Europa
分类:欧洲	Categoria:Europa
Wikipedia:Subpages	Wikipédia:Subpágina
Wikipedia:近段辰光个事体	Portal:Eventos atuais
模板:Documentation	Predefinição:Documentação
Wikipedia:User access levels	Wikipédia:Usuários
分类:已保护页面	Categoria:!Páginas protegidas
Wikipedia:聊天频道	Wikipédia:Chat
分类:维基人	Categoria:!Wikipedistas
Wikipedia:社区门堂	Wikipédia:Portal comunitário
分类:User by languages	Categoria:!Wikipedistas por idioma
帮助:用词指南	Wikipédia:Por favor seja claro
成在基	Sung Jae-ki
模板:Soft redirect	Predefinição:Pseudorredirecionamento
模板:Delete	Predefinição:ER
分类:维基百科版权	Categoria:!Direitos de autor
分类:技术	Categoria:Tecnologia
卫星天线	Antena parabólica
分类:言话	Categoria:Línguas
分类:历法	Categoria:Calendários
分类:维基百科	Categoria:Wikipédia
分类:各样言话个维基百科	Categoria:Versões da Wikipédia
分类:朆索引个页	Categoria:!Páginas não indexadas
分类:有无用文件链接个页	Categoria:!Páginas com ficheiros inexistentes
Wikipedia:模板消息	Wikipédia:Lista de predefinições
分类:現在正發生個事體	Categoria:Eventos atuais
分类:欧洲城市	Categoria:Cidades da Europa
Wikipedia:維基休息	Wikipédia:WikiPausa
模板:Navbox	Predefinição:Navbox
模板:Fact	Predefinição:Carece de fontes
分类:重定向	Categoria:!Redirecionamentos
分类:維基百科維護	Categoria:!Manutenção
分类:泰国网球运动员	Categoria:Tenistas da Tailândia
寺	Templo budista
模板:Error	Predefinição:Erro
模板:((	Predefinição:Chaves-abre
模板:))	Predefinição:Chaves-fecha
模板:!!	Predefinição:!!
模板:=	Predefinição:=
模板:Tnavbar	Predefinição:Tnavbar
模板:Code	Predefinição:Código
模板:0	Predefinição:0
模板:Unicode	Predefinição:Unicode
模板:Transclude	Predefinição:Transclude
模板:Small	Predefinição:Pequeno
模板:Clear	Predefinição:Limpar
模板:Col-break	Predefinição:Col-break
模板:Col-begin	Predefinição:Col-begin
模板:Nowrap	Predefinição:Nowrap
模板:Bots	Predefinição:Bots
Wikipedia:必有个页面	Wikipédia:Artigos essenciais
分类:非洲	Categoria:África
分类:數字	Categoria:Números
分类:电子学	Categoria:Eletrônica
分类:书	Categoria:Livros
模板:Wikisource	Predefinição:Wikisource
模板:Babel	Predefinição:Babel
模板:Commons	Predefinição:Commons
模板:Link GA	Predefinição:Bom interwiki
模板:Reflist	Predefinição:Referências
模板:AFG	Predefinição:AFG
Wikipedia:列明來源	Wikipédia:Livro de estilo/Cite as fontes
模板:Stub	Predefinição:Esboço
模板:See also	Predefinição:VT
模板:User de	Predefinição:User de
模板:User de-1	Predefinição:User de-1
模板:User es	Predefinição:User es
模板:User de-3	Predefinição:User de-3
模板:User en-3	Predefinição:User en-3
模板:User en-1	Predefinição:User en-1
模板:User en-2	Predefinição:User en-2
模板:User en-4	Predefinição:User en-4
模板:User en	Predefinição:User en
模板:User de-2	Predefinição:User de-2
模板:User es-1	Predefinição:User es-1
模板:User fa	Predefinição:User fa
模板:User fr-1	Predefinição:User fr-1
分类:各国个文化	Categoria:Cultura por país
分类:物质	Categoria:Matéria
模板:User sk	Predefinição:User sk
模板:User fr-2	Predefinição:User fr-2
模板:User ja	Predefinição:User ja
模板:User ja-1	Predefinição:User ja-1
模板:User it-1	Predefinição:User it-1
模板:User fr	Predefinição:User fr
模板:Unsigned	Predefinição:Não assinou
模板:HRV	Predefinição:HRV
分类:亚洲	Categoria:Ásia
分类:智利	Categoria:Chile
分类:21世紀	Categoria:Século XXI
分类:User uk	Categoria:Usuários uk
分类:南美洲	Categoria:América do Sul
分类:User uk-N	Categoria:Usuário uk
模板:Intricate template	Predefinição:Predefinição complexa
分类:马来西亚	Categoria:Malásia
分类:食物	Categoria:Alimentos
分类:足球	Categoria:Futebol
模板:Mod	Predefinição:Mod
模板:User uk	Predefinição:User uk
模板:User es-2	Predefinição:User es-2
模板:WikipediaSister	Predefinição:Projetos correlatos
模板:USA	Predefinição:USA
分类:年历	Categoria:Almanaques
分类:组织	Categoria:Organizações
分类:语言学	Categoria:Linguística
模板:ITA	Predefinição:ITA
模板:GEO	Predefinição:GEO
模板:BOL	Predefinição:BOL
分类:鏈接模板	Categoria:!Predefinições sobre links
模板:MEX	Predefinição:MEX
分类:User fr-1	Categoria:Usuário fr-1
模板:Wikiquote	Predefinição:Wikiquote
模板:Image label	Predefinição:Image label
模板:Category handler	Predefinição:Cat handler
模板:Translated page	Predefinição:Traduzido
模板:MAR	Predefinição:MAR
模板:Ja icon	Predefinição:((ja))
模板:Korea-stub	Predefinição:Esboço-Coreia
模板:PSE	Predefinição:PSE
模板:Sidebar	Predefinição:Sidebar
模板:Es icon	Predefinição:((es))
模板:Ambox	Predefinição:Ambox
模板:Update	Predefinição:Desatualizado
模板:SVK	Predefinição:SVK
模板:TWN	Predefinição:TWN
模板:EGY	Predefinição:EGY
模板:Quotation	Predefinição:Quotation
模板:KGZ	Predefinição:KGZ
模板:Infobox School	Predefinição:Info/Escola
模板:ISR	Predefinição:ISR
模板:Nobel Prize in Physics	Predefinição:Nobel de Física
模板:Infobox Country	Predefinição:Info/País
模板:Column-count	Predefinição:Column-count
模板:VEN	Predefinição:VEN
模板:Airline infobox	Predefinição:Info/Companhia aérea
模板:Wide image	Predefinição:Panorama
模板:UKR	Predefinição:UKR
模板:Px	Predefinição:Px
模板:好哉	Predefinição:Feito
模板:Documentation/docname	Predefinição:Documentação/nomedoc
模板:Audio	Predefinição:Áudio
模板:Flatlist	Predefinição:Lista horizontal
模板:PHL	Predefinição:PHL
模板:ROU	Predefinição:ROU
模板:BHR	Predefinição:BHR
分类:欧洲国家足球队	Categoria:Seleções nacionais de futebol da Europa
模板:Endflatlist	Predefinição:Endflatlist
模板:TUR	Predefinição:TUR
模板:Expand section	Predefinição:Expandir
模板:Tmbox	Predefinição:Tmbox
模板:清理	Predefinição:Reciclagem
模板:DJI	Predefinição:DJI
模板:Infobox university	Predefinição:Info/Universidade
模板:BRN	Predefinição:BRN
模板:Wikibooks	Predefinição:Wikilivros
模板:Hatnote	Predefinição:Dablink
模板:S-after	Predefinição:S-aft
分类:巴黎	Categoria:Paris
分类:User en-4	Categoria:Utilizador en-4
分类:User en	Categoria:Usuários en
分类:User zh	Categoria:Usuários zh
分类:User zh-N	Categoria:Usuário zh
分类:User en-2	Categoria:Usuário en-2
模板:Infobox	Predefinição:Info
模板:Right TOC	Predefinição:TOC-direita
模板:Main other	Predefinição:Artigos e outros
模板:User zh	Predefinição:User zh
模板:Template other	Predefinição:Template other
模板:Legend	Predefinição:Legenda
模板:Cite web	Predefinição:Citar web
模板:Youtube	Predefinição:Youtube
模板:Current	Predefinição:Evento atual
分类:軍事裝備	Categoria:Equipamento militar
模板:Infobox WS	Predefinição:Info/Sistema de escrita
模板:Ombox	Predefinição:Ombox
模板:IMDb title	Predefinição:IMDb título
模板:国际足球	Predefinição:Futebol Internacional
模板:User ru-4	Predefinição:User ru-4
分类:饮食	Categoria:Alimentação
模板:Coor URL	Predefinição:Coor URL
模板:Wiktionary	Predefinição:Wikcionário
模板:Mbox templates	Predefinição:Mbox templates
薄拉特	Borat
模板:Multi-listen start	Predefinição:Multi-escuta início
模板:Languageicon	Predefinição:Languageicon
分类:英国个博物馆	Categoria:Museus do Reino Unido
模板:大韩民国行政区划	Predefinição:Coreia do Sul
Wikipedia:Selected anniversaries/October 3	Wikipédia:Efemérides/3 de outubro
分类:总统	Categoria:Presidentes
模板:User ru	Predefinição:User ru
分类:20世紀	Categoria:Século XX
模板:IPA	Predefinição:AFI
分类:美洲	Categoria:América
模板:Otheruses	Predefinição:Ver desambig
分类:各国个人	Categoria:Pessoas por nacionalidade
模板:Imbox	Predefinição:Imbox
模板:Rellink	Predefinição:Rellink
模板:Did you know	Predefinição:Sabia que
模板:MONTHNAME	Predefinição:MONTHNAME
Wikipedia:GNU自由文档许可证文本	Wikipédia:GNU Free Documentation License
模板:CPV	Predefinição:CPV
模板:Infobox Model	Predefinição:Info/Modelo
模板:MONTHNUMBER	Predefinição:MONTHNUMBER
分类:人物小作品	Categoria:!Esboços de biografias
模板:Top icon	Predefinição:Top icon
模板:Namespace detect	Predefinição:Namespace detect
模板:Fmbox	Predefinição:Fmbox
分类:作家	Categoria:Escritores
分类:軍事	Categoria:Tópicos militares
分类:大学	Categoria:Universidades
模板:Hidden begin	Predefinição:Hidden begin
模板:Talkback	Predefinição:Resposta
模板:MYS	Predefinição:MYS
模板:TJK	Predefinição:TJK
模板:Infobox Website	Predefinição:Info/Sítio
模板:Image label end	Predefinição:Image label end
模板:Documentation subpage	Predefinição:Subpágina de documentação
模板:Winners	Predefinição:Winners
模板:Ref label	Predefinição:Ref label
模板:GHA	Predefinição:GHA
模板:GMB	Predefinição:GMB
模板:Uncategorized	Predefinição:Sem cat
模板:IDN	Predefinição:IDN
模板:FRO	Predefinição:FRO
模板:ZAF	Predefinição:ZAF
模板:POL	Predefinição:POL
模板:Oldid	Predefinição:Oldid
模板:URY	Predefinição:URY
模板:CUB	Predefinição:CUB
模板:CMR	Predefinição:CMR
模板:BIH	Predefinição:BIH
模板:FIN	Predefinição:FIN
模板:Tlx	Predefinição:Tlx
模板:CAN	Predefinição:CAN
模板:Purge	Predefinição:Purgar
模板:DNK	Predefinição:DNK
模板:Empty category	Predefinição:Categoria vazia
模板:Infobox Cyrillic	Predefinição:Alfabeto cirílico
模板:Dead link	Predefinição:Ligação inativa
模板:Provinces of China	Predefinição:Subdivisões da República Popular da China
模板:SAU	Predefinição:SAU
模板:Userpage	Predefinição:Página de usuário
模板:DEU	Predefinição:DEU
模板:BEN	Predefinição:BEN
模板:CIS	Predefinição:Comunidade dos Estados Independentes
模板:SWE	Predefinição:SWE
模板:Note label	Predefinição:Note label
分类:中国个建筑	Categoria:Arquitetura da China
模板:User	Predefinição:Usuário2
模板:YEM	Predefinição:YEM
模板:Spoken Wikipedia	Predefinição:Wikipédia audível
模板:Lorem ipsum	Predefinição:Lorem ipsum
分类:中学	Categoria:Instituições de ensino médio
模板:YearTOC	Predefinição:Cabeçalho dos anos
分类:越南机场	Categoria:Aeroportos do Vietname
模板:Note	Predefinição:Nota
分类:公司	Categoria:Empresas
模板:Footballbox	Predefinição:Footballbox
模板:Renameuser	Predefinição:Renomear
模板:Image label small	Predefinição:Image label small
模板:Iaaf name	Predefinição:IAAF name
模板:欧洲和海	Predefinição:Mapa detalhado da Europa
模板:瑞士城市	Predefinição:Info/Comuna da Suíça
模板:Japanese	Predefinição:Japonês
模板:User fr-3	Predefinição:User fr-3
模板:UEFA	Predefinição:Eurocopa
模板:Infobox Military Unit	Predefinição:Info/Unidade Militar
模板:美国地图含州名	Predefinição:USA imagemap with state names small
模板:IMDb name	Predefinição:Imdb nome
模板:Ar icon	Predefinição:Ar
模板:ABW	Predefinição:ABW
分类:突尼斯	Categoria:Tunísia
模板:Th	Predefinição:((th))
模板:S-title	Predefinição:S-ttl
分类:泰国个寺庙	Categoria:Templos budistas da Tailândia
模板:JPN	Predefinição:JPN
分类:韩国电视	Categoria:Televisão da Coreia do Sul
模板:Japan	Predefinição:Regiões e divisões administrativas do Japão
模板:China-stub	Predefinição:Esboço-China
模板:Cmbox	Predefinição:Cmbox
模板:CSS IPA vowel chart	Predefinição:IPA tabela de vogais
模板:PAN	Predefinição:PAN
模板:SOM	Predefinição:SOM
模板:SWZ	Predefinição:SWZ
模板:Infobox Spacecraft	Predefinição:Info/Nave espacial
模板:PAK	Predefinição:PAK
模板:User nds-1	Predefinição:User nds-1
模板:S-before	Predefinição:S-bef
分类:日本行政区划	Categoria:Subdivisões do Japão
模板:Mbox	Predefinição:Mbox
模板:ISL	Predefinição:ISL
模板:Oppose	Predefinição:Discordo
模板:COL	Predefinição:COL
模板:CCK	Predefinição:CCK
模板:ERI	Predefinição:ERI
模板:Pagetype	Predefinição:Tipo de página
模板:GAB	Predefinição:GAB
模板:IRN	Predefinição:IRN
模板:MLI	Predefinição:MLI
模板:JOR	Predefinição:JOR
模板:NPL	Predefinição:NPL
模板:NAM	Predefinição:NAM
模板:CAF	Predefinição:CAF
模板:MKD	Predefinição:MKD
模板:LKA	Predefinição:LKA
模板:MWI	Predefinição:MWI
模板:KAZ	Predefinição:KAZ
模板:OMN	Predefinição:OMN
模板:PER	Predefinição:PER
模板:MOZ	Predefinição:MOZ
模板:SUR	Predefinição:SUR
模板:TRI	Predefinição:TTO
模板:GUY	Predefinição:GUY
模板:ETH	Predefinição:ETH
模板:HKG	Predefinição:HKG
模板:NGA	Predefinição:NGA
模板:PRK	Predefinição:PRK
模板:NIC	Predefinição:NIC
模板:LBR	Predefinição:LBR
模板:TKM	Predefinição:TKM
模板:THA	Predefinição:THA
模板:BFA	Predefinição:BFA
模板:TCD	Predefinição:TCD
模板:PRY	Predefinição:PRY
模板:ECU	Predefinição:ECU
模板:BTN	Predefinição:BTN
模板:MDV	Predefinição:MDV
模板:SLE	Predefinição:SLE
模板:LTU	Predefinição:LTU
模板:SGP	Predefinição:SGP
模板:IND	Predefinição:IND
模板:MAC	Predefinição:MAC
模板:User ar-2	Predefinição:User ar-2
客家语维基百科	Wikipédia em chinês hakka
麦跨里字典	Macquarie Dictionary
分类:User ja-N	Categoria:Usuário ja
分类:用戶名字空間模板	Categoria:!Predefinições para o domínio @@@u0026Usuário"
赣语维基百科	Wikipédia em chinês gan
模板:CHE	Predefinição:CHE
分类:社会阶层	Categoria:Classes sociais
分类:印度电影	Categoria:Cinema da Índia
模板:URL	Predefinição:URL
模板:Disambiguation	Predefinição:Desambiguação
分类:公共交通	Categoria:Transportes públicos
分类:中东	Categoria:Oriente Médio
分类:报纸	Categoria:Jornais
分类:运动场	Categoria:Estádios
模板:Para	Predefinição:Parâmetro
分类:維基百科元模板	Categoria:!Metapredefinições
模板:LAO	Predefinição:LAO
模板:ARE	Predefinição:ARE
模板:GRC	Predefinição:GRC
模板:PRT	Predefinição:PRT
模板:BGD	Predefinição:BGD
模板:BAR	Predefinição:BRB
模板:User ksh	Predefinição:User ksh
模板:AUS	Predefinição:AUS
模板:CZE	Predefinição:CZE
模板:AZE	Predefinição:AZE
模板:Infobox Film	Predefinição:Info/Filme
模板:英文名	Predefinição:Lang-en
分类:语言标示模板	Categoria:!Predefinições sobre idiomas
分类:甜品	Categoria:Sobremesas
分类:新加坡个机场	Categoria:Aeroportos de Singapura
模板:WAD	Predefinição:WAD
分类:內部鏈接模板	Categoria:!Predefinições de ligações internas
模板:KHM	Predefinição:KHM
模板:NLD	Predefinição:NLD
模板:KWT	Predefinição:KWT
模板:Resize	Predefinição:Redimensionar
模板:辅音	Predefinição:Consoantes
模板:VNM	Predefinição:VNM
模板:LIE	Predefinição:LIE
模板:SEN	Predefinição:SEN
模板:NZL	Predefinição:NZL
分类:广州	Categoria:Cantão (China)
模板:MMR	Predefinição:MMR
模板:KOR	Predefinição:KOR
分类:各类电影	Categoria:Filmes por gênero
模板:!(	Predefinição:!(
分类:中国外交官	Categoria:Diplomatas da China
模板:NATO	Predefinição:OTAN
分类:生物	Categoria:Organismos
模板:De icon	Predefinição:((de))
模板:SVN	Predefinição:SVN
模板:LBN	Predefinição:LBN
模板:GUF	Predefinição:GUF
模板:GGY	Predefinição:GGY
模板:FRA	Predefinição:FRA
模板:Infobox Biography	Predefinição:Info/Biografia
分类:蒙古	Categoria:Mongólia
模板:InterWiki	Predefinição:InterWiki
模板:Main Page interwikis	Predefinição:Interwikis da página principal
分类:泰国个大学	Categoria:Universidades da Tailândia
分类:澳大利亚个报纸	Categoria:Jornais da Austrália
分类:历年个电影	Categoria:Filmes por ano
分类:爱尔兰城市	Categoria:Cidades da Irlanda
分类:美国黑人	Categoria:Afro-americanos
模板:Dated maintenance category	Predefinição:Categoria de manutenção datada
模板:Chem-stub	Predefinição:Esboço-química
模板:Thailand-stub	Predefinição:Esboço-Tailândia
模板:Britain-stub	Predefinição:Esboço-Reino Unido
分类:1992年个歌曲	Categoria:Canções de 1992
分类:姊妹计划链接模板	Categoria:!Predefinições para correlatos
模板:User la-1	Predefinição:User la-1
模板:歐洲行政區劃	Predefinição:Países da Europa
分类:模板說明文檔	Categoria:!Instruções de predefinições
分类:泰语	Categoria:Língua tailandesa
分类:User sk	Categoria:Usuários sk
分类:User fr	Categoria:Usuários fr
分类:User ja	Categoria:Usuários ja
分类:User la	Categoria:Usuários la
分类:User fr-3	Categoria:Usuário fr-3
分类:User fr-2	Categoria:Usuário fr-2
分类:User ja-2	Categoria:Usuário ja-2
分类:User la-2	Categoria:Usuário la-2
分类:User ko-N	Categoria:Usuário ko
分类:User fr-N	Categoria:Usuário fr
分类:User nl-N	Categoria:Usuário nl
分类:User ru-N	Categoria:Usuário ru
分类:泰国拳击运动员	Categoria:Pugilistas da Tailândia
分类:政治经济学	Categoria:Economia política
分类:曼谷	Categoria:Distritos de Banguecoque
分类:文字	Categoria:Sistemas de escrita
分类:中国省级行政区	Categoria:Províncias da República Popular da China
分类:岛	Categoria:Ilhas
分类:广平省	Categoria:Quang Binh
分类:User sk-N	Categoria:Usuário sk
分类:User de	Categoria:Usuários de
分类:User de-2	Categoria:Usuário de-2
分类:User de-3	Categoria:Usuário de-3
分类:User de-N	Categoria:Usuário de
分类:User en-3	Categoria:Usuário en-3
分类:User en-N	Categoria:Usuário en
分类:User es	Categoria:Usuários es
分类:User es-1	Categoria:Usuário es-1
分类:User es-2	Categoria:Usuário es-2
分类:User es-N	Categoria:Usuário es
分类:首尔	Categoria:Seul
分类:日本模板	Categoria:!Predefinições sobre o Japão
模板:User la-3	Predefinição:User la-3
分类:阿德来得	Categoria:Adelaide
分类:法国个公园	Categoria:Parques da França
分类:各国个公园	Categoria:Parques por país
分类:各国个政治	Categoria:Política por país
模板:Multiple image	Predefinição:Imagem múltipla
模板:Colorsample	Predefinição:Color sample
分类:User it	Categoria:Usuários it
分类:User it-1	Categoria:Usuário it-1
分类:User ja-1	Categoria:Usuário ja-1
分类:User ko	Categoria:Usuários ko
分类:美国州	Categoria:Estados dos Estados Unidos
分类:User ksh	Categoria:Usuários ksh
分类:User ksh-N	Categoria:Usuário ksh
分类:User la-1	Categoria:Usuário la-1
分类:User la-3	Categoria:Usuário la-3
分类:澳大利亚地理	Categoria:Geografia da Austrália
感谢倷	Thank You
分类:维基百科讨论	Categoria:!Discussão
分类:火山	Categoria:Vulcões
模板:NOR	Predefinição:NOR
模板:Translation WIP	Predefinição:Em tradução
分类:天灾	Categoria:Riscos naturais
分类:天气	Categoria:Fenômenos atmosféricos
模板:Information	Predefinição:Information
分类:日本个县	Categoria:Províncias do Japão
分类:法国城市	Categoria:Cidades da França
模板:BRA	Predefinição:BRA
分类:澳大利亚女演员	Categoria:Atrizes da Austrália
分类:User ru-1	Categoria:Usuário ru-1
Wikipedia:巴别	Wikipédia:Babel
模板:High-use	Predefinição:Alto uso
水分子	Propriedades físico-químicas da água
模板:Humor	Predefinição:Humor
分类:残疾人	Categoria:Pessoas com deficiência
分类:化学小作品	Categoria:!Esboços sobre química
分类:各国个军事	Categoria:Forças armadas dos países
模板:TUN	Predefinição:TUN
分类:日本地方	Categoria:Regiões do Japão
分类:海	Categoria:Mares
地方政府	Governo local
分类:泰国模板	Categoria:!Predefinições sobre a Tailândia
分类:工具书	Categoria:Obras de referência
分类:计算机科学	Categoria:Ciência da computação
分类:User nds	Categoria:Usuários nds
分类:User nds-1	Categoria:Usuário nds-1
模板:LUX	Predefinição:LUX
模板:Red	Predefinição:Vermelho
分类:神奈川县	Categoria:Kanagawa
分类:福岛县	Categoria:Província de Fukushima
分类:广东省	Categoria:Guangdong
分类:安徽	Categoria:Anhui
分类:江西省	Categoria:Jiangxi
分类:江苏省	Categoria:Jiangsu
分类:经济	Categoria:Economias
分类:行政区划	Categoria:Tipos de subdivisões de países
分类:饮料	Categoria:Bebidas
分类:社会科学	Categoria:Ciências sociais
分类:办拉路斯	Categoria:Bielorrússia
分类:中国电影	Categoria:Cinema da China
分类:澳大利亚教育	Categoria:Educação na Austrália
分类:非洲国家	Categoria:Países de África
分类:各国教育	Categoria:Educação por país
模板:)!	Predefinição:)!
Wikipedia:AutoWikiBrowser/Typos	Wikipédia:AutoWikiBrowser/Typos
模板:User ru-2	Predefinição:User ru-2
分类:科幻片	Categoria:Filmes de ficção científica
模板:Column-width	Predefinição:Column-width
分类:User ru	Categoria:Usuários ru
分类:User ru-2	Categoria:Usuário ru-2
分类:User ru-4	Categoria:Usuário ru-4
模板:En icon	Predefinição:((en))
分类:浙江省	Categoria:Zhejiang
分类:金球奖获得者	Categoria:Vencedores do Globo de Ouro
模板:!((	Predefinição:!((
模板:))!	Predefinição:))!
模板:Lang	Predefinição:Lang
分类:泰国电影	Categoria:Filmes da Tailândia
分类:社会学	Categoria:Sociologia
模板:IRL	Predefinição:IRL
分类:1981年出生	Categoria:Nascidos em 1981
分类:1986年出生	Categoria:Nascidos em 1986
模板:ALB	Predefinição:ALB
模板:AND	Predefinição:AND
模板:ARG	Predefinição:ARG
模板:ARM	Predefinição:ARM
分类:美国慈善家	Categoria:Filantropos dos Estados Unidos
分类:各国个电影	Categoria:Cinema por país
Wikipedia:Template sandbox and test cases	Wikipédia:Testes e exemplos para teste de predefinições
分类:人类	Categoria:Humanos
分类:分類名字空間模板	Categoria:!Predefinições para categorias
模板:Australia-stub	Predefinição:Esboço-Austrália
模板:BDI	Predefinição:BDI
模板:BAH	Predefinição:BHS
模板:BLR	Predefinição:BLR
模板:Bhutan stub	Predefinição:Esboço-Butão
分类:棋类	Categoria:Jogos de estratégia abstratos
模板:CIV	Predefinição:CIV
模板:CRI	Predefinição:CRI
模板:CHY	Predefinição:CYP
分类:泰国交通	Categoria:Transportes da Tailândia
模板:Fr	Predefinição:Fr icon
分类:文章	Categoria:Artigos
模板:Ko icon	Predefinição:((ko))
分类:法国铁路	Categoria:Transporte ferroviário na França
分类:1951年个电影	Categoria:Filmes de 1951
模板:物理学粒子	Predefinição:Partículas elementares
分类:女演员	Categoria:Atrizes
分类:佛罗里达州	Categoria:Flórida
分类:上海个区	Categoria:Distritos de Xangai
分类:弗自由媒体	Categoria:!Conteúdo restrito
模板:EST	Predefinição:EST
分类:泰国政党	Categoria:Partidos políticos da Tailândia
Wikipedia:Lua	Wikipédia:Lua
分类:大規模殺傷性武器	Categoria:Armas de destruição em massa
模板:QAT	Predefinição:QAT
模板:RUS	Predefinição:RUS
模板:AUT	Predefinição:AUT
模板:History-stub	Predefinição:Esboço-história
分类:2009年恐怖事件	Categoria:Atentados terroristas de 2009
分类:2005年个歌曲	Categoria:Canções de 2005
分类:动作片	Categoria:Filmes de ação
模板:CHL	Predefinição:CHL
分类:英语电影	Categoria:Filmes em língua inglesa
分类:软件系统	Categoria:Sistemas de software
模板:Round8	Predefinição:Round8
模板:SYR	Predefinição:SYR
模板:CHN	Predefinição:CHN
模板:Switzerland-stub	Predefinição:Esboço-Suíça
模板:Side box	Predefinição:Side box
分类:世界人口	Categoria:Demografia por país
分类:所有页面需要清理	Categoria:!Páginas a reciclar
模板:IRQ	Predefinição:IRQ
模板:Citation/core	Predefinição:Citation/core
分类:法国交通	Categoria:Transportes da França
分类:澳大利亚个湖	Categoria:Lagos da Austrália
分类:各国经济	Categoria:Economia por país
分类:各国个报纸	Categoria:Jornais por país
分类:各国个银行	Categoria:Bancos por país
分类:各国个地震	Categoria:Sismos por país
分类:韩国政治	Categoria:Política da Coreia do Sul
分类:澳大利亚个政治	Categoria:Política da Austrália
分类:泰国政治	Categoria:Política da Tailândia
分类:越南经济	Categoria:Economia do Vietname
分类:柬埔寨经济	Categoria:Economia do Camboja
分类:朝鲜民主主义人民共和国政治	Categoria:Política da Coreia do Norte
分类:泰国经济	Categoria:Economia da Tailândia
模板:Infobox Language/family-color	Predefinição:Info/Língua/corfamília
分类:澳大利亚体育运动	Categoria:Desporto da Austrália
分类:泰国体育	Categoria:Desporto da Tailândia
分类:澳大利亚足球	Categoria:Futebol da Austrália
分类:河	Categoria:Rios
模板:User ko	Predefinição:User ko
模板:User la-2	Predefinição:User la-2
模板:User ru-1	Predefinição:User ru-1
模板:User zh-1	Predefinição:User zh-1
模板:User zh-2	Predefinição:User zh-2
模板:User zh-3	Predefinição:User zh-3
分类:韩国交通	Categoria:Transportes da Coreia do Sul
分类:中国交通	Categoria:Transportes da China
分类:世界各国个博物馆	Categoria:Museus por país
分类:马来西亚经济	Categoria:Economia da Malásia
分类:泰国军事	Categoria:Forças Armadas da Tailândia
分类:菲律宾模板	Categoria:!Predefinições sobre Filipinas
模板:Multi-listen end	Predefinição:Multi-escuta fim
分类:澳大利亚个交通	Categoria:Transportes da Austrália
分类:蘇聯政治家	Categoria:Políticos da União Soviética
分类:日本教育	Categoria:Educação no Japão
分类:泰国教育	Categoria:Educação na Tailândia
分类:韩国人	Categoria:Sul-coreanos
分类:台湾人	Categoria:Taiwaneses
Wikipedia:Picture of the day	Wikipédia:Imagem em destaque
分类:菲律宾	Categoria:Filipinas
分类:各行业澳大利亚人	Categoria:Australianos por ocupação
分类:马来西亚歌手	Categoria:Cantores da Malásia
分类:泰国歌星	Categoria:Cantores da Tailândia
分类:User nl	Categoria:Usuários nl
分类:User zh-1	Categoria:Usuário zh-1
分类:User zh-3	Categoria:Usuário zh-3
分类:User zh-2	Categoria:Usuário zh-2
分类:泰国国王	Categoria:Reis da Tailândia
分类:力学	Categoria:Mecânica
分类:中国计算机科学家	Categoria:Cientistas da computação da China
分类:不丹	Categoria:Butão
分类:澳大利亚跳水运动员	Categoria:Saltadores da Austrália
分类:印度模特	Categoria:Modelos da Índia
分类:印度科学技术	Categoria:Ciência e tecnologia na Índia
分类:泰国旅游	Categoria:Turismo na Tailândia
分类:中国演员	Categoria:Atores da China
分类:泰国演员	Categoria:Atores da Tailândia
分类:澳大利亚游泳运动员	Categoria:Nadadores da Austrália
分类:电视	Categoria:Televisão
分类:中国诗人	Categoria:Poetas da China
分类:世紀	Categoria:Séculos
分类:蘇聯外敎官	Categoria:Diplomatas da União Soviética
分类:印度演员	Categoria:Atores da Índia
分类:中国田径运动员	Categoria:Atletas da China
分类:澳大利亚脚踏车运动员	Categoria:Ciclistas da Austrália
分类:泰国运动员	Categoria:Desportistas da Tailândia
分类:中国运动员	Categoria:Desportistas da China
分类:泰国府	Categoria:Províncias da Tailândia
分类:海滩	Categoria:Praias
分类:泰国个海滩	Categoria:Praias da Tailândia
分类:柬埔寨人	Categoria:Cambojanos
分类:泰国政治人物	Categoria:Políticos da Tailândia
分类:香港人	Categoria:Hongueconguenses
分类:泰国人	Categoria:Tailandeses
分类:东海	Categoria:Mar da China Oriental
分类:泰国个湖泊	Categoria:Lagos da Tailândia
分类:意大利个湖	Categoria:Lagos da Itália
分类:光学仪器	Categoria:Instrumentos ópticos
分类:机场	Categoria:Aeroportos
分类:泰国机场	Categoria:Aeroportos da Tailândia
分类:日本个机场	Categoria:Aeroportos do Japão
分类:化学元素	Categoria:Elementos químicos
分类:澳大利亚运动员	Categoria:Desportistas da Austrália
分类:香港演员	Categoria:Atores de Hong Kong
分类:环球小姐	Categoria:Miss Universo
分类:不丹总理	Categoria:Primeiros-ministros do Butão
分类:澳大利亚总理	Categoria:Primeiros-ministros da Austrália
分类:泰国总理	Categoria:Primeiros-ministros da Tailândia
分类:地理小作品	Categoria:!Esboços sobre geografia
分类:朝鲜	Categoria:Coreia do Norte
分类:柬埔寨	Categoria:Camboja
分类:澳大利亚人	Categoria:Australianos
分类:中国人	Categoria:Chineses
分类:台湾歌手	Categoria:Cantores de Taiwan
分类:韩国演员	Categoria:Atores da Coreia do Sul
分类:蘇聯作家	Categoria:Escritores da União Soviética
分类:中国历史	Categoria:História da China
分类:不丹国王	Categoria:Reis do Butão
分类:老挝	Categoria:Laos
分类:缅甸	Categoria:Myanmar
分类:台湾	Categoria:Taiwan
分类:法国演员	Categoria:Atores da França
分类:電影模板	Categoria:!Predefinições sobre cinema
分类:爱尔兰模板	Categoria:!Predefinições sobre a Irlanda
分类:伊朗模板	Categoria:!Predefinições sobre o Irão
分类:英国模板	Categoria:!Predefinições sobre o Reino Unido
分类:美国模板	Categoria:!Predefinições sobre os Estados Unidos
分类:中国古代朝代	Categoria:Dinastias chinesas
分类:多語言支援模板	Categoria:!Predefinições de apoio multilingue
分类:新加坡模板	Categoria:!Predefinições sobre Singapura
分类:外交模板	Categoria:!Predefinições sobre relações exteriores
分类:法国模板	Categoria:!Predefinições sobre França
分类:越南模板	Categoria:!Predefinições sobre o Vietname
分类:加拿大模板	Categoria:!Predefinições sobre o Canadá
分类:马来西亚模板	Categoria:!Predefinições sobre a Malásia
分类:精密模板	Categoria:!Predefinições complexas
分类:維基百科工具模板	Categoria:!Predefinições utilitário Wikipedia
分类:模板名字空間模板	Categoria:!Predefinições para o domínio predefinição
分类:泰国个公司	Categoria:Empresas da Tailândia
分类:马来西亚公司	Categoria:Empresas da Malásia
分类:浙江人	Categoria:Naturais de Zhejiang
分类:出生	Categoria:Nascidos por ano
分类:朝鮮人	Categoria:Pessoas da Dinastia Joseon
分类:法国总统	Categoria:Presidentes da França
分类:亚洲历史	Categoria:História da Ásia
分类:约旦	Categoria:Jordânia
分类:大洋洲国家	Categoria:Países da Oceania
分类:鱼类	Categoria:Peixes
分类:北京	Categoria:Pequim
分类:国家足球队	Categoria:Seleções nacionais de futebol
分类:泰国灾难	Categoria:Desastres na Tailândia
分类:日本关东地方	Categoria:Região de Kanto
分类:剧情片	Categoria:Filmes de drama
分类:1971年个电影	Categoria:Filmes de 1971
分类:2003年个电影	Categoria:Filmes de 2003
分类:1994年个电影	Categoria:Filmes de 1994
分类:2004年个电影	Categoria:Filmes de 2004
分类:2005年个电影	Categoria:Filmes de 2005
分类:2007年个电影	Categoria:Filmes de 2007
分类:2008年个电影	Categoria:Filmes de 2008
分类:香港电影	Categoria:Cinema de Hong Kong
分类:法国电影	Categoria:Cinema da França
分类:公用领域媒体	Categoria:Imagens domínio público
分类:阿拉伯语	Categoria:Língua árabe
分类:印度言话	Categoria:Línguas da Índia
分类:人类学	Categoria:Antropologia
分类:世界小姐	Categoria:Miss Mundo
分类:抗生素	Categoria:Antibióticos
分类:操作系统	Categoria:Sistemas operativos
分类:昆士兰州	Categoria:Queensland
分类:泰国政府	Categoria:Governo da Tailândia
分类:维克多利亚州	Categoria:Vitória (Austrália)
分类:电影奖	Categoria:Prêmios de cinema
分类:奥斯卡金像奖	Categoria:Oscar
分类:金球奖	Categoria:Prêmios Globo de Ouro
分类:清朝	Categoria:Dinastia Qing
分类:明朝	Categoria:Dinastia Ming
分类:汉朝	Categoria:Dinastia Han
分类:里昂	Categoria:Lyon
模板:Incubator	Predefinição:Incubadora
分类:中国文化	Categoria:Cultura da China
分类:法国文化	Categoria:Cultura da França
分类:越南文化	Categoria:Cultura do Vietname
分类:韩国文化	Categoria:Cultura da Coreia do Sul
分类:電子工程	Categoria:Engenharia eletrônica
分类:网络语言	Categoria:Internetês
模板:ESP	Predefinição:ESP
分类:动物	Categoria:Animais
分类:泰国航空公司	Categoria:Empresas aéreas da Tailândia
分类:国际象棋	Categoria:Xadrez
分类:武器	Categoria:Armas
分类:核武器	Categoria:Armas nucleares
瀑瑶兰	Beaujolais
分类:物理量	Categoria:Grandezas físicas
分类:温标	Categoria:Unidades de temperatura
模板:元素色例	Predefinição:Legenda séries químicas
分类:小吃	Categoria:Salgados
分类:热力学	Categoria:Termodinâmica
分类:气象学	Categoria:Meteorologia
分类:航空事故	Categoria:Acidentes aéreos
分类:香港	Categoria:Hong Kong
分类:菲律宾群岛	Categoria:Ilhas das Filipinas
分类:大西洋岛屿	Categoria:Ilhas do Atlântico
分类:上海	Categoria:Xangai
分类:节日	Categoria:Festivais
分类:印度城市	Categoria:Cidades e vilas da Índia
分类:俄罗斯城市	Categoria:Cidades da Rússia
分类:Web 2.0	Categoria:Web 2.0
分类:事体	Categoria:Eventos
分类:西亚	Categoria:Sudoeste Asiático
分类:電信	Categoria:Telecomunicações
分类:流感病毒	Categoria:Gripe
分类:交通	Categoria:Transporte
分类:选美	Categoria:Concursos de beleza
分类:性行为	Categoria:Práticas sexuais
分类:电视剧	Categoria:Telesséries
分类:北美洲	Categoria:América do Norte
分类:歌手	Categoria:Cantores
分类:亚洲个湖泊	Categoria:Lagos da Ásia
分类:欧洲个湖泊	Categoria:Lagos da Europa
分类:湖泊	Categoria:Lagos
分类:大韩民国机场	Categoria:Aeroportos da Coreia do Sul
模板:Infobox Language	Predefinição:Info/Língua
分类:大洋洲	Categoria:Oceania
分类:中国城市	Categoria:Cidades da China
分类:瀑布	Categoria:Quedas de água
分类:自然灾害	Categoria:Desastres naturais
分类:日本九州	Categoria:Região de Kyushu
分类:1998年个电影	Categoria:Filmes de 1998
分类:2006年个电影	Categoria:Filmes de 2006
分类:恐怖片	Categoria:Filmes de horror
分类:美国电影	Categoria:Cinema dos Estados Unidos
分类:汉语	Categoria:Língua chinesa
分类:泰国言话	Categoria:Línguas da Tailândia
分类:新南威尔士州	Categoria:Nova Gales do Sul
分类:澳大利亚文化	Categoria:Cultura da Austrália
分类:泰国文化	Categoria:Cultura da Tailândia
分类:越南城市	Categoria:Cidades do Vietname
分类:澳大利亚城市	Categoria:Cidades da Austrália
分类:泰国城市	Categoria:Cidades da Tailândia
分类:泰国个岛	Categoria:Ilhas da Tailândia
分类:印度文化	Categoria:Cultura da Índia
分类:印度尼西亚个岛	Categoria:Ilhas da Indonésia
分类:中东国家	Categoria:Países do Oriente Médio
分类:澳大利亚旅游	Categoria:Turismo na Austrália
分类:中国个公园	Categoria:Parques da China
分类:银行	Categoria:Bancos
分类:霍巴特	Categoria:Hobart
Wikipedia:模板文檔	Wikipédia:Documentação da predefinição
分类:中华人民共和国	Categoria:República Popular da China
分类:維基百科名字空間模板	Categoria:!Predefinições por domínio
模板:FULLROOTPAGENAME	Predefinição:FULLROOTPAGENAME
分类:学堂	Categoria:Escolas
分类:澳大利亚风光	Categoria:Atrações turísticas da Austrália
分类:越南航空	Categoria:Empresas aéreas do Vietnã
分类:中国地铁	Categoria:Metropolitanos da China
模板:Geo stub	Predefinição:Esboço-geografia
模板:UGA	Predefinição:UGA
模板:UZB	Predefinição:UZB
模板:Comment	Predefinição:Comentário
分类:香港交通	Categoria:Transportes de Hong Kong
中国	China (desambiguação)
Portal:数学	Portal:Matemática
模板:Greece-stub	Predefinição:Esboço-Grécia
分类:朝鲜国家元首	Categoria:Presidentes da Coreia do Norte
分类:亚洲国家	Categoria:Países da Ásia
分类:美洲国家	Categoria:Países da América
模板:Japan stub	Predefinição:Esboço-Japão
模板:Mexico-stub	Predefinição:Esboço-México
模板:SSU	Predefinição:Uniões gays
分类:含有內容嗰已軟重定向分類	Categoria:!Redirecionamentos de categorias não vazios
分类:維基百科幽默	Categoria:!Humor
模板:RWA	Predefinição:RWA
模板:MLT	Predefinição:MLT
模板:KEN	Predefinição:KEN
模板:JAM	Predefinição:JAM
分类:南美洲国家模板	Categoria:!Predefinições sobre América do Sul
模板:CXR	Predefinição:CXR
分类:1976年个地震	Categoria:Sismos em 1976
分类:必有个页面	Categoria:!Artigos essenciais
模板:Sister project	Predefinição:Irmão
分类:事故	Categoria:Acidentes
海南	Hainan (desambiguação)
分类:香港机场	Categoria:Aeroportos de Hong Kong
分类:亚洲国家模板	Categoria:!Predefinições sobre países da Ásia
分类:澳大利亚模板	Categoria:!Predefinições sobre a Austrália
分类:AutoWikiBrowser	Categoria:!AutoWikiBrowser
分类:宝莱坞	Categoria:Bollywood
分类:大桥	Categoria:Pontes
分类:布里司班	Categoria:Brisbane
分类:中美洲国家	Categoria:Países da América Central
分类:江苏城市	Categoria:Cidades de Jiangsu
分类:地震	Categoria:Sismos
分类:中国地震	Categoria:Sismos na China
分类:香港教育	Categoria:Educação em Hong Kong
分类:环境	Categoria:Ambiente
分类:欧洲国家模板	Categoria:!Predefinições sobre países da Europa
分类:凯撒奖	Categoria:César
分类:泰国个节日	Categoria:Festivais da Tailândia
分类:大洋洲国家模板	Categoria:!Predefinições sobre países da Oceania
模板:IAST	Predefinição:IAST
分类:中国水灾	Categoria:Enchentes na China
分类:手册	Categoria:Manuais
分类:印度个寺庙	Categoria:Templos hindus da Índia
分类:香港文化	Categoria:Cultura de Hong Kong
分类:爱尔兰	Categoria:Irlanda
模板:India-stub	Predefinição:Esboço-Índia
分类:苏州	Categoria:Suzhou
分类:中华民国	Categoria:República da China
模板:Listen	Predefinição:Escute
分类:北美洲国家模板	Categoria:!Predefinições sobre países da América do Norte
分类:性学	Categoria:Sexologia
模板:MNG	Predefinição:MNG
分类:相态	Categoria:Fases da matéria
分类:南澳大利亚州	Categoria:Austrália do Sul
模板:BEL	Predefinição:BEL
分类:韩国模板	Categoria:!Predefinições sobre a Coreia do Sul
分类:东南亚国家联盟	Categoria:Associação de Nações do Sudeste Asiático
分类:墨尔本	Categoria:Melbourne
分类:方向	Categoria:Orientação
分类:電話號碼	Categoria:Números de telefone
分类:電話	Categoria:Telefonia
分类:温度	Categoria:Temperatura
分类:印度个恐怖事体	Categoria:Atentados terroristas na Índia
分类:上海交通	Categoria:Transportes de Xangai
斋月	Ramadão
分类:海啸	Categoria:Tsunamis
分类:悉尼	Categoria:Sydney
分类:朝鲜模板	Categoria:!Predefinições sobre a Coreia do Norte
分类:热带气旋	Categoria:Ciclones tropicais
分类:澳大利亚个公园	Categoria:Parques da Austrália
分类:应用科学	Categoria:Ciências aplicadas
分类:字典	Categoria:Dicionários chineses
分类:法国个报纸	Categoria:Jornais da França
模板:Image label begin	Predefinição:Image label begin
分类:澳大利亚大学	Categoria:Universidades da Austrália
分类:中国个银行	Categoria:Bancos da China
分类:中国个报纸	Categoria:Jornais da China
分类:高分子化学	Categoria:Química dos polímeros
分类:日本大学	Categoria:Universidades do Japão
分类:浙江城市	Categoria:Cidades de Zhejiang
甲型流感病毒H7N9亚型	Influenza A subtipo H7N9
分类:巴黎高速铁路	Categoria:RER
分类:天津	Categoria:Tianjin
分类:巴黎交通	Categoria:Transportes de Paris
分类:非洲国家模板	Categoria:!Predefinições sobre África
模板:HUN	Predefinição:HUN
分类:澳大利亚小姐	Categoria:Miss Austrália
模板:Ns has subpages	Predefinição:Ns has subpages
分类:生活	Categoria:Vida pessoal
Wikipedia:生成机器人	Wikipédia:Como criar um robô
分类:女性	Categoria:Mulher
分类:柬埔寨文化	Categoria:Cultura do Camboja
分类:User en-1	Categoria:Usuário en-1
分类:User de-1	Categoria:Usuário de-1
分类:亚洲个台风	Categoria:Ciclones tropicais na Ásia
分类:法国省份	Categoria:Departamentos da França
分类:工具	Categoria:Ferramentas
分类:德国城市	Categoria:Cidades da Alemanha
分类:美国演员	Categoria:Atores dos Estados Unidos
模板:France-stub	Predefinição:Esboço-França
分类:瑞典贵族	Categoria:Nobres da Suécia
分类:人物模板	Categoria:!Predefinições sobre pessoas
分类:古巴拳击运动员	Categoria:Pugilistas de Cuba
模板:Asbox	Predefinição:Asbox
模板:Lua	Predefinição:Lua
Wikipedia:弗要犯常见个错误	Ajuda:Erros comuns
Wikipedia:How to read a taxobox	Wikipédia:Como ler uma caixa taxonómica
Wikipedia:Media help	Ajuda:Guia de consulta e reprodução/introdução à mídia
模板:Italy-stub	Predefinição:Esboço-Itália
模板:OIC	Predefinição:OCI
模板:Start date	Predefinição:Data de início
姜義錫	Kang We-seok
琉球群岛	Ryūkyū
模板:Mbox templates see also	Predefinição:Mbox/ver também
模板:Bio-stub	Predefinição:Esboço-biografia
模板:Indonesia stub	Predefinição:Esboço-Indonésia
模板:Infobox Thailand province	Predefinição:Info/Província da Tailândia
模板:Malaysia-stub	Predefinição:Esboço-Malásia
褥子	Almofada
模板:Wayback	Predefinição:Wayback
模板:Ireland stub	Predefinição:Esboço-Irlanda
模板:Philippines-stub	Predefinição:Esboço-Filipinas
Wikipedia:VisualEditor	Wikipédia:Editor Visual
Wikipedia:AutoWikiBrowser/CheckPage	Wikipédia:AutoWikiBrowser/CheckPage
分类:Audio templates	Categoria:!Predefinições de áudio
模板:Element color/Actinides	Predefinição:Elemento/Cor actinídios
模板:Element color/Alkaline earth metals	Predefinição:Elemento/Cor metais alcalino-terrosos
模板:Contains special characters	Predefinição:Caracteres especiais
Wikipedia:Spoken articles	Wikipédia:Projetos/Wikipédia audível
Wikipedia:CC-BY-SA-3.0协议文本	Wikipédia:Texto da licença Creative Commons Attribution-ShareAlike 3.0 Unported
模板:Multi-listen item	Predefinição:Multi-escuta item
模板:Element color/Alkali metals	Predefinição:Elemento/Cor metais alcalinos
模板:Element color/Lanthanides	Predefinição:Elemento/Cor lantanídios
模板:Element color/Nonmetals	Predefinição:Elemento/Cor não-metais
模板:Nobots	Predefinição:Nobots
曼谷枪手 2	Bangkok Dangerous
模板:Documentation/preload	Predefinição:Documentação/preload
模板:Infobox Language/genetic2	Predefinição:Info/Língua/genetic2
模板:Vietnam stub	Predefinição:Esboço-Vietname
模板:Tld	Predefinição:Tld
模块:Documentation	Módulo:Documentação
模板:No documentation	Predefinição:Falta doc
模板:HKG stub	Predefinição:Esboço-Hong Kong
模板:TemplateDataHeader	Predefinição:Documentação dos parâmetros
模板:Reply to	Predefinição:Responder a
模块:Yesno	Módulo:Yesno
模块:Message box	Módulo:Message box
模块:Category handler	Módulo:Category handler
模块:Message box/configuration	Módulo:Message box/configuration
尹賢碩	Yun Hyon-seok
惡病質	Caquexia
模块:Unsubst	Módulo:Unsubst
模块:Arguments	Módulo:Arguments
特殊:最近更改	Especial:Mudanças recentes
模块:TableTools	Módulo:TableTools
模块:Documentation/config	Módulo:Documentação/config
模块:Namespace detect	Módulo:Namespace detect
模块:Bananas	Módulo:Bananas
模块:HtmlBuilder	Módulo:HtmlBuilder
模块:String	Módulo:String
模块:InfoboxImage	Módulo:InfoboxImage
模块:Navbar	Módulo:Navbar
模块:Navbox	Módulo:Navbox
模块:Infobox	Módulo:Infobox
模块:Pagetype	Módulo:Pagetype
Wikipedia:VisualEditor/TemplateData	Wikipédia:Editor Visual/TemplateData
模块:Namespace detect/data	Módulo:Namespace detect/data
模块:Namespace detect/config	Módulo:Namespace detect/config
模块:Pagetype/config	Módulo:Pagetype/config
模板:Aligned table	Predefinição:Aligned table
模块:Aligned table	Módulo:Aligned table
模块:No globals	Módulo:No globals
模块:Hatnote	Módulo:Hatnote
模块:Listen	Módulo:Ouvir
模块:Side box	Módulo:Caixa lateral
模块:File link	Módulo:Link de arquivo
馬來西亞航空17號班機空难	Voo Malaysia Airlines 17
雨傘運動	Protestos em Hong Kong em 2014
新加坡总理一览	Lista de primeiros-ministros de Singapura
飞行员	Piloto (aviação)
