阿非利加洲	África
日本	Japão
挪威	Noruega
英格蘭	Inglaterra
蘇格蘭	Escócia
愛爾蘭共和國	República da Irlanda
匈牙利	Hungria
西班牙	Espanha
美國	Estados Unidos
比利時	Bélgica
盧森堡	Luxemburgo
宇宙	Universo
坤輿	Terra
死	Morte
人	Homo sapiens
華盛頓	George Washington
芬蘭	Finlândia
瑞典	Suécia
丹麥	Dinamarca
波蘭	Polónia
立陶宛	Lituânia
義大利	Itália
瑞士	Suíça
奧地利	Áustria
希臘共和國	Grécia
土耳其	Turquia
啤酒	Cerveja
葡萄牙	Portugal
歐羅巴洲	Europa
亞細亞洲	Ásia
南極洲	Antártida
維基大典	Wikipédia
荷蘭	Países Baixos
紐約市	Nova Iorque
華盛頓哥倫比亞特區	Washington, D.C.
柏林	Berlim
電腦	Computador
共筆臺	MediaWiki
倫敦	Londres
巴黎	Paris
安卓	Android
谷歌	Google
墨西哥	México
太平洋	Oceano Pacífico
熒惑	Marte (planeta)
衣索比亞	Etiópia
迦納	Gana
法國	França
世界語	Esperanto
犬	Canis lupus familiaris
英國	Reino Unido
貓	Gato
中華人民共和國	República Popular da China
法蘭西語	Língua francesa
維基爾雅	Wikcionário
乙醇	Etanol
巴西	Brasil
醇	Álcool
俄羅斯	Rússia
光導纖維	Fibra óptica
正方形	Quadrado
圓周率	Pi
共筆	Wiki
魁北克	Quebec
維基媒體基金會	Wikimedia
威霽彌	Jimmy Wales
德國	Alemanha
白俄羅斯	Bielorrússia
德語	Língua alemã
冰島	Islândia
愛沙尼亞	Estónia
鎮星	Saturno (planeta)
飛機	Avião
一	Um
二	Dois
三	Três
〇	0 (número)
無限	Infinito
拉脫維亞	Letónia
烏克蘭	Ucrânia
捷克	República Checa
斯洛伐克	Eslováquia
羅馬尼亞	Roménia
保加利亞	Bulgária
羅馬	Roma
馬其頓	República da Macedónia
格陵蘭	Gronelândia
哈薩克	Cazaquistão
古巴	Cuba
印度尼西亞	Indonésia
莫扎特	Wolfgang Amadeus Mozart
貝多芬	Ludwig van Beethoven
南非	África do Sul
商博良	Jean-François Champollion
阿爾及利亞	Argélia
水	Água
電視	Televisão
智利	Chile
耶穌	Jesus
伽利略	Galileu Galilei
辰星	Mercúrio (planeta)
史	História
蘋果公司	Apple
太白	Vénus (planeta)
語言	Linguagem
愛	Amor
歲星	Júpiter (planeta)
銀河	Via Láctea
大霹靂	Big Bang
天王星	Urano (planeta)
英文維基大典	Wikipédia em inglês
海王星	Netuno (planeta)
新加坡	Singapura
格致	Ciência
冥王星	Plutão
列支敦士登	Liechtenstein
希特勒	Adolf Hitler
臉書	Facebook
第一次世界大戰	Primeira Guerra Mundial
第二次世界大戰	Segunda Guerra Mundial
烏邦土	Ubuntu
數學	Matemática
拉丁語	Língua latina
巴林	Bahrein
塞爾維亞	Sérvia
月	Lua
澳大利亞	Austrália
物理	Física
阿根廷	Argentina
秘魯	Peru
生物學	Biologia
朝鮮民主主義人民共和國	Coreia do Norte
柬埔寨	Camboja
古蘭經	Alcorão
恐龍	Dinossauros
回教	Islão
大英百科	Encyclopædia Britannica
歐羅巴聯盟	União Europeia
朋友	Amizade
馬里亞納海溝	Fossa das Marianas
珠穆朗瑪峰	Monte Everest
拿破崙一世	Napoleão Bonaparte
恆星	Estrela
日	Sol
巴斯特	Louis Pasteur
光年	Ano-luz
大洋洲	Oceania
太陽系	Sistema Solar
氫	Hidrogénio
氦	Hélio
維基共享	Wikimedia Commons
鋰	Lítio
鈹	Berílio
日（曆法）	Dia
東帝汶	Timor-Leste
夜	Noite
黑洞	Buraco negro
穀神星	Ceres (planeta anão)
妊神星	Haumea
鳥神星	Makemake
鬩神星	Éris (planeta anão)
硼	Boro
碳	Carbono
氮	Azoto
氧	Oxigénio
行星	Planeta
威尼斯	Veneza
火影忍者	Naruto
莫斯科	Moscovo
氟	Flúor
義大利語	Língua italiana
氖	Néon
鈉	Sódio
鎂	Magnésio
鋁	Alumínio
紐西蘭	Nova Zelândia
印度	Índia
硅	Silício
磷	Fósforo
鐵	Ferro
硫	Enxofre
東	Leste
氯	Cloro
巴布亞新幾內亞	Papua-Nova Guiné
莎士比亞	William Shakespeare
氬	Árgon
鉀	Potássio
鈣	Cálcio
鉛	Chumbo
蒙古國	Mongólia
鈧	Escândio
鈦	Titânio
委內瑞拉	Venezuela
成吉思汗	Gengis Khan
釩	Vanádio
鉻	Crômio
阿姆斯特丹	Amesterdão
動物	Animalia
錳	Manganês
哥倫比亞	Colômbia
鈷	Cobalto
鎢	Tungstênio
鎳	Níquel
佛教	Budismo
玻利維亞	Bolívia
銅	Cobre
千里達及托巴哥	Trinidad e Tobago
植物	Plantae
鋅	Zinco
真菌	Fungi
牙買加	Jamaica
夏威夷	Havaí
海地	Haiti
伊朗	Irão
伊拉克	Iraque
哥斯大黎加	Costa Rica
以色列	Israel
巴拿馬	Panamá
科威特	Kuwait
老撾	Laos
馬爾地夫	Maldivas
亞美利加洲	América
馬來西亞	Malásia
緬甸	Myanmar
尼泊爾	Nepal
阿曼	Omã
巴基斯坦	Paquistão
卡達國	Catar
沙特阿拉伯	Arábia Saudita
斯里蘭卡	Sri Lanka
斯大林	Josef Stalin
柏拉圖	Platão
鎵	Gálio
神奇寶貝	Pokémon
中華民國	República da China
鍺	Germânio
泰國	Tailândia
砒	Arsênio
硒	Selênio
溴	Bromo
鉑	Platina
越南	Vietname
大韓民國	Coreia do Sul
氪	Crípton
阿富汗	Afeganistão
江南風	Gangnam Style
銣	Rubídio
金	Ouro
蘇彝士運河	Canal de Suez
孟加拉國	Bangladesh
蘇格拉底	Sócrates
安哥拉	Angola
不丹	Butão
汶萊	Brunei
汞	Mercúrio (elemento químico)
菲律賓	Filipinas
中非	República Centro-Africana
鉈	Tálio
南極	Polo Sul
北極	Polo Norte
牛頓	Isaac Newton
鍶	Estrôncio
釔	Ítrio
鉍	Bismuto
尚比亞	Zâmbia
津巴布韋	Zimbabwe
北京市	Pequim
南蘇丹	Sudão do Sul
海參崴	Vladivostok
波札那	Botswana
剛果民主共和國	República Democrática do Congo
吉布提	Djibouti
加蓬	Gabão
甘地	Mahatma Gandhi
利比亞	Líbia
馬達加斯加	Madagáscar
摩洛哥	Marrocos
莫桑比克	Moçambique
納米比亞	Namíbia
尼日利亞	Nigéria
烏干達	Uganda
索馬里	Somália
凱撒	Júlio César
蘇丹	Sudão
斯威士蘭	Suazilândia
鍀	Tecnécio
天演	Evolução
聯合國	Organização das Nações Unidas
地理學	Geografia
腦	Cérebro
布拉格	Praga
銀	Prata
錫	Estanho
鈾	Urânio
鈈	Plutónio
碘	Iodo
氙	Xenônio
銫	Césio
鐳	Rádio (elemento químico)
氡	Rádon
賈坎德邦	Jharkhand
耶路撒冷	Jerusalém
印度洋	Oceano Índico
科索沃	Kosovo
蕭邦	Frédéric Chopin
Category:類	Categoria:Conteúdo
帕斯卡	Blaise Pascal
冬	Inverno
春	Primavera
夏	Verão
秋	Outono
薩達姆·海珊	Saddam Hussein
拉登	Osama bin Laden
西班牙語	Língua castelhana
巴赫	Johann Sebastian Bach
泉幣	Dinheiro
奧古斯都	Augusto
諾基亞	Nokia
德克薩斯州	Texas
布宜諾斯艾利斯	Buenos Aires
東京都	Tóquio
密西西比河	Rio Mississippi
錫金	Siquim
尼爾杭思朗	Neil Armstrong
斯德哥爾摩	Estocolmo
墓誌	Epitáfio
里加	Riga
聖經	Bíblia
金邊	Phnom Penh
真耶穌教會	Verdadeira Igreja de Jesus
英語	Língua inglesa
曼谷	Banguecoque
臺北市	Taipé
鎇	Amerício
康賽普西翁	Concepción (Chile)
緬尼托巴	Manitoba
孔斯科沃拉	Końskowola
公元二千年	2000
二〇〇三年	2003
二〇〇二年	2002
二〇〇一年	2001
二〇一二年	2012
二〇一一年	2011
二〇一〇年	2010
二〇〇九年	2009
二氧化碳	Dióxido de carbono
二〇一三年	2013
二〇一四年	2014
二〇一五年	2015
二〇〇八年	2008
二〇〇四年	2004
二〇〇五年	2005
二〇〇六年	2006
二〇〇七年	2007
一氧化碳	Monóxido de carbono
戴高樂	Charles de Gaulle
一九九二年	1992
一九九一年	1991
一九九〇年	1990
一九九三年	1993
一九九四年	1994
一九九五年	1995
一九九六年	1996
可縮放矢量圖形	SVG
萊比錫	Leipzig
一九九七年	1997
一九九八年	1998
一九九九年	1999
食物	Alimento
光速	Velocidade da luz
公曆一月一日	1 de janeiro
公曆一月二日	2 de janeiro
公曆一月三日	3 de janeiro
公曆一月四日	4 de janeiro
矮行星	Planeta anão
公曆一月五日	5 de janeiro
公曆一月六日	6 de janeiro
電子	Elétron
公曆一月七日	7 de janeiro
公曆一月八日	8 de janeiro
公曆一月九日	9 de janeiro
公曆一月十日	10 de janeiro
公曆一月十一日	11 de janeiro
公曆一月十二日	12 de janeiro
公曆一月十三日	13 de janeiro
公曆一月十四日	14 de janeiro
公曆一月十五日	15 de janeiro
工業革命	Revolução Industrial
苯	Benzeno
微軟	Microsoft
質子	Próton
庫魯夫	Kurów
公曆二月五日	5 de fevereiro
公曆二月八日	8 de fevereiro
化學	Química
中子	Nêutron
公曆二月廿九日	29 de fevereiro
公曆三月十四日	14 de março
一九八九年	1989
一九八八年	1988
一九八七年	1987
一九八六年	1986
一九八五年	1985
一九八四年	1984
一九八三年	1983
一九八二年	1982
一九八一年	1981
一九八〇年	1980
一九七〇年	1970
一九七一年	1971
一九七二年	1972
一九七三年	1973
一九七四年	1974
一九七五年	1975
一九七六年	1976
一九七七年	1977
一九七八年	1978
一九七九年	1979
一九六九年	1969
公曆四月五日	5 de abril
衛星	Satélite natural
公曆五月四日	4 de maio
土衛六	Titã (satélite)
一九六八年	1968
一九六七年	1967
一九六六年	1966
一九六五年	1965
一九六四年	1964
公曆六月廿日	20 de junho
公曆七月廿三日	23 de julho
足球	Futebol
一九六三年	1963
一九六二年	1962
公曆九月十日	10 de setembro
公曆十二月卅一日	31 de dezembro
公曆十月十日	10 de outubro
灶神星	4 Vesta
查理曼	Carlos Magno
木衛一	Io (satélite)
木衛四	Calisto (satélite)
木衛二	Europa (satélite)
木衛三	Ganímedes (satélite)
火	Fogo
新南威爾士州	Nova Gales do Sul
土衛二	Encélado (satélite)
天衛三	Titânia (satélite)
海衛一	Tritão (satélite)
雅加達	Jacarta
一九六一年	1961
Category:模板	Categoria:!Predefinições Wikipédia
一九六〇年	1960
小行星	Asteroide
日食	Eclipse solar
二進制	Sistema de numeração binário
阿斯圖里亞斯	Astúrias
維基大典:沙盒	Wikipédia:Página de testes
卡爾梅克共和國	Calmúquia
代數學	Álgebra
地圖	Mapa
阿拉貢自治區	Aragão
前卅三年	33 a.C.
硫酸	Ácido sulfúrico
同海機場	Aeroporto de Dong Hoi
Category:大韓民國紀事	Categoria:História da Coreia do Sul
Category:日本史	Categoria:História do Japão
伯力	Khabarovsk
Category:越南史	Categoria:História do Vietnã
孔子	Confúcio
莎拉伯恩哈特	Sarah Bernhardt
Category:伊拉克史	Categoria:História do Iraque
南加州大学	Universidade do Sul da Califórnia
Category:數學	Categoria:Matemática
Category:蒙古史	Categoria:História da Mongólia
Category:人造語言	Categoria:Línguas artificiais
文藝復興	Renascimento
歐元	Euro
美金	Dólar dos Estados Unidos
地中海	Mar Mediterrâneo
遼	Dinastia Liao
杭州市	Hangzhou
基督教	Cristianismo
Template:亞洲	Predefinição:Países da Ásia
Template:然也	Predefinição:Concordo
金朝	Dinastia Jin (1115-1234)
柏林圍牆	Muro de Berlim
稻	Arroz
大陸	Continente
京	Capital
Template:門	Predefinição:Portal
一九四八年	1948
艾爾瑪善鎮	Almazán
黃現璠	Huang Xianfan
一九四五年	1945
一九五八年	1958
日語	Língua japonesa
百科全書	Enciclopédia
維基大典:卷首	Wikipédia:Página principal
一九五九年	1959
Template:正典	Predefinição:Artigo bom
電晶體	Transístor
棒球	Basebol
奧林匹克運動會	Jogos Olímpicos
長江	Rio Yangtzé
喜瑪拉雅山	Himalaia
落磯山	Montanhas Rochosas
韃靼斯坦共和國	Tartaristão
一二六三年	1263
古斯巴達	Esparta
埃斯特雷馬杜拉	Estremadura (Espanha)
安達盧西亞	Andaluzia
麥加	Meca
毛澤東	Mao Tsé-Tung
西安市	Xian
拉薩市	Lassa
哲學	Filosofia
Category:速刪候	Categoria:!Páginas para eliminação rápida
茶	Chá
馬可·波羅	Marco Polo
一三六三年	1363
共產主義	Comunismo
一三六八年	1368
迦太基	Cartago
大英博物館	Museu Britânico
巴拉頓湖	Lago Balaton
蒙庇利埃	Montpellier
Category:天文	Categoria:Astronomia
吉他	Guitarra
同性戀	Homossexualidade
漢堡包	Hambúrguer
夸克	Quark
高斯	Carl Friedrich Gauss
一六四四年	1644
一六四五年	1645
Category:恒星	Categoria:Estrelas
李白	Li Bai
伽羅華	Évariste Galois
政府	Governo
秦始皇帝	Qin Shihuang
秦二世皇帝	Qin Er Shi
中東	Médio Oriente
漢	Dinastia Han
漢太祖高皇帝	Imperador Gaozu de Han
漢孝惠皇帝	Hui de Han
漢太宗孝文皇帝	Imperador Wen de Han
漢孝景皇帝	Imperador Jing de Han
漢世宗孝武皇帝	Wu de Han
聖女貞德	Joana d'Arc
漢孝昭皇帝	Zhaodi
漢中宗孝宣皇帝	Xuan de Han
漢孝元皇帝	Yuan de Han
漢孝成皇帝	Cheng de Han
漢孝哀皇帝	Aidi de Han
漢孝平皇帝	Imperador Ping de Han
漢孺子嬰	Ruzi Ying
王莽	Wang Mang
意理	Ideologia
帝國主義	Imperialismo
漢更始帝	Liu Xuan (imperador)
漢世祖光武皇帝	Guang Wudi
共和	República
漢顯宗孝明皇帝	Ming de Han
國	Estado
漢肅宗孝章皇帝	Imperador Zhang de Han
漢孝安皇帝	Han Andi
漢孝順皇帝	Shundi
漢孝沖皇帝	Chong de Han
漢孝質皇帝	Zhi de Han
漢孝桓皇帝	Huandi
漢孝靈皇帝	Lingdi
元	Dinastia Yuan
漢孝獻皇帝	Xiandi
德意志第三帝國	Alemanha Nazi
哥倫布	Cristóvão Colombo
庫克船長	James Cook
科爾蒂斯	Hernán Cortés
鄭和	Zheng He
大堡礁	Grande Barreira de Coral
巴拿馬運河	Canal do Panamá
晉	Dinastia Jin (265-420)
黃河	Rio Amarelo
晉武帝	Sima Yan
晉元帝	Imperador Yuan de Jin
隋	Dinastia Sui
西夏	Império Tangut
脫氧核酸	Ácido desoxirribonucleico
趙宋	Dinastia Sung
宋太祖	Song Taizu
宋徽宗	Hongxian
宋度宗	Duzong
歐拉	Leonhard Euler
一七七四年	1774
一七七五年	1775
一七七六年	1776
一八六六年	1866
一八六七年	1867
一八六八年	1868
晝	Manhã
拿破崙二世	Napoleão II de França
砒霜	Trióxido de arsênio
法律	Direito
一七九四年	1794
世界人權宣言	Declaração Universal dos Direitos Humanos
一七九五年	1795
一七九六年	1796
漢語	Língua chinesa
細胞	Célula
全球暖化	Aquecimento global
禪宗	Zen
鼠標	Rato (informática)
聖奧思定	Agostinho de Hipona
精靈	Fada
朊	Proteína
理則	Lógica
龍捲風	Tornado
幾何	Geometria
語法	Gramática
熱帶氣旋	Ciclone tropical
計學	Economia
語言學	Linguística
文字	Sistema de escrita
阿拉伯字	Alfabeto árabe
漢字	Caracteres chineses
西里爾字母	Alfabeto cirílico
孫子兵法	A Arte da Guerra
Category:音樂	Categoria:Música
紅樓夢	O Sonho da Câmara Vermelha
Category:法國史	Categoria:História da França
哈利波特	Harry Potter
放手銃	Masturbação
法文維基大典	Wikipédia em francês
死刑	Pena de morte
人權	Direitos humanos
乳	Leite
山	Montanha
沙漠	Deserto
孫文	Sun Yat-sen
薩拉丁	Saladino
阿育王	Asoka
阿克巴大帝	Akbar
香港	Hong Kong
韓戰	Guerra da Coreia
南北戰爭	Guerra de Secessão
首爾特別市	Seul
上海市	Xangai
清	Dinastia Qing
越戰	Guerra do Vietnã
歐几里得	Euclides
巴斯克語	Língua basca
星座	Constelação
拉脫維亞語	Língua letã
原子	Átomo
宗教	Religião
朝鮮語	Língua coreana
笛卡兒	René Descartes
官話	Língua mandarim
越南語	Língua vietnamita
猶太教	Judaísmo
老子	Lao Zi
電鼠	Pikachu
尼采	Friedrich Nietzsche
司馬遷	Sima Qian
斯密亞丹	Adam Smith
朱熹	Zhu Xi
廷巴克圖	Tombuctu
洋	Oceano
阿奎那	Tomás de Aquino
英王維多利亞	Vitória do Reino Unido
釋迦牟尼	Sidarta Gautama
馬丁·路德	Martinho Lutero
儒家	Confucionismo
腹	Abdómen
陰脈	Veia
福克蘭群島	Ilhas Malvinas
陽脈	Artéria
唐	Dinastia Tang
威爾斯王妃黛安娜	Diana, Princesa de Gales
唐高祖	Imperador Gaozu de Tang
唐太宗	Imperador Taizong de Tang
唐宣宗	Xuanzong II
小學	Escola primária
明	Dinastia Ming
明太祖	Zhū Yuánzhāng
明成祖	Yongle
明宣宗	Xuande
明武宗	Imperador Zhengde
明世宗	Jiajing
明神宗	Imperador Wanli
電漿	Plasma
北斗七星	Grande Carro
金正日	Kim Jong-il
元素週期表	Tabela periódica
自殺	Suicídio
九一一事件	Ataques de 11 de setembro de 2001
電話	Telefone
梵語	Sânscrito
化合物	Composto químico
算術	Aritmética
食鹽	Sal de cozinha
化學元素	Elemento (química)
方程	Equação
映射	Função (matemática)
角	Ângulo
分子	Molécula
加速度	Aceleração
能量	Energia
弈	Go
金屬	Metal
氣體	Gás
液體	Líquido
固體	Sólido
船舶	Navio
農	Agricultura
速度	Velocidade
納米科技	Nanotecnologia
勾股定理	Teorema de Pitágoras
證明	Prova matemática
數	Número
複數	Número complexo
公斤	Quilograma
公尺	Metro
大麥	Cevada
繪畫	Pintura
華爾街	Wall Street
美國總統	Presidente dos Estados Unidos
東南亞	Sudeste Asiático
瀋陽市	Shenyang
重慶市	Chongqing
天津市	Tianjin
武漢市	Wuhan
史前	Pré-história
古埃及	Antigo Egito
白令海峽	Estreito de Bering
古希臘	Grécia Antiga
傑弗遜	Thomas Jefferson
希臘文維基大典	Wikipédia em grego
麥	Trigo
格里曆	Calendário gregoriano
拉丁文維基大典	Wikipédia em latim
麻雀 (棋牌)	Mahjong
鹽	Sal
牛頓（單位）	Newton (unidade)
度量衡	Medição
萬國公制	Sistema Internacional de Unidades
集論	Teoria dos conjuntos
哈里發塔	Burj Khalifa
長城	Muralha da China
整數	Número inteiro
球	Esfera
大憲章	Magna Carta
阿兹特克	Astecas
上塞納省	Altos do Sena
東羅馬帝國	Império Bizantino
奧斯曼帝國	Império Otomano
國內生產總值	Produto interno bruto
銃	Arma de fogo
伊比利半島	Península Ibérica
坦克	Carro de combate
實數	Número real
楈枒	Coqueiro
桃	Pessegueiro
冰酪	Sorvete
文胸	Sutiã
阿拉伯語	Língua árabe
本州	Honshu
四國	Shikoku
地中海氣候	Clima mediterrânico
科西嘉	Córsega
頂級域名	Domínio de topo
斯洛文尼亞語維基大典	Wikipédia em esloveno
百度	Baidu
澳門	Macau
土衛一	Mimas (satélite)
土衛四	Dione (satélite)
土衛三	Tétis (satélite)
土衛五	Reia (satélite)
廣東省	Guangdong
廣西壯族自治區	Guangxi
蘇聯	União Soviética
亡神星	90482 Orco
塞德娜	90377 Sedna
孟德斯鳩	Montesquieu
維基大典:卓著	Wikipédia:Artigos destacados
Template:Link FA	Predefinição:Link FA
維基大典:會館	Wikipédia:Esplanada
釜山廣域市	Busan
廣州市	Cantão (China)
蔣中正	Chiang Kai-shek
南京市	Nanquim
君士坦丁堡	Constantinopla
首爾地鐵	Metropolitano de Seul
北京大學	Universidade de Pequim
清華大學	Universidade Tsinghua
烏魯木齊市	Ürümqi
江蘇省	Jiangsu
浙江省	Zhejiang
鄧小平	Deng Xiaoping
新好男孩	Backstreet Boys
西藏	Tibete
西藏自治區	Região Autônoma do Tibete
圓	Círculo
歐氏幾何	Espaço euclidiano
周恩來	Zhou Enlai
中國共產黨	Partido Comunista da China
馮諾曼	John von Neumann
偽基大典	Uncyclopedia
太平山	Victoria Peak
公理	Axioma
清聖祖	Kangxi
朝鮮文維基大典	Wikipédia em coreano
檀香山	Honolulu
紋章	Heráldica
曼徹斯特聯足球俱樂部	Manchester United Football Club
平壤直轄市	Pyongyang
模 (代數)	Módulo (álgebra)
九	Nove
清高宗	Qianlong
司徒華	Szeto Wah
蕭伯納	George Bernard Shaw
黑龍江省	Heilongjiang
香港島	Ilha de Hong Kong
鹼金屬	Metal alcalino
非金屬	Não metal
鹵素	Halogênio
稀有氣體	Gás nobre
維基大典:正典	Wikipédia:Artigos bons
四川省	Sichuan
舊約	Antigo Testamento
聖誕節	Natal
三角形	Triângulo
印歐語系	Línguas indo-europeias
穆阿邁爾·格達費	Muammar al-Gaddafi
獨島	Rochedos de Liancourt
江南區	Gangnam-gu
大田廣域市	Daejeon
大邱廣域市	Daegu
仁川國際機場	Aeroporto Internacional de Incheon
仁川廣域市	Incheon
京畿道	Gyeonggi
自然數	Número natural
萬國音標字	Alfabeto fonético internacional
河北省	Hebei
革奴自由文檔許可協議	GNU Free Documentation License
臺灣	Ilha Formosa
紐約	Nova Iorque (desambiguação)
汝矣島	Yeouido
公元元年	1
魯迅	Lu Xun (escritor)
八	Oito
馬德堡半球	Hemisférios de Magdeburgo
主禱文	Pai Nosso
蒜	Alho
白	Branco
黑	Preto
六九八年	698
巴爾幹半島	Bálcãs
七二七年	727
墨索里尼	Benito Mussolini
四方	Ponto cardeal
十	Dez
原子序	Número atómico
九一八年	918
公元百年	100
五七〇年	570
四時	Estação do ano
二二二年	222
利物浦	Liverpool
鐵達尼號	RMS Titanic
五五二年	552
同位素	Isótopo
蜚蠊	Barata
功率	Potência
螢	Vaga-lume
索布語	Línguas sorábias
一八一二年戰爭	Guerra anglo-americana de 1812
頂點	Vértice
大理國	Reino de Dali
福岡市	Fukuoka (cidade)
建城	Ab urbe condita
日本海	Mar do Japão
中亞	Ásia Central
琉球國	Reino de Ryukyu
伽倻	Confederação Gaya
朝鮮國	Dinastia Joseon
高麗國	Goryeo
大韓帝國	Império Coreano
渤海國	Balhae
高句麗	Koguryo
百濟	Baekje
新羅	Silla (Coreia)
奧匈帝國	Áustria-Hungria
吸血鬼日記	The Vampire Diaries (série)
馬雅	Civilização maia
印加國	Império Inca
縣	Condado
韓非子	Han Fei
錦州市	Jinzhou
導數	Derivada
黃帝	Huangdi
釣魚臺列嶼	Ilhas Senkaku
中國	China (civilização)
成都市	Chengdu
咖啡廳	Café (estabelecimento)
蒲公英	Taraxacum
雪豹	Leopardo-das-neves
白話維基大典	Wikipédia em chinês
二二一年	221
五四三年	543
五三六年	536
二三〇年	230
二〇二年	202
一九二年	192
總統	Presidente
五五五年	555
五七一年	571
滿洲國	Manchukuo
二三一年	231
二二五年	225
三一一年	311
二二〇年	220
三一三年	313
五八七年	587
五四八年	548
五四九年	549
五五一年	551
五五七年	557
二二三年	223
二二四年	224
二一九年	219
大運河	Grande Canal da China
五八九年	589
華佗	Hua Tuo
三〇四年	304
五五〇年	550
五八六年	586
五八八年	588
五五四年	554
二二九年	229
五八三年	583
二六五年	265
二六三年	263
五八五年	585
五八二年	582
五五六年	556
四二〇年	420
二八〇年	280
五八一年	581
五五八年	558
切羅基語	Língua cherokee
羅素悖論	Paradoxo de Russell
五六九年	569
贛語	Chinês gan
爪哇語	Língua javanesa
滿語	Língua manchu
弧度	Radiano
三〇七年	307
杜甫	Du Fu
人口	População
瓦爾帕萊索	Valparaíso (Chile)
青銅	Bronze
情報及特殊使命局	Mossad
尼亞加拉瀑布	Cataratas do Niágara
吳語	Língua wu
昭和天皇	Hirohito
基地組織	Al-Qaeda
穆罕默德二世	Maomé II, o Conquistador
希臘神話	Mitologia grega
秦	Qin (estado)
新疆維吾爾族自治區	Xinjiang
萬國首都全覽	Lista de capitais nacionais
周	Dinastia Zhou
形而上學	Metafísica
白宮	Casa Branca
北海道	Hokkaido
科科斯（基林）群島	Ilhas Cocos (Keeling)
胡志明	Ho Chi Minh
明尼阿波利斯	Minneapolis
集	Conjunto
順化市	Huế
閩東語	Língua min oriental
閩南語	Min Nan
離子	Íon
壯族	Zhuang (etnia)
南斯拉夫	Jugoslávia
長毛象	Mamute
四邊形	Quadrilátero
甘蔗	Cana-de-açúcar
三船敏郎	Toshiro Mifune
線	Reta
甲烷	Metano
孫武	Sun Tzu
中央情報局	Central Intelligence Agency
語法學	Sintaxe
聯合國安全理事會	Conselho de Segurança das Nações Unidas
眼鏡	Óculos
火柴	Palito de fósforo
多邊形	Polígono
市場	Mercado
南海	Mar da China Meridional
朝鮮世宗	Rei Sejong
俳句	Haiku
黃海	Mar Amarelo
今上天皇	Akihito
橫濱市	Yokohama
普魯士	Prússia
前四年	4 a.C.
柳州市	Liuzhou
皇帝	Imperador
索契	Sóchi
壓強	Pressão
龍貓	Tonari no Totoro
线粒体	Mitocôndria
吠陀	Vedas
橢圓	Elipse
杠杆	Alavanca
蟹	Caranguejo
前九十年	90 a.C.
酸鹼度	PH
美國革命	Guerra da Independência dos Estados Unidos
安徽省	Anhui
前九十一年	91 a.C.
忠清北道	Chungcheong do Norte
忠清南道	Chungcheong do Sul
內蒙古自治區	Mongólia Interior
金日成	Kim Il-sung
慶尚南道	Gyeongsang do Sul
慶尚北道	Gyeongsang do Norte
全羅北道	Jeolla do Norte
全羅南道	Jeolla do Sul
濟州特別自治道	Jeju
鬱陵島	Ulleungdo
巴別塔	Torre de Babel
蔚山廣域市	Ulsan
光州廣域市	Gwangju
一元二次方程	Equação quadrática
李斯特	Franz Liszt
美式足球	Futebol americano
前八十七年	87 a.C.
哥德爾	Kurt Gödel
摩爾	Mol
華國鋒	Hua Guofeng
烷烴	Alcano
希爾伯特	David Hilbert
前九十五年	95 a.C.
黃金分割	Proporção áurea
福建省	Fujian
班夫國家公園	Parque Nacional Banff
查士丁尼一世	Justiniano
前七十四年	74 a.C.
安東市	Andong
阿貝爾·塔斯曼	Abel Tasman
海南省	Hainan
功	Trabalho (física)
漢語拼音	Pīnyīn
莽原氣候	Savana
甘肅省	Gansu
蘇州市	Suzhou
溫州市	Wenzhou
無錫市	Wuxi
紹興市	Shaoxing
寧波市	Ningbo
紙鳶	Pipa (brinquedo)
前二〇一年	201 a.C.
前二〇二年	202 a.C.
哈爾濱市	Harbin
油	Óleo
拓撲學	Topologia (matemática)
文身	Tatuagem
金融學	Finanças
雲南省	Yunnan
多項式	Polinómio
山東省	Shandong
中南半島	Indochina
天擇	Seleção natural
地質年代	Escala de tempo geológico
壟斷	Monopólio
河南省	Henan
遼寧省	Liaoning
席德	O Cid
刳剔者傑克	Jack, o Estripador
前一五六年	156 a.C.
列奧尼達一世	Leónidas I
前一三九年	139 a.C.
前一二二年	122 a.C.
前二〇六年	206 a.C.
西爾門·拉什迪	Salman Rushdie
前二〇三年	203 a.C.
化學鍵	Ligação química
槍	Lança
前一四一年	141 a.C.
僧院	Mosteiro
白堊紀	Cretáceo
前二〇九年	209 a.C.
皮薩羅	Francisco Pizarro
點	Ponto (matemática)
骰子	Dado
吉林省	Jilin
東海	Mar da China Oriental
前二三二年	232 a.C.
湖南省	Hunan
青海省	Qinghai
前一九七年	197 a.C.
前二〇七年	207 a.C.
前一八八年	188 a.C.
矢	Flecha
前二〇五年	205 a.C.
鮨	Sushi
前二〇八年	208 a.C.
湖北省	Hubei
山西省	Shanxi
魔方	Cubo de Rubik
伊洛瓦底省	Ayeyarwady (divisão)
貴州省	Guizhou
京都議定書	Protocolo de Quioto
聯合國大會	Assembleia Geral das Nações Unidas
乙酸	Ácido etanoico
安達曼海	Mar de Andamão
前二〇四年	204 a.C.
胡適	Hu Shi
莊子	Chuang-Tzu
清孝欽顯皇后	Tseu-Hi
陝西省	Shaanxi
Template:共享類	Predefinição:Commonscat
三八三年	383
德文維基大典	Wikipédia em alemão
拋物線	Parábola
尿素	Ureia
平假名	Hiragana
波斯文維基大典	Wikipédia em persa
質數	Número primo
五七二年	572
南北朝	Dinastias do Norte e do Sul
吾世	Minecraft
罷工	Greve
李舜臣汝諧	Yi Sun-sin
泰國地方	Subdivisões da Tailândia
中華人民共和國地方	Subdivisões da República Popular da China
日本都道府縣	Prefeituras do Japão
氧化物	Óxido
合數	Número composto
因數	Divisor
口琴	Harmónica (instrumento musical)
朝鮮灣	Golfo da Coreia
Template:Taxobox	Predefinição:Info/Taxonomia
繩文時代	Período Jomon
魔法少女小圓	Puella Magi Madoka Magica
平行	Retas paralelas
極品飛車	Need for Speed
海鳥	Ave oceânica
琉球語	Línguas ryukyuanas
閩語	Línguas min
莆仙語	Língua putian
江西省	Jiangxi
阿卜杜拉·本·阿卜杜勒-阿齊茲·沙特	Abdullah da Arábia Saudita
寧夏回族自治區	Ningxia
揚州市	Yangzhou
鎮江市	Zhenjiang
哈薩克文維基大典	Wikipédia em cazaque
嘉興市	Jiaxing
石家莊市	Shijiazhuang
亞當與夏娃	Adão e Eva
卡金納答	Kakinada
珠海	Zhuhai
韶關市	Shaoguan
東莞市	Dongguan
維吾爾文維基大典	Wikipédia em uigure
俄羅斯正教會	Igreja Ortodoxa Russa
鯢	Salamandra-gigante-da-china
空師	Força aérea
大名	Daimiô
色盲檢測圖	Teste de cores de Ishihara
威氏鷸	Gallinago delicata
哈布斯堡氏	Casa de Habsburgo
中央銀行	Banco central
福州市	Fucheu
南平市	Nanping
莆田市	Putian
三明市	Sanming
泉州市	Quanzhou
廈門市	Xiamen
漳州市	Zhangzhou
龍岩市	Longyan
西寧市	Xining
西遊記	Jornada ao Oeste
三國演義	Romance dos Três Reinos
福島縣	Fukushima
豬油	Banha
鞍山市	Anshan (China)
羅馬治世	Pax Romana
克羅內克	Leopold Kronecker
康托爾	Georg Cantor
戴德金	Richard Dedekind
寒武紀	Cambriano
十六元數	Sedeniões
神聖羅馬皇帝腓特烈一世	Frederico I da Germânia
前三八七年	387 a.C.
盲文	Braille
千葉縣	Chiba
賽珍珠	Pearl S. Buck
聯合國秘書長	Secretário-geral das Nações Unidas
龐加萊	Henri Poincaré
西北水道	Passagem do Noroeste
十進制	Sistema de numeração decimal
烯烴	Alceno
皇祚	Kimi ga Yo
氣壓	Pressão atmosférica
箸	Hashi
標點符號	Pontuação
英格蘭王表	Lista de monarcas da Inglaterra
片假名	Katakana
民之旨	Jana Gana Mana
臺北一零一	Taipei 101
化學式	Fórmula química
波斯	Pérsia
群 (代數)	Grupo (matemática)
天安門	Porta de Tiannamen
水星領航員	Aria (mangá)
三角函數	Função trigonométrica
六四事件	Protesto na Praça da Paz Celestial em 1989
趙紫陽	Zhao Ziyang
胡耀邦	Hu Yaobang
安樂死	Eutanásia
姓氏	Sobrenome
醛	Aldeído
規	Compasso (geometria)
物質之量	Quantidade de substância
平安北道	Pyongan Norte
咸鏡南道	Hamgyong Sul
島國	País insular
尺規作圖	Construções com régua e compasso
京都府	Quioto (província)
絕對值	Função modular
羅賓漢	Robin Hood
表數法	Sistema de numeração
大阪府	Osaka
瑪瑙	Ágata
愛媛縣	Ehime
圓錐曲線	Cónica
海平面	Nível médio do mar
玄武	Tartaruga Negra
羅馬皇帝表	Lista de imperadores romanos
矢量空間	Espaço vetorial
距	Distância
臺灣海峽	Estreito de Taiwan
山口縣	Yamaguchi
市盈率	Índice Preço/Lucro
神奈川縣	Kanagawa
中國地方	Região de Chugoku
長野縣	Nagano
殷商	Dinastia Shang
色諾芬	Xenofonte
兵庫縣	Hyōgo
廣州恆大淘寶蹴鞠會	Guangzhou Evergrande Football Club
關係 (數學)	Relação binária
等價	Relação de equivalência
主格	Caso nominativo
泰國灣	Golfo da Tailândia
螳螂	Louva-a-deus
維基大典:書海	Wikipédia:Fontes bibliográficas
征夷大將軍	Xogum
春節	Ano-novo chinês
切腹	Seppuku
色盲	Daltonismo
阿什莫爾島與卡捷島	Ilhas Ashmore e Cartier
農曆	Calendário chinês
可樂	Bebida de cola
高知縣	Kōchi
道德經	Tao Te Ching
萬有引力	Lei da gravitação universal
坐標幾何	Geometria analítica
芬瑟島	Ilha Fraser
蹴鞠	Cuju
與格	Caso dativo
摩爾質量	Massa molar
滿洲族	Manchu
義大利半島	Península Itálica
汽水	Refrigerante
天象館	Planetário
微積分	Cálculo
岳陽市	Yueyang
李斯	Lǐ Sī
碗	Tigela
全等	Congruência (geometria)
義勇軍進行曲	Marcha dos Voluntários
數理物理	Física matemática
紅花	Carthamus tinctorius
大正天皇	Imperador Taishō
毛納洛峰	Mauna Loa
富牌國際機場	Aeroporto Internacional de Phu Bai
修道院	Abadia
符節	Senha
環 (代數)	Anel (matemática)
環球小姐	Miss Universo
香川縣	Kagawa
曲線	Curva
平面幾何	Geometria euclidiana
葉問	Yip Man
基數	Número cardinal
二元運算	Operação binária
餘弦定理	Lei dos cossenos
新幹線	Shinkansen
雙曲線	Hipérbole
星際爭霸	StarCraft
反射	Reflexão (física)
形意拳	Hsing-i chuan
近視	Miopia
代數數	Número algébrico
夏后氏	Dinastia Xia
連續	Função contínua
教廷諸屬國	Estados Papais
濟南市	Jinan
十一月革命	Revolução Alemã de 1918-1919
中國抗日戰爭	Segunda Guerra Sino-Japonesa
青島市	Qingdao
PSP	PlayStation Portable
葛利斯五八一丙	Gliese 581 c
官能團	Funções orgânicas
世氣公會	Organização Meteorológica Mundial
見即所得	WYSIWYG
新西班牙代王領	Vice-Reino da Nova Espanha
織田信長	Oda Nobunaga
向日葵	Girassol
南昌市	Nanchang
玫瑰之名	O Nome da Rosa
幾何原本	Os Elementos
米高·哥連斯	Michael Collins
金本位	Padrão-ouro
直積	Produto cartesiano
艾狄胥	Paul Erdős
四元數	Quaterniões
長沙市	Changsha
有機化合物	Composto orgânico
明治天皇	Imperador Meiji
源實朝	Minamoto no Sanetomo
蜉蝣	Ephemeroptera
伊藤博文	Ito Hirobumi
絞刑	Forca
門:史	Portal:História
電極	Eletrodo
阿拉伯數字	Algarismos indo-arábicos
股骨	Fêmur
子集	Subconjunto
海東青	Falcão-gerifalte
日文維基大典	Wikipédia em japonês
繁體字	Chinês tradicional
甲午戰爭	Primeira Guerra Sino-Japonesa
克里希那穆提	Jiddu Krishnamurti
宦官	Eunuco
選擇公理	Axioma da escolha
行星環	Anel planetário
青藏高原	Planalto do Tibete
拓撲空間	Espaço topológico
古文書	Paleografia
數學符表	Tabela de símbolos matemáticos
錫克金廟	Harmandir Sahib
卡奔塔利亞灣	Golfo de Carpentária
度量空間	Espaço métrico
千分比	Por mil
交換群	Grupo abeliano
高雄市	Kaohsiung
華盛頓歐文	Washington Irving
易經	I Ching
弩	Besta (arma)
渤海	Mar de Bohai
甑帶瘡	Herpes-zóster
西楚霸王	Xiang Liang
戰艦	Couraçado
海倫公式	Teorema de Herão
昆明市	Kunming
天氣預報	Previsão do tempo
人蔘	Panax ginseng
回族	Hui (povo)
蘭州市	Lanzhou
期貨	Contrato de futuros
鰂	Choco
三國	Três Reinos
春秋時代	Período das Primaveras e Outonos
戰國	Período dos Reinos Combatentes
名偵探柯南	Detective Conan
區間	Intervalo (matemática)
清宣統帝	Imperador Pu Yi
併集	União (matemática)
簡化字	Chinês simplificado
合肥市	Hefei
交集	Interseção
常染色體	Autossomo
簡歷	Curriculum vitæ
蝴蝶效應	Efeito borboleta
豐臣秀吉	Toyotomi Hideyoshi
假名	Kana (escrita)
民律大全	Corpus Juris Civilis
白鱀豚	Lipotes vexillifer
弦	Corda (geometria)
平昌郡	Pyeongchang
泰國國際航空	Thai Airways International
北九州市	Kitakyushu
匈奴	Xiongnu
孟子	Mêncio
桂林市	Guilin
海口市	Haikou
無機化合物	Composto inorgânico
域 (代數)	Corpo (matemática)
海拔	Altitude
挪威廣播公司	NRK
道	Tao
世界語維基大典	Wikipédia em esperanto
刺身	Sashimi
中泰國	Região Central (Tailândia)
高錳酸鉀	Permanganato de potássio
鴉片戰爭	Primeira Guerra do Ópio
魔鬼之詩篇	The Satanic Verses
有序對	Par ordenado
金屬鍵	Ligação metálica
書面挪威語維基大典	Wikipédia em norueguês
序數	Número ordinal
南京大屠殺	Massacre de Nanquim
吳廷琰	Ngo Dinh Diem
複式記帳	Método das partidas dobradas
路易斯安那購地案	Compra da Luisiana
扇	Leque
平安時代	Período Heian
旦	Nascer do sol
韓信點兵	Teorema chinês do resto
梅涅勞斯定理	Teorema de Menelaus
無窮小	Infinitesimal
單鏡筒反光相機	Câmera reflex monobjetiva
張飛	Zhang Fei
張郃	Zhang He
張角	Zhang Jiao
張衡	Zhang Heng
張居正	Zhang Juzheng
憲法十七條	Constituição dos dezassete artigos
張遼	Zhang Liao
張三丰	Chang San Feng
趙 (釋義)	Zhao
趙	Zhao (Estado)
趙雲	Zhao Yun
鄭成功	Koxinga
鍾會	Zhong Hui
周泰	Zhou Tai
周瑜	Zhou Yu
帝顓頊	Zhuanxu
諸葛亮	Zhuge Liang
壯學	Zhuangologia
烏克蘭語維基大典	Wikipédia em ucraniano
阿拉伯文維基大典	Wikipédia em árabe
金孟加拉	Amar Shonar Bangla
希伯來文維基大典	Wikipédia em hebraico
洞里薩湖	Tonle Sap
賈姆謝德布爾	Jamshedpur
越南文維基大典	Wikipédia em vietnamita
負數	Número negativo
中醫	Medicina tradicional chinesa
高松市	Takamatsu
提格兰二世	Tigranes, o Grande
珠江	Rio das Pérolas
泰西格致史	História da ciência
五帝	Três Augustos e os Cinco Imperadores
瑪格麗特一世	Margarida I da Dinamarca
日本國會	Dieta do Japão
先哥倫布	Era pré-colombiana
英聯邦王國	Reinos da Comunidade de Nações
彼得一世島	Ilha de Pedro I
墓碑	Lápide
十二銅表法	Lei das Doze Tábuas
漢魏武王	Cao Cao
斬首	Decapitação
垂直	Perpendicularidade
無窮集合	Conjunto infinito
冪集	Conjunto de partes
魚鉤	Anzol
齊齊哈爾市	Qiqihar
椰蟹	Caranguejo-dos-coqueiros
俄文維基大典	Wikipédia em russo
平行公理	Postulado das paralelas
春武里府	Chon Buri (província)
西線無戰事	Im Westen nichts Neues
嘧啶	Pirimidina
泰王國歌	Phleng Chat
冬至	Solstício de inverno
中國中央電視臺	Televisão Central da China
圖蘭朵	Turandot
巴列維王朝	Dinastia Pahlavi
天皇	Imperador do Japão
熱帶雨林氣候	Clima equatorial
袁世凱	Yuan Shikai
北海市	Beihai
袋鼠島	Ilha Kangaroo
阮世祖	Gia Long
君士坦丁堡普世宗主教區	Patriarcado Ecumênico de Constantinopla
辛普生沙漠	Deserto de Simpson
雷曼兄弟公司	Lehman Brothers
娜塔莎·北鼎斐	Natasha Bedingfield
開集	Conjunto aberto
測地線	Geodésica
塞瓦定理	Teorema de Ceva
健陀羅	Gandara
愛爾蘭共和國總統	Presidente da Irlanda
內積空間	Produto interno
金奎植	Kim Kyu-sik
江戶	Edo
金九	Kim Gu
泰山	Monte Tai
九江市	Jiujiang
反氫	Anti-hidrogênio
占婆	Champa
倒數	Inverso multiplicativo
黃道兇賊	Assassino do Zodíaco
陰陽五行	Cinco elementos (filosofia chinesa)
盧溝橋事變	Incidente da Ponte Marco Polo
關羽	Guan Yu
龜	Testudinata
阮福晪	Bao Dai
空集	Conjunto vazio
祖沖之	Tsu Ch'ung Chih
羅馬 (釋義)	Roma (desambiguação)
連通	Conectividade (teoria dos grafos)
瀨戶內海	Mar Interior de Seto
自由民主黨	Partido Liberal Democrata (Japão)
環	Loop
利瑪竇	Matteo Ricci
原富	A Riqueza das Nações
技術分析	Análise técnica
哆啦A夢	Doraemon
宋卡府	Songkhla (província)
甲米府	Krabi (província)
拉廊府	Ranong (província)
伏羲	Fu Xi
法家	Legalismo (filosofia chinesa)
九龍	Kowloon
瑪麗·安·尼科爾斯	Mary Ann Nichols
素叻府	Surat Thani (província)
成本	Custo
桐艾府	Trat (província)
五代	Período das Cinco Dinastias e dos Dez Reinos
瑪麗·簡·凱利	Mary Jane Kelly
森理世	Riyo Mori
補集	Complementar
靖國神社	Santuário Yasukuni
博他侖府	Phatthalung (província)
鹽田	Salina
班武里府	Prachuap Khiri Khan (província)
洛坤府	Nakhon Si Thammarat (província)
春蓬府	Chumphon (província)
新北市	Nova Taipé
臺中市	Taichung
漢昭烈皇帝	Liu Bei
邁克學搖滾	Michael Learns to Rock
金門縣	Kinmen
基隆市	Keelung
從眾	Argumentum ad populum
牢不可破之聯盟	Hino nacional da União Soviética
相似	Semelhança
年號	Nome de era
語序	Ordem dos constituintes
摩托羅拉	Motorola
丁汝昌	Ding Ruchang
伊麗莎白·史泰德	Elizabeth Stride
安妮·查普曼	Annie Chapman
聖德太子	Shōtoku Taishi
沈括	Shen Kuo
貴金屬	Metal precioso
懿德天皇	Imperador Itoku
史記	Registros do Historiador
早稻田大學	Universidade de Waseda
孫吳	Wu Oriental
論語	Analectos de Confúcio
尚眞王	Shō Shin
平清盛	Taira no Kiyomori
創意公用授權條款	Licenças Creative Commons
澳洲聯邦銀行	Commonwealth Bank
拉臘·杜塔	Lara Dutta
小野田寬郎	Hiroo Onoda
清太宗	Huang-Taiji
漢高皇后	Lu Hou
推古天皇	Imperatriz Suiko
清德宗	Guangxu
鎖國	Isolacionismo
戈登	Charles George Gordon
清世祖	Shunzhi
清太祖	Nurhachi
進數	Número p-ádico
卡拉卡拉敕令	Édito de Caracala
明智光秀	Akechi Mitsuhide
綏靖天皇	Imperador Suizei
阮攸	Nguyễn Du
白居易	Bai Juyi
吳大帝	Sun Quan
魏世祖文皇帝	Cao Pi
神農	Shennong
小淵惠三	Keizō Obuchi
帝舜	Shun (imperador chinês)
安寧天皇	Imperador An'nei
發勃耳	Jean-Henri Casimir Fabre
張國榮	Leslie Cheung
蔣經國	Chiang Ching-kuo
王維	Wang Wei
後醍醐天皇	Go-Daigo
桓武天皇	Imperador Kammu
林彪	Lin Biao
清世宗	Yongzheng
呂布	Lü Bu
鴨脷洲	Ap Lei Chau
清穆宗	Tongzhi
韓愈	Han Yu
王安石	Wang Anshi
德川吉宗	Tokugawa Yoshimune
拓撲閉包	Fecho
閉集	Conjunto fechado
曹魏	Cao Wei
作格	Caso ergativo
尖竹汶府	Chanthaburi (província)
陳省身	Shiing-Shen Chern
第十五屆亞洲運動會	Jogos Asiáticos de 2006
覆蓋	Cobertura aberta
竭澤而漁	Sobrepesca
廢藩置縣	Abolição do sistema han
通格	Caso absolutivo
清仁宗	Jiaqing
正親町天皇	Imperador Ogimachi
董卓	Dong Zhuo
林語堂	Lin Yutang
孫臏	Sun Pin
杜牧	Du Mu
孫堅	Sun Jian
石田三成	Ishida Mitsunari
婆羅多舞	Bharatanatyam
朝鮮世祖	Sejo de Joseon
歐陽脩	Ouyang Xiu
清宣宗	Daoguang
岳飛	Yue Fei
清文宗	Xianfeng
北柳府	Chachoengsao (província)
羅勇府	Rayong (província)
袁紹	Yuan Shao
柳宗元	Liu Zongyuan
司馬懿	Sima Yi
福澤諭吉	Fukuzawa Yukichi
安慶市	Anqing
安祿山	An Lushan
呂不韋	Lü Buwei
陳獨秀	Chen Duxiu
蒂邁歐篇	Timeu (diálogo)
魏 (釋義)	Wei
藤原定家	Fujiwara no Teika
夏侯惇	Xiahou Dun
曹仁	Cao Ren
坂本龍馬	Sakamoto Ryoma
朝鮮太祖	Taejo de Joseon
陸遜	Lu Xun
夏侯淵	Xiahou Yuan
李鴻章	Li Hongzhang
魏延	Wei Yan
黃忠	Huang Zhong
顧愷之	Gu Kaizhi
康托爾悖論	Paradoxo de Cantor
中秋	Festival da Lua
李珥	Yi I
光中帝	Nguyen Hue
尹鑴	Yun Hyu
孫策	Sun Ce
沙繳府	Sa Kaeo (província)
緊集	Espaço compacto
依善	Região Nordeste (Tailândia)
龐統	Pang Tong
高順	Gao Shun
成都雙流國際機場	Aeroporto Internacional de Chengdu Shuangliu
發翔羽	Penas de voo
赤腹蠑螈	Cynops pyrrhogaster
南陽市	Nanyang
臺南	Tainan
秋葉原	Akihabara
徐光啟	Xu Guangqi
虹吸	Sifão
北條時宗	Hōjō Tokimune
藤原道長	Fujiwara no Michinaga
戚繼光	Qi Jiguang
托勒密定理	Teorema de Ptolomeu
丸龜市	Marugame
鄧麗君	Teresa Teng
北條政子	Hōjō Masako
明成皇后	Myeongseong da Coreia
殷墟	Yin Xu
詩經	Clássico da Poesia
秋瑾	Qiu Jin
自斷	Autotomia
戈公省	Koh Kong
效用	Utilidade (economia)
甘寧	Gan Ning
嵇康	Xi Kang
典韋	Dian Wei
龐德	Pang De
馬超	Ma Chao
太史慈	Taishi Ci
徐晃	Xu Huang
吳景帝	Jing de Wu
淩統	Ling Tong
漢後主	Liu Chan
山口二矢	Otoya Yamaguchi
興宣獻懿大院君	Heungseon Daewongun
吳末帝	Modi
吳會稽王亮	Feidi
呂蒙	Lü Meng
潘清簡	Phan Thanh Gian
噌汁	Sopa de missô
偏序	Conjunto parcialmente ordenado
康托爾定理	Teorema de Cantor
長島區	Ko Yao
新山一國際機場	Aeroporto Internacional Tan Son Nhat
朝鮮半島	Península da Coreia
電車	Trem unidade elétrico
和服	Quimono
遜尼派	Sunismo
白翎島	Baengnyeong
汝矣島純福音教會	Igreja do Evangelho Pleno
哥德巴赫猜想	Conjetura de Goldbach
朝鮮漢字	Hanja
李埈鎔	Yi Junyong
國會議員	Deputado
摩爾體積	Volume molar
傲遊瀏覽器	Maxthon
矢圖	Quiver
竹島 (鬱陵郡)	Jukdo
可居島	Gageodo
馬羅島	Marado
萌	Moe (gíria)
韓國放送公社	Korean Broadcasting System
涼宮春日系列	Suzumiya Haruhi no Yūutsu
莎阿南	Shah Alam
玉山	Yu Shan
大嶼山	Lantau
楚	Império Chu
梅爾維爾島	Ilha Melville (Austrália)
新	Dinastia Xin
北太平洋露脊鯨	Baleia-franca-do-pacífico
蒼龍	Dragão azul
中國禮儀之爭	Controvérsia dos ritos na China
鳳凰	Fenghuang
宋教仁	Song Jiaoren
吳清源	Go Seigen
真言宗	Shingon
初音未來	Hatsune Miku
餛飩	Wonton
星期四島	Ilha Thursday
滿寵	Man Chong
超濾法	Ultrafiltração
賈詡	Jia Xu
馬騰	Ma Teng
許褚	Xu Zhu
吉田松陰	Yoshida Shōin
嚴復	Yan Fu
帕覺柯	José Emilio Pacheco
泰文維基大典	Wikipédia em tailandês
猫眼林克	Link (The Legend of Zelda)
尼奧寵物	Neopets
包頭市	Baotou
大化革新	Reformas Taika
壬辰倭亂	Guerra Imjin
小行星三千	3000 Leonardo
軍曹	Sgt. Keron
出雲國	Província de Izumo
原口證	Akira Haraguchi
新界	Novos Territórios
武漢天河國際機場	Aeroporto Internacional de Wuhan Tianhe
午餐肉	Spam (alimento)
呂底亞	Lídia
自焚	Autoimolação
廬山	Monte Lu
老撾之歌	Pheng Xat Lao
夏禹	Yu o Grande
藤原氏	Clã Fujiwara
漢 (釋義)	Han
杭思朗	Armstrong
刀	Dao (sabre)
水龍頭	Torneira
子拓撲	Subespaço topológico
廣州地鐵	Metrô de Guangzhou
車裂	Desmembramento
泰國小姐	Miss Tailândia
性染色體	Cromossomo sexual
算術基本定理	Teorema fundamental da aritmética
存活期	Time to Live
稠密	Conjunto denso
崑曲	Ópera de Kunqu
流亡政府	Governo no exílio
古魯特島	Groote Eylandt
中文數字	Numeração chinesa
天主教輔仁大學	Universidade Católica Fu Jen
武器貿易條約	Tratado de Comércio de Armas Convencionais
龜船	Navios Tartaruga
永樂大典	Enciclopédia Yung-lo Ta-tien
諡	Nome póstumo
大東諸島	Ilhas Daitō
曹休	Cao Xiu
周文王	Conde Wen
劉基	Liu Ji
張勳	Zhang Xun (República da China)
杭州灣	Baía de Hangzhou
高雄捷運	Metrô de Kaohsiung
韓服	Hanbok
朝香鳩彥	Asaka Yasuhiko
劉伯承	Liu Bocheng
魏忠賢	Wei Zhongxian
段祺瑞	Duan Qirui
臺灣問題	Estatuto da República da China
黃興	Huang Xing
于謙	Yu Qian
裴秀	Pei Xiu
世界新七大奇蹟	Sete maravilhas do mundo moderno
鑒真	Jianzheng
臺北捷運	Metrô de Taipé
延邊州	Prefeitura Autônoma de Yanbian
桃園區	Taoyuan (cidade)
太陽餅	Torta do Sol
日本雅樂	Gagaku
墨家	Moísmo
帝嚳	Ku (imperador)
印地文維基大典	Wikipédia em hindi
琴	Guqin
範空間	Espaço normado
有界	Conjunto limitado
蘇我入鹿	Soga no Iruka
平知盛	Taira no Tomomori
倫敦東隅	East End (Londres)
申 (地支)	Macaco (zodíaco)
歐羅巴	Europa (desambiguação)
性	Natureza humana
八元數	Octoniões
春秋	Os Anais de Primavera e Outono
地級市	Prefeitura com nível de cidade
泰北	Região Norte (Tailândia)
迴文數	Capicua
水墨畫	Sumi-ê
威爾斯親王島	Ilha do Príncipe de Gales (Queensland)
銀魂	Gintama
沖繩縣	Okinawa
香港城市大學	Universidade da Cidade de Hong Kong
百度大典	Baidu Baike
基 (拓撲)	Base (topologia)
帝堯	Yao (imperador)
二虎歌	Frère Jacques
南越	Nanyue
超複數	Número hipercomplexo
奧海鎮	Ojai (Califórnia)
天下通言	Língua auxiliar
博者之謬	Falácia do apostador
古雅典	Atenas Antiga
藤原清河	Fujiwara no Kiyokawa
閩東語維基大典	Wikipédia em min oriental
漢傳佛教	Budismo na China
渭水	Rio Wei
阿巴諾湖	Lago Albano
康熙字典	Dicionário de Kangxi
證明論	Teoria da prova
石	Koku
坂出市	Sakaide
族 (數學)	Família indexada
李賀	Li He
仡佬族	Gelao (etnia)
中華民國元首	Lista de presidentes da República da China
整除	Critérios de divisibilidade
光圈	Abertura (óptica)
禮記	Clássico dos Ritos
內點	Interior
州際三十五號公路大橋	Ponte I-35W do rio Mississippi
萬葉假名	Man'yōgana
會計等式	Equação contábil básica
姣童	Bishōnen
元朗區	Yuen Long (distrito)
錦衣親軍都指揮使司	Jinyi Wei
北魏	Dinastia Wei do Norte
尚書	Shujing
雲隙光	Raios crepusculares
康威數	Número surreal
常用漢字	Jōyō kanji
天命	Mandato do céu
周界	Fronteira (matemática)
漢水	Rio Han (afluente do rio Yangtzé)
窮奇	Kamaitachi
太甲	Tai Jia
陸奧國	Província de Mutsu
東方計劃	Touhou Project
分液漏斗	Funil separador
魏	Wei (Estado)
吳	Wu (estado)
藁人之謬	Falácia do espantalho
地球之年歲	Idade da Terra
弗林德斯島 (塔斯曼尼亞)	Ilha Flinders
坂上田村麻呂	Sakanoue no Tamuramaro
孫叔敖	Sunshu Ao
景教	Igreja do Oriente
兼六園	Kenroku-en
代數 (代數)	Álgebra sobre um corpo
羅勇市	Rayong
儋州市	Danzhou
江陰市	Jiangyin
馬達納帕利	Madanapalle
大都	Khanbaliq
倉頡	Cangjie
凌遲	Morte por mil cortes
美洲殖民	Período colonial dos Estados Unidos
日本新字體	Shinjitai
朱鳥	Pássaro Vermelho
元維基	Wikimedia Meta-Wiki
去衣馳騁	Streaking
燭線	Candlestick
後漢	Dinastia Han Posterior (cinco dinastias)
泰南	Região Sul (Tailândia)
閣帕岸島	Ko Pha Ngan
積拓撲	Topologia produto
縣級市	Cidade administrativa
夢蓮湖	Lago Moraine
祁連山	Montanhas Qilian
西班牙小姐	Miss Espanha
中國共產黨中央政治局	Politburo do Partido Comunista da China
吳語維基大典	Wikipédia em chinês wu
三垣二十八宿	Três Caixas
尚灝王	Sho Ko
亞米利加蝲蛄	Procambarus clarkii
源義仲	Minamoto no Yoshinaka
少皞	Shaohao
訓讀	Kun'yomi
子思	Zisi
日本舊字體	Kyujitai
人民公社	Comuna popular (China)
伊多文維基大典	Wikipédia em ido
麻貴	Ma Gui
中國茉莉花革命	Protestos na China em 2011
粵文維基大典	Wikipédia em cantonês
蘇我馬子	Soga no Umako
小篆	Xiaozhuan
後周恭帝	Kung-ti
朱然	Zhu Ran
關門大橋	Ponte Kanmon
五畿七道	Gokishichidō
六朝	Seis Dinastias
維基大典:大使館	Wikipédia:Embaixada
太鼓達人	Taiko no Tatsujin
平將門	Taira no Masakado
曾子	Zengzi
分數	Número racional
曾鞏	Zeng Gong
有司足下之函	Dear Boss (carta)
蘇我蝦夷	Soga no Emishi
PSYCHO-PASS	Psycho-Pass
泰國日報	Thai Rath
恆山	Monte Heng (Shanxi)
洞爺湖	Lago Tōya
古丁尼柏國家公園	Parque Nacional Quttinirpaaq
漢服	Hanfu
乾燥氣候	Clima árido
富勞里友半島	Península de Fleurieu
內閣情報調查室	Naicho
尚泰王	Sho Tai
後樂園	Kōraku-en
文言維基大典	Wikipédia em chinês clássico
動物莊園	Animal Farm
藤原忠平	Fujiwara no Tadahira
Category:德國史	Categoria:Alemanha
Category:俄羅斯聯邦書	Categoria:Rússia
Category:大韓民國書	Categoria:Coreia do Sul
Category:羅馬帝國書	Categoria:Império Romano
Category:鳥	Categoria:Aves
Category:植物	Categoria:Plantas
Category:物理	Categoria:Física
Category:自然科學	Categoria:Ciências naturais
Category:化學	Categoria:Química
Category:史部	Categoria:História
Category:群	Categoria:Sociedade
Category:宗教	Categoria:Religião
Category:運動	Categoria:Desportos
Category:經部	Categoria:Ciência
Category:聯合國	Categoria:Nações Unidas
Category:地球	Categoria:Terra
玉龍雪山	Shanzidou
盈不足術	Método da posição falsa
道路連通	Conexidade
摩靈頓島	Ilha Mornington
精	Jing
桂宮宜仁親王	Príncipe Katsura
古羅馬	Roma Antiga
物部氏	Clã Mononobe
克拉拉·奧斯瓦爾德	Clara Oswald
古今圖書集成	Gujin Tushu Jicheng
聖火降魔錄	Fire Emblem
局部	Localmente (matemática)
不寐	Insônia
生肖	Horóscopo chinês
Category:釋義	Categoria:Desambiguação
Category:哲學	Categoria:Filosofia
Category:心理	Categoria:Psicologia
Category:佛教	Categoria:Budismo
Category:基督教	Categoria:Cristianismo
Category:回教	Categoria:Islamismo
Category:猶太教	Categoria:Judaísmo
洋油貓弔詭	Paradoxo do gato e pão com manteiga
嘉當矩陣	Matriz de Cartan
華東師範大學	East China Normal University
汝有二牯	Você tem duas vacas
藏文維基大典	Wikipédia em tibetano
吳 (釋義)	Wu
小豆島	Shōdoshima
陸機	Lu Ji
阿拉伯文維基大典(埃及地區)	Wikipédia em árabe egípcio
物部守屋	Mononobe no Moriya
兒島明子	Akiko Kojima
鄰域	Vizinhança (matemática)
羅馬共和官制	Constituição da República Romana
梵文維基大典	Wikipédia em sânscrito
華夏	Huaxia
陸秀夫	Lu Xiufu
Category:殘章	Categoria:!Esboços
Category:維基分類	Categoria:!Categorização da Wikipedia
Category:維基事	Categoria:!Administração da Wikipédia
Category:行星	Categoria:Planetas
Category:地質	Categoria:Geologia
每日新聞 (泰國)	Daily News (Tailândia)
明治	Era Meiji
維基大典:陳年今誌	Wikipédia:Efemérides
正數	Número positivo
Help:凡例	Ajuda:Tutorial/Edição
Template:太陽系	Predefinição:Sistema Solar
霍英東	Henry Fok
閩南語維基大典	Wikipédia em min nan
門:子	Portal:Filosofia
壯語維基大典	Wikipédia em zhuang
各地治世一覽	Lista de períodos de paz regional
國際語維基大典	Wikipédia em interlíngua
門:集	Portal:Arte
Category:小行星帶天體	Categoria:Asteroides da cintura principal
Category:美國列傳	Categoria:Estado-unidenses
Template:Tl	Predefinição:Ligação para predefinição
Template:Userbox	Predefinição:Userbox
Category:網頁瀏覽器	Categoria:Navegadores web
Template:世事	Predefinição:Eventos atuais
Category:律法	Categoria:Direito
Category:計學	Categoria:Economia
維基大典:有秩選舉	Wikipédia:Pedidos de administração
Category:醫學	Categoria:Medicina
Category:政治	Categoria:Política
Category:教育	Categoria:Educação
Category:藝術	Categoria:Arte
會計	Contabilidade
密思兒	Egito
國務院總理	Primeiro-ministro da República Popular da China
Category:統計	Categoria:Estatística
Template:Bot	Predefinição:Robô
加拿大	Canadá
Category:卓著	Categoria:!Artigos destacados
維	Dimensão (matemática)
Category:遊戲	Categoria:Jogos
門:經	Portal:Ciência
Category:幫助文檔	Categoria:!Ajuda
維基大典:世事	Portal:Eventos atuais
Template:Documentation	Predefinição:Documentação
Category:有秩	Categoria:!Administradores
維基大典:簿之權限	Wikipédia:Usuários
Category:半保護	Categoria:!Páginas semiprotegidas
Category:維基社群論壇	Categoria:!Avisos sobre a Wikipédia
維基大典:聯繫	Wikipédia:Contato
維基大典:市集	Wikipédia:Portal comunitário
Category:維基人	Categoria:!Wikipedistas por idioma
Category:維基人 (地方)	Categoria:!Wikipedistas por localização
維基大典:忽略規則	Wikipédia:A Wikipédia não possui regras fixas além dos cinco pilares
維基大典:五柱	Wikipédia:Cinco pilares
成在基	Sung Jae-ki
企業	Negócio
Template:Softredirect	Predefinição:Pseudorredirecionamento
Template:刪	Predefinição:ER
Category:技術	Categoria:Tecnologia
Category:語言	Categoria:Línguas
Category:語法	Categoria:Gramática
Category:維基大典	Categoria:Wikipédia
Category:諸語維基大典	Categoria:Versões da Wikipédia
Category:未索之頁	Categoria:!Páginas não indexadas
Category:帶壞檔之頁	Categoria:!Páginas com ficheiros inexistentes
門:卷首	Portal:Índice
Template:Navbox	Predefinição:Navbox
Template:捷徑	Predefinição:Atalho
Category:時區	Categoria:Fusos horários
Category:維基大典維護	Categoria:!Manutenção
門:美國史	Portal:Estados Unidos
Template:Navbar	Predefinição:Tnavbar
Template:Unicode	Predefinição:Unicode
Category:格式模板	Categoria:!Predefinições de formatação
Template:Transclude	Predefinição:Transclude
Template:Clear	Predefinição:Limpar
Template:Nowrap	Predefinição:Nowrap
維基大典:當有之文	Wikipédia:Artigos essenciais
Category:數	Categoria:Números
Category:書籍	Categoria:Livros
Template:Wikisource	Predefinição:Wikisource
Template:Babel	Predefinição:Babel
Template:共享	Predefinição:Commons
Template:Link GA	Predefinição:Bom interwiki
Template:Reflist	Predefinição:Referências
維基大典:掃興警示	Wikipédia:A Wikipédia contém spoilers
Template:芻文	Predefinição:Esboço
Template:See also	Predefinição:VT
Template:User de	Predefinição:User de
Template:User de-1	Predefinição:User de-1
Template:User es-2	Predefinição:User es
Template:User en-3	Predefinição:User en-3
Template:User en-1	Predefinição:User en-1
Template:User en-2	Predefinição:User en-2
Template:User en-4	Predefinição:User en-4
Template:User en	Predefinição:User en
Template:User de-2	Predefinição:User de-2
Template:User es-1	Predefinição:User es-1
Template:User fr-1	Predefinição:User fr-1
Category:香港大專院校	Categoria:Instituições de ensino superior de Hong Kong
Template:User he-2	Predefinição:User he-2
Template:User id-3	Predefinição:User id-3
Template:User sk	Predefinição:User sk
Template:User fr-2	Predefinição:User fr-2
Template:User ja	Predefinição:User ja
Template:User ja-1	Predefinição:User ja-1
Template:User fr	Predefinição:User fr
Category:智利	Categoria:Chile
Category:廿一世紀	Categoria:Século XXI
Category:維護模板	Categoria:!Predefinições de manutenção
Category:User uk	Categoria:Usuários uk
Category:User uk-N	Categoria:Usuário uk
Template:Esoteric	Predefinição:Predefinição complexa
Template:Mod	Predefinição:Mod
Template:User uk	Predefinição:User uk
Category:百科全書	Categoria:Enciclopédias
Template:歡迎	Predefinição:Bem-vindo(a)
Category:User ms	Categoria:Usuários ms
Template:Ref	Predefinição:Ref
Template:Click	Predefinição:Click
Category:連結模板	Categoria:!Predefinições sobre links
Template:Userbox-2	Predefinição:Userbox-2
Category:User fr-1	Categoria:Usuário fr-1
Template:Wikiquote	Predefinição:Wikiquote
Template:Image label	Predefinição:Image label
Template:Category handler	Predefinição:Cat handler
Template:Ja	Predefinição:((ja))
Template:維基諸策	Predefinição:Wikimedia Foundation
Template:醫	Predefinição:Aviso-médico
Template:大修	Predefinição:Em edição
Template:Es	Predefinição:((es))
Template:Ambox	Predefinição:Ambox
Template:官能團	Predefinição:Funções orgânicas
Template:Hide in print	Predefinição:Hide in print
Category:美國史	Categoria:História dos Estados Unidos
Template:國	Predefinição:Info/País
Template:Infobox software	Predefinição:Info/Software
Template:Wide image	Predefinição:Panorama
Template:Military Conflict	Predefinição:Info/Conflito militar
Template:Audio	Predefinição:Áudio
Template:電玩訊欄	Predefinição:Info/Jogo eletrônico
Template:Dablink	Predefinição:Dablink
Template:卓著	Predefinição:Artigo destacado
Category:User en-4	Categoria:Utilizador en-4
Category:User en	Categoria:Usuários en
Category:User zh	Categoria:Usuários zh
Category:User zh-N	Categoria:Usuário zh
Category:User en-2	Categoria:Usuário en-2
Category:曲	Categoria:Composições musicais
Template:Infobox	Predefinição:Info
Template:User zh	Predefinição:User zh
Template:Template other	Predefinição:Template other
Template:Legend	Predefinição:Legenda
Template:引網	Predefinição:Citar web
Template:Ombox	Predefinição:Ombox
Category:食	Categoria:Alimentação
Template:未已之作	Predefinição:Futuro
Template:Coor URL	Predefinição:Coor URL
Template:Pp-template	Predefinição:Pp-template
Category:史書	Categoria:Livros de história
Template:維基爾雅	Predefinição:Wikcionário
Template:Multi-listen start	Predefinição:Multi-escuta início
Template:MongolUnicode	Predefinição:MongolUnicode
Template:Languageicon	Predefinição:Languageicon
Category:農業	Categoria:Agricultura
Category:User ms-N	Categoria:Usuário ms
Template:User ru	Predefinição:User ru
Category:二十世紀	Categoria:Século XX
Template:IPA	Predefinição:AFI
Template:釋義二	Predefinição:Ver desambig
Category:東羅馬史	Categoria:Império Bizantino
Template:LangWithName	Predefinição:Língua com nome
Template:Navbox subgroup	Predefinição:Navbox subgroup
Template:Dyk	Predefinição:Sabia que
Template:Archive box	Predefinição:Arquivo-índice
Template:Namespace detect	Predefinição:Namespace detect
Template:KIA	Predefinição:KIA
Template:Fmbox	Predefinição:Fmbox
Template:Navbox with collapsible groups	Predefinição:Navbox with collapsible groups
Template:Copyvio	Predefinição:VDA
Template:元素週期表	Predefinição:Tabela periódica compacta
Template:天下觀	Predefinição:Global
Template:Image label end	Predefinição:Image label end
Template:澳大利亞地方	Predefinição:Austrália
Template:Purge	Predefinição:Purgar
Template:土星之衛星	Predefinição:Luas de Saturno
Template:敗興	Predefinição:Revelações sobre o enredo
Template:中華人民共和國地方	Predefinição:Subdivisões da República Popular da China
Template:齋	Predefinição:Página de usuário
Template:User	Predefinição:Usuário2
非標準實數	Número hiper-real
Category:中學	Categoria:Instituições de ensino médio
Template:Note	Predefinição:Nota
Category:公司	Categoria:Empresas
Template:User fr-3	Predefinição:User fr-3
Template:Move	Predefinição:Renomear página
Template:Th	Predefinição:((th))
Template:Redirect	Predefinição:Redirect
Category:日本地方志	Categoria:Subdivisões do Japão
Category:電腦	Categoria:Computadores
Category:器	Categoria:Equipamentos
Template:Mbox	Predefinição:Mbox
Template:非也	Predefinição:Discordo
Template:SUL Box	Predefinição:SUL Box
Category:複分析	Categoria:Análise complexa
客家語維基大典	Wikipédia em chinês hakka
Category:User ja-N	Categoria:Usuário ja
Category:茶	Categoria:Chá
贛語維基大典	Wikipédia em chinês gan
Template:Browsebar	Predefinição:Barra de portais
Template:釋義	Predefinição:Desambiguação
Category:攝影	Categoria:Fotografia
Category:天皇本紀	Categoria:Monarcas do Japão
Category:德意志第三帝國書	Categoria:Alemanha Nazi
Category:朝鮮史	Categoria:História da Coreia
Category:礦冶	Categoria:Mineração
Template:Legend inline	Predefinição:Legend inline
Template:User ksh	Predefinição:User ksh
Template:Lang-en	Predefinição:Lang-en
Category:廣州	Categoria:Cantão (China)
Category:建築	Categoria:Arquitetura
Template:PD-release	Predefinição:PD-release
Template:Period end	Predefinição:Período fim
Category:生物	Categoria:Organismos
Template:De	Predefinição:((de))
Template:Infobox person	Predefinição:Info/Biografia
Category:鐵路	Categoria:Transporte ferroviário
Template:洲	Predefinição:Continentes
Template:InterWiki	Predefinição:InterWiki
Template:MainPageInterwikis	Predefinição:Interwikis da página principal
Template:LSR	Predefinição:ULE
大韓民國大統領	Presidente da Coreia do Sul
Template:User th-1	Predefinição:User th-1
Category:金蘭之模	Categoria:!Predefinições para correlatos
Template:User bg	Predefinição:User bg
Template:User la-1	Predefinição:User la-1
Template:歐洲	Predefinição:Países da Europa
Category:User sk	Categoria:Usuários sk
Category:User fr	Categoria:Usuários fr
Category:User id	Categoria:Usuários id
Category:User ja	Categoria:Usuários ja
Category:User la	Categoria:Usuários la
Category:User th	Categoria:Usuários th
Category:User fr-3	Categoria:Usuário fr-3
Category:User fr-2	Categoria:Usuário fr-2
Category:User ja-2	Categoria:Usuário ja-2
Category:User ko-N	Categoria:Usuário ko
Category:User fr-N	Categoria:Usuário fr
Category:User ru-N	Categoria:Usuário ru
Category:娛樂	Categoria:Entretenimento
Category:商學	Categoria:Negócios
Category:文字	Categoria:Sistemas de escrita
Category:User bg	Categoria:Usuários bg
Category:輕小說	Categoria:Light novels
Category:道教	Categoria:Taoismo
Category:User bg-N	Categoria:Usuário bg
Category:User sk-N	Categoria:Usuário sk
Category:User de	Categoria:Usuários de
Category:User de-2	Categoria:Usuário de-2
Category:User de-N	Categoria:Usuário de
Category:User en-3	Categoria:Usuário en-3
Category:User en-N	Categoria:Usuário en
Category:User es	Categoria:Usuários es
Category:User es-1	Categoria:Usuário es-1
Category:User id-3	Categoria:Usuário id-3
Category:韓語	Categoria:Língua coreana
Category:幾何	Categoria:Geometria
Category:User ja-1	Categoria:Usuário ja-1
Category:User ko	Categoria:Usuários ko
Category:User ko-1	Categoria:Usuário ko-1
Category:User ko-2	Categoria:Usuário ko-2
Category:User ksh	Categoria:Usuários ksh
Category:User ksh-N	Categoria:Usuário ksh
Category:User la-3	Categoria:Usuário la-3
Category:斯巴達書	Categoria:Esparta
Template:Translating	Predefinição:Em tradução
Template:辨	Predefinição:Não confundir com
Category:User ru-1	Categoria:Usuário ru-1
維基大典:巴别	Wikipédia:Babel
Template:木星之衛星	Predefinição:Luas de Júpiter
Category:化合物	Categoria:Compostos químicos
Category:大洋洲史	Categoria:História da Oceania
Category:User ms-1	Categoria:Usuário ms-1
長安	Changan
Category:以嗜好類之維基人	Wikipédia:Lista de wikipedistas por interesse
Category:花	Categoria:Flores
Category:慶尚北道	Categoria:Gyeongsang do Norte
Category:廣東省	Categoria:Guangdong
Category:四川省	Categoria:Sichuan
Category:遼寧省	Categoria:Liaoning
Category:陝西省	Categoria:Shaanxi
Category:安徽省	Categoria:Anhui
Category:江西省	Categoria:Jiangxi
Category:江蘇省	Categoria:Jiangsu
Category:吉林省	Categoria:Jilin
Category:福建省	Categoria:Fujian
Category:海南省	Categoria:Hainan
Category:河北省	Categoria:Hebei
Category:黑龍江省	Categoria:Heilongjiang
Category:湖北省	Categoria:Hubei
Category:地理	Categoria:Geografia física
Category:水	Categoria:Água
Category:美洲史	Categoria:História da América
Category:地理學	Categoria:Ramos da geografia
Category:社會科學	Categoria:Ciências sociais
Template:!w	Predefinição:!wrap
Template:Zh	Predefinição:Zh icon
Category:江戶書	Categoria:Período Edo
Category:室町書	Categoria:Período Muromachi
Category:鎌倉書	Categoria:Período Kamakura
Category:平安書	Categoria:Período Heian
Category:奈良書	Categoria:Período Nara
Category:飛鳥書	Categoria:Período Asuka
Category:古墳書	Categoria:Período Kofun
Category:繩文書	Categoria:Período Jomon
Category:戰國書	Categoria:Período Sengoku
Template:User ja-2	Predefinição:User ja-2
Template:User ko-2	Predefinição:User ko-2
Template:User ko-1	Predefinição:User ko-1
Template:User ru-2	Predefinição:User ru-2
Template:天王星之衛星	Predefinição:Luas de Urano
Category:User ru	Categoria:Usuários ru
Category:User ru-2	Categoria:Usuário ru-2
Category:User th-1	Categoria:Usuário th-1
Template:En	Predefinição:((en))
Category:山東省	Categoria:Shandong
Category:雲南省	Categoria:Yunnan
Category:浙江省	Categoria:Zhejiang
Category:青海省	Categoria:Qinghai
Category:河南省	Categoria:Henan
Category:湖南省	Categoria:Hunan
Template:Lang	Predefinição:Lang
Category:日本文學	Categoria:Literatura do Japão
Category:群學	Categoria:Sociologia
Category:臺南市	Categoria:Tainan
Template:2images	Predefinição:Imagem dupla
域	Champ
Category:三世紀	Categoria:Século III
Category:十七世紀	Categoria:Século XVII
Category:七世紀	Categoria:Século VII
Category:人	Categoria:Humanos
Category:東羅馬本紀	Categoria:Imperadores bizantinos
Category:門	Categoria:!Portais
Template:Ko	Predefinição:((ko))
Template:粒子	Predefinição:Partículas elementares
Template:Main	Predefinição:Artigo principal
Template:User gan	Predefinição:User gan
Template:Fossil range/marker	Predefinição:Período fóssil/marcador
Category:習俗	Categoria:Convenções culturais
Category:風	Categoria:Ventos
Template:PD-self	Predefinição:PD-self
Template:Chart	Predefinição:Chart
Category:中華地方志	Categoria:Subdivisões da República Popular da China
Category:希臘史	Categoria:História da Grécia
Category:澳大利亞史	Categoria:História da Austrália
Category:北韓紀事	Categoria:História da Coreia do Norte
Category:民國紀事	Categoria:História da República da China
Category:加拿大史	Categoria:História do Canadá
Template:User ko	Predefinição:User ko
Template:User ru-1	Predefinição:User ru-1
Template:User zh-1	Predefinição:User zh-1
Template:User zh-2	Predefinição:User zh-2
Template:User zh-3	Predefinição:User zh-3
Category:中華民國行政區	Categoria:Divisões administrativas da República da China
Category:俄羅斯史	Categoria:História da Rússia
Category:中華人民共和國紀事	Categoria:História da República Popular da China
Template:Multi-listen end	Predefinição:Multi-escuta fim
Category:中華自治區	Categoria:Regiões autônomas da República Popular da China
Category:羅馬皇帝本紀	Categoria:Imperadores romanos
Category:戲劇	Categoria:Teatro
維基大典:每日圖繪	Wikipédia:Imagem em destaque
Template:中立	Predefinição:Neutro
Category:中東史	Categoria:História do Oriente Médio
Category:User zh-1	Categoria:Usuário zh-1
Category:User zh-3	Categoria:Usuário zh-3
Category:User zh-2	Categoria:Usuário zh-2
Category:刑法	Categoria:Direito penal
Category:酸	Categoria:Ácidos
Category:民國總統世家	Categoria:Presidentes da República da China
Category:算法	Categoria:Algoritmos
Category:維基訊	Categoria:!Notícias
Category:一世紀	Categoria:Século I
Category:十四世紀	Categoria:Século XIV
Category:二世紀	Categoria:Século II
Category:四世紀	Categoria:Século IV
Category:十八世紀	Categoria:Século XVIII
Category:八世紀	Categoria:Século VIII
Category:唐本紀	Categoria:Imperadores da Dinastia Tang
Category:明本紀	Categoria:Imperadores da Dinastia Ming
Category:整數	Categoria:Inteiros
Category:香港列傳	Categoria:Hongueconguenses
Category:藤原氏	Categoria:Clã Fujiwara
Category:印歐語系	Categoria:Línguas indo-europeias
Category:量子場論	Categoria:Teoria quântica de campos
Category:化學元素	Categoria:Elementos químicos
Template:中國世界遺產	Predefinição:Património Mundial na China
Category:姓氏	Categoria:Sobrenomes
Category:朝鮮民主主義人民共和國書	Categoria:Coreia do Norte
Category:英國史	Categoria:História do Reino Unido
Category:中華史	Categoria:História da China
Category:新聞學	Categoria:Jornalismo
Category:前二世紀	Categoria:Século II a.C.
Category:前三世紀	Categoria:Século III a.C.
Category:越南地理志	Categoria:Geografia do Vietname
Category:蘇聯書	Categoria:União Soviética
Category:古羅馬史	Categoria:Roma Antiga
Category:朝鮮書	Categoria:Dinastia Joseon
Category:前一世紀	Categoria:Século I a.C.
Template:Ed	Predefinição:Ed
Category:鎌倉列傳	Categoria:Pessoas do período Kamakura
Category:明列傳	Categoria:Pessoas da Dinastia Ming
Category:朝鮮列傳	Categoria:Pessoas da Dinastia Joseon
Category:江戶列傳	Categoria:Pessoas do período Edo
Category:平安列傳	Categoria:Pessoas do período Heian
Category:漢列傳	Categoria:Pessoas da Dinastia Han
Category:元列傳	Categoria:Pessoas da Dinastia Yuan
Category:唐列傳	Categoria:Pessoas da Dinastia Tang
Category:反物質	Categoria:Antimatéria
Category:美國總統世家	Categoria:Presidentes dos Estados Unidos
Category:歐洲史	Categoria:História da Europa
Category:魚	Categoria:Peixes
Category:北京市	Categoria:Pequim
Category:果	Categoria:Frutos
九條教家	Kujō Noriie
Category:天候學	Categoria:Climatologia
Category:亞洲地理志	Categoria:Geografia da Ásia
Category:人類學	Categoria:Antropologia
Category:作業系統	Categoria:Sistemas operativos
Category:金書	Categoria:Dinastia Jin (1115–1234)
Category:清書	Categoria:Dinastia Qing
Category:明書	Categoria:Dinastia Ming
Category:元書	Categoria:Dinastia Yuan
Category:隋書	Categoria:Dinastia Sui
Category:周書	Categoria:Dinastia Zhou
Category:天演	Categoria:Evolução
Category:動物	Categoria:Animais
Category:俄羅斯加盟共和國	Categoria:Repúblicas da Rússia
Category:三國書	Categoria:Três Reinos
Category:涼宮春日	Categoria:Haruhi Suzumiya
Category:兵器	Categoria:Armas
Category:紀年	Categoria:Cronologia
Category:弦論	Categoria:Teoria das cordas
Category:數學分析	Categoria:Análise matemática
Category:樂器	Categoria:Instrumentos musicais
Category:氣象	Categoria:Meteorologia
Category:實驗儀器	Categoria:Material de laboratório
Category:香港	Categoria:Hong Kong
Category:PS2遊戲	Categoria:Jogos para PlayStation 2
Category:高雄市	Categoria:Kaohsiung
Category:鹽	Categoria:Sais
Category:廣西壯族自治區	Categoria:Guangxi
Category:衣	Categoria:Vestuário
Category:上海市	Categoria:Xangai
Category:龜	Categoria:Tartarugas
Category:節日	Categoria:Festivais
Category:臺北市	Categoria:Taipei
Category:書體	Categoria:Fontes tipográficas
Category:古希臘史	Categoria:Grécia Antiga
Category:交通	Categoria:Transporte
Category:刑	Categoria:Punições
Category:玩	Categoria:Brinquedos
Category:數趣	Categoria:Matemática recreativa
Category:IE用者	Categoria:!Wikipedistas utilizadores do Internet Explorer
Category:清本紀	Categoria:Imperadores da Dinastia Qing
Category:漢本紀	Categoria:Imperadores da Dinastia Han
Category:群論	Categoria:Teoria dos grupos
Category:數論	Categoria:Teoria dos números
Category:拓撲學	Categoria:Topologia
Category:疇人	Categoria:Matemáticos
Category:雕塑	Categoria:Escultura
Category:大韓民國大統領世家	Categoria:Presidentes da Coreia do Sul
Category:漢語	Categoria:Língua chinesa
Category:澳門	Categoria:Macau
Category:塔	Categoria:Torres
便利店	Loja de conveniência
Category:中華人民共和國書	Categoria:República Popular da China
Category:衛星	Categoria:Satélites naturais
Category:數理物理	Categoria:Física matemática
Category:數學史	Categoria:História da matemática
Category:目錄學	Categoria:Bibliografia
Category:飛鳥列傳	Categoria:Pessoas do período Asuka
Category:日本世家	Categoria:Clãs do Japão
Template:依余之見	Predefinição:Comentário
Category:正典	Categoria:!Artigos bons na Wikipédia em chinês clássico
中國 (釋義)	China (desambiguação)
Category:戰國列傳	Categoria:Pessoas do período Sengoku
門:數學	Portal:Matemática
Category:鮮卑書	Categoria:Xianbei
Category:北韓本紀	Categoria:Presidentes da Coreia do Norte
Category:武漢市	Categoria:Wuhan
Category:基礎之文	Categoria:!Artigos essenciais
Template:Sister	Predefinição:Irmão
Category:代數	Categoria:Álgebra
Category:雅典列傳	Categoria:Naturais da Atenas Antiga
Category:雅典書	Categoria:Atenas Antiga
Category:胴體	Categoria:Tronco
Category:足利將軍世家	Categoria:Xoguns do clã Ashikaga
Category:鹼	Categoria:Bases
Category:橋	Categoria:Pontes
Category:矮行星	Categoria:Planetas anões
Category:地震	Categoria:Sismos
Category:香港教育	Categoria:Educação em Hong Kong
Category:電極	Categoria:Eletrodo
Category:版權	Categoria:Direitos autorais
Category:世界語	Categoria:Esperanto
Template:Lang-zh	Predefinição:Lang-zh
Category:語法格	Categoria:Casos gramaticais
Category:內蒙古自治區	Categoria:Mongólia Interior
Category:琉球本紀	Categoria:Reis de Ryukyu
Category:蘇州市	Categoria:Suzhou
Category:律史	Categoria:História do direito
門:化學	Portal:Química
Category:秦書	Categoria:Dinastia Qin
Category:軍事	Categoria:Ciência militar
Category:萌	Categoria:Moe
Category:中華直轄市	Categoria:Municípios da República Popular da China
Category:中華民國書	Categoria:República da China
Category:有機化學	Categoria:Química orgânica
Category:琉球群島	Categoria:Ilhas Ryukyu
Category:船舶	Categoria:Navios
Category:奈良列傳	Categoria:Pessoas do período Nara
Category:中華特別行政區	Categoria:Regiões administrativas especiais da República Popular da China
Category:衡器	Categoria:Instrumentos de medida
Category:唐書	Categoria:Dinastia Tang
Category:魏書	Categoria:Dinastia Wei do Norte
Category:電話	Categoria:Telefonia
Category:音節文字	Categoria:Silabários
Category:臺灣省大專院校	Categoria:Universidades de Taiwan
Category:德川將軍世家	Categoria:Xoguns do clã Tokugawa
Category:應用科學	Categoria:Ciências aplicadas
Category:輿圖學	Categoria:Cartografia
Category:西安市	Categoria:Xi'an
Category:行星環	Categoria:Anéis planetários
Template:Image label begin	Predefinição:Image label begin
Category:儒家	Categoria:Confucionismo
Category:民法	Categoria:Direito civil
Category:李代數	Categoria:Álgebra de Lie
Category:古墳列傳	Categoria:Pessoas do período Kofun
Category:User en-1	Categoria:Usuário en-1
Category:User de-1	Categoria:Usuário de-1
Category:語言標示模	Categoria:!Predefinições de ícones de línguas
Category:非洲史	Categoria:História da África
Category:羅馬共和本紀	Categoria:Cônsules da República Romana
Category:國憲	Categoria:Direito constitucional
埃博拉	Vírus Ebola
Template:LPR	Predefinição:ULI
Template:PD-author	Predefinição:SemDireitosReservados
Template:FZW-Intro	Predefinição:Discussão
Help:校對	Wikipédia:Validação de páginas
雨冰	Chuva congelada
Template:海王星之衛星	Predefinição:Luas de Netuno
Template:Multi-listen item	Predefinição:Multi-escuta item
Template:Nobots	Predefinição:Nobots
維基大典:編輯次數	Wikipédia:Lista de wikipedistas por número de edições
Template:Style/IPA	Predefinição:Style/IPA
Template:Style/yid	Predefinição:Style/yid
潘多拉病毒	Pandoravírus
門:理則	Portal:Lógica
麗水市	Lishui
Module:Yesno	Módulo:Yesno
Module:Message box	Módulo:Message box
Module:Category handler	Módulo:Category handler
Module:Message box/configuration	Módulo:Message box/configuration
如釋冰	Let It Go (canção de Frozen)
Module:Arguments	Módulo:Arguments
Special:近易	Especial:Mudanças recentes
Module:Namespace detect	Módulo:Namespace detect
Module:HtmlBuilder	Módulo:HtmlBuilder
Module:String	Módulo:String
Module:InfoboxImage	Módulo:InfoboxImage
Module:Navbar	Módulo:Navbar
Module:Navbox	Módulo:Navbox
Module:Infobox	Módulo:Infobox
Module:Namespace detect/config	Módulo:Namespace detect/config
Category:龍	Categoria:Dragões chineses
雨傘運動	Protestos em Hong Kong em 2014
代言 (動漫)	Mascote
